,purchase_ID,Date at created,Category,Name,Purchase Price,Delivery Price,Total
0,1,21-10-2020 14:42:55.373979,Saludable · Desayunos,Distrito Gourmet,10700,3700,14400
1,2,21-10-2020 14:42:55.483563,Postres,Toledo Pastelería,53900,6800,60700
2,3,21-10-2020 14:42:55.739536,Postres · Helados,Mahé,7500,6000,13500
3,4,21-10-2020 14:42:55.945560,Hamburguesas · Saludable,Restaurant Inn,23000,6100,29100
4,5,21-10-2020 14:42:56.201561,Postres · Desayunos,Maria Luisa - Postres,9000,4300,13300
5,6,21-10-2020 14:42:56.507789,Pollo · China,China Tao,24200,3500,27700
6,7,21-10-2020 14:42:56.613657,Desayunos,La Frijolada Desayunos,24300,4400,28700
7,8,21-10-2020 14:42:56.919591,Sushi · Asiática,Tu Sushi,45800,6400,52200
8,9,21-10-2020 14:42:57.025475,Desayunos · Café,Moramia,37900,4700,42600
9,10,21-10-2020 14:42:57.281396,Postres · Desayunos,BagBog Bagels,8900,6400,15300
10,11,21-10-2020 14:42:57.637426,Desayunos · Pescados y Mariscos,Luzí­a - Mediterranea,11870,5700,17570
11,12,21-10-2020 14:42:57.993546,Postres · Desayunos,La Folie - Postres,12500,3300,15800
12,13,21-10-2020 14:42:58.249459,Hamburguesas,Bendito Cordero,10700,5800,16500
13,14,21-10-2020 14:42:58.355327,Saludable,MIMA,24300,3700,28000
14,15,21-10-2020 14:42:58.711481,Saludable · Desayunos,La Estampilla,8900,6000,14900
15,16,21-10-2020 14:42:59.017628,Pizza,18 Scalini,37900,4300,42200
16,17,21-10-2020 14:42:59.323682,Saludable · Desayunos,La Cesta,39700,4700,44400
17,18,21-10-2020 14:42:59.579726,Típica,La Herencia,13600,5900,19500
18,19,21-10-2020 14:42:59.886211,Pollo · Sánduches,Pollos Century,13000,3000,16000
19,20,21-10-2020 14:43:00.192198,Helados,Orso To Go,8900,6800,15700
20,21,21-10-2020 14:43:00.498390,Desayunos · Café,Moramia,13600,4700,18300
21,22,21-10-2020 14:43:00.704277,Pizza · Parrilla,Urban Lunch,39700,4000,43700
22,23,21-10-2020 14:43:00.810159,Pollo · Saludable,Tremenda Sal y Dulce,24200,6500,30700
23,24,21-10-2020 14:43:00.915872,Mexicana,Cantina La 15,29500,4300,33800
24,25,21-10-2020 14:43:01.121848,Postres · Desayunos,Jacques Pastelería,35000,5900,40900
25,26,21-10-2020 14:43:01.327825,Saludable · Desayunos,Guadalupe - Fruteria,39700,5900,45600
26,27,21-10-2020 14:43:01.433821,Desayunos · Café,El Gualilo,15600,6200,21800
27,28,21-10-2020 14:43:01.790117,Postres · Desayunos,BagBog Bagels,12500,6400,18900
28,29,21-10-2020 14:43:02.146264,Sushi,Kim Pop,11870,5400,17270
29,30,21-10-2020 14:43:02.352151,Saludable · Típica,Sopas Mrg,24300,3100,27400
30,31,21-10-2020 14:43:02.558096,Pizza,Pizza Andante,15600,6300,21900
31,32,21-10-2020 14:43:02.663936,Desayunos,Señor Desayuno,17800,6800,24600
32,33,21-10-2020 14:43:02.919957,Típica,El Cucharón - Tipica,24200,4400,28600
33,34,21-10-2020 14:43:03.276070,Pizza · Italiana,Pisapore - Pizza,15600,6600,22200
34,35,21-10-2020 14:43:03.582296,Parrilla,Coquitas,13000,5600,18600
35,36,21-10-2020 14:43:03.938534,Típica,Cabrito Santandereano,17800,6600,24400
36,37,21-10-2020 14:43:04.094628,Parrilla,Antojo a Domicilio,48750,5000,53750
37,38,21-10-2020 14:43:04.250705,Típica · Parrilla,Mi Ranchito Parrilla,37900,4400,42300
38,39,21-10-2020 14:43:04.456825,Parrilla,OAK Ahumado y Brebajes,48750,6000,54750
39,40,21-10-2020 14:43:04.663979,Típica,Bandejas Mrg,70000,3800,73800
40,41,21-10-2020 14:43:05.020225,Desayunos · Típica,La Frijolada,17800,4500,22300
41,42,21-10-2020 14:43:05.126177,Postres · Desayunos,BagBog Bagels,9000,6400,15400
42,43,21-10-2020 14:43:05.332236,Pollo · Pescados y Mariscos,Bang Bang Rice,35000,3400,38400
43,44,21-10-2020 14:43:05.688389,Postres · Desayunos,La Folie - Postres,10700,3300,14000
44,45,21-10-2020 14:43:06.044548,Hamburguesas,Bendito Cordero,15600,5800,21400
45,46,21-10-2020 14:43:06.150515,Alta Cocina · Postres,La Pinta,17800,4500,22300
46,47,21-10-2020 14:43:06.456679,Sushi,Kim Pop,17800,5400,23200
47,48,21-10-2020 14:43:06.762916,Desayunos · Típica,Casa Vieja,37900,6000,43900
48,49,21-10-2020 14:43:07.119150,Saludable · Parrilla,The Angels Grill and Drinks,23000,6200,29200
49,50,21-10-2020 14:43:07.425394,Hamburguesas · Panadería,NYC Burgers,39700,6200,45900
50,51,21-10-2020 14:43:07.781619,Típica,Cabrito Santandereano,23000,6600,29600
51,52,21-10-2020 14:43:08.087710,Típica · Parrilla,Parrilla Farandula Gourmet,10700,5100,15800
52,53,21-10-2020 14:43:08.344088,Peruana,Uma Cantina Peruana,13000,3200,16200
53,54,21-10-2020 14:43:08.600295,Desayunos · Típica,Fogón Sangileño,9000,5000,14000
54,55,21-10-2020 14:43:08.756409,Postres · Desayunos,KOKOA & co.,15000,4700,19700
55,56,21-10-2020 14:43:08.962579,Desayunos · Típica,Criollomania,9000,5200,14200
56,57,21-10-2020 14:43:09.318852,Típica,Cabrito Santandereano,7500,6600,14100
57,58,21-10-2020 14:43:09.474977,Saludable · Desayunos,Raices Bienestar Gourmet,31800,6600,38400
58,59,21-10-2020 14:43:09.832603,Peruana · Internacional,La Chifería,53400,6600,60000
59,60,21-10-2020 14:43:10.139103,Pollo · Sánduches,Pollos Century,10700,3000,13700
60,61,21-10-2020 14:43:10.245056,Postres · Desayunos,Protein Bakes,27800,5900,33700
61,62,21-10-2020 14:43:10.501213,Desayunos · Típica,Alce,11870,4900,16770
62,63,21-10-2020 14:43:10.607320,Típica,Sabores De Mi Tierra,17800,5400,23200
63,64,21-10-2020 14:43:10.763372,Desayunos · Pescados y Mariscos,Gypsy Bistro,27800,4500,32300
64,65,21-10-2020 14:43:10.869389,Saludable · Parrilla,The Angels Grill and Drinks,34500,6200,40700
65,66,21-10-2020 14:43:11.225521,Desayunos · Café,Matchacha,39700,5900,45600
66,67,21-10-2020 14:43:11.331422,Típica,Baondish,39700,5800,45500
67,68,21-10-2020 14:43:11.687704,Desayunos · Típica,Rojo Gourmet,65000,4700,69700
68,69,21-10-2020 14:43:11.943914,Típica,Juan Chorizo,48750,3900,52650
69,70,21-10-2020 14:43:12.300242,Desayunos · Café,Aromacafé el Placer de Compartir,53900,5000,58900
70,71,21-10-2020 14:43:12.406304,Saludable,Puro Verde,35000,5700,40700
71,72,21-10-2020 14:43:12.512247,Postres · Saludable,Ana Rebana,13600,6300,19900
72,73,21-10-2020 14:43:12.818613,Jugos y Batidos,Pomponio,24300,3600,27900
73,74,21-10-2020 14:43:12.974713,Parrilla · Café,Figaro Café/ Restaurante Argentino,35000,5800,40800
74,75,21-10-2020 14:43:13.130837,Helados,Buon Gelato,35000,4400,39400
75,76,21-10-2020 14:43:13.236881,Sushi · Desayunos,Maki Roll,11870,4300,16170
76,77,21-10-2020 14:43:13.393002,Hamburguesas · Panadería,NYC Burgers,13600,6200,19800
77,78,21-10-2020 14:43:13.499062,Típica,Sopitas y Más,31800,4200,36000
78,79,21-10-2020 14:43:13.655166,Desayunos · Helados,San Giorgio Gelateria,70000,3100,73100
79,80,21-10-2020 14:43:13.861283,Postres,La Galeta,53900,3000,56900
80,81,21-10-2020 14:43:14.167367,Hamburguesas,Burger Society,9000,4100,13100
81,82,21-10-2020 14:43:14.523793,Típica · Parrilla,Mi Ranchito Parrilla,15600,4400,20000
82,83,21-10-2020 14:43:14.780106,Parrilla,Antojo a Domicilio,13600,5000,18600
83,84,21-10-2020 14:43:15.037811,Desayunos · Árabe,Boniato Sabores Vivos,35000,5300,40300
84,85,21-10-2020 14:43:15.194611,Mexicana,Mexicanachos,35000,3900,38900
85,86,21-10-2020 14:43:15.350696,Mexicana,Cantina La 15,24200,4300,28500
86,87,21-10-2020 14:43:15.707649,Parrilla,El Tambor,9000,6800,15800
87,88,21-10-2020 14:43:16.063911,Poke,Poke Go,39700,4600,44300
88,89,21-10-2020 14:43:16.420213,Postres · Helados,Mahé,13600,6000,19600
89,90,21-10-2020 14:43:16.576259,Sushi · Desayunos,Maki Roll,23000,4300,27300
90,91,21-10-2020 14:43:16.732407,Pollo,Chicken House,8900,4200,13100
91,92,21-10-2020 14:43:16.838440,Parrilla · Internacional,Taperia de la Plaza,34500,5700,40200
92,93,21-10-2020 14:43:17.144697,Hamburguesas · Saludable,Restaurant Inn,24200,6100,30300
93,94,21-10-2020 14:43:17.451080,Típica · Parrilla,La Parilla de David,17800,3100,20900
94,95,21-10-2020 14:43:17.557101,Postres · Desayunos,Vivalight Market.,48750,6500,55250
95,96,21-10-2020 14:43:17.713242,Saludable · Jugos y Batidos,Berdes Drinks & Salads,15000,3500,18500
96,97,21-10-2020 14:43:18.019446,Saludable · Desayunos,Malú,11870,3700,15570
97,98,21-10-2020 14:43:18.125612,Desayunos,Don Leo,48750,6000,54750
98,99,21-10-2020 14:43:18.331677,Sánduches,Submarin,31800,3800,35600
99,100,21-10-2020 14:43:18.638127,Hamburguesas · Saludable,Restaurant Inn,70000,6100,76100
100,101,21-10-2020 14:43:18.894523,Italiana,Bocatto Di Passo,45800,5000,50800
101,102,21-10-2020 14:43:19.100624,Típica,El Cucharón - Tipica,53400,4400,57800
102,103,21-10-2020 14:43:19.356880,Alta Cocina · Postres,La Pinta,35000,4500,39500
103,104,21-10-2020 14:43:19.463060,Peruana,Masivo,48750,5800,54550
104,105,21-10-2020 14:43:19.569187,Postres · Desayunos,Aury Postres - Comidas & Picadas,24300,4700,29000
105,106,21-10-2020 14:43:19.925516,Saludable · Parrilla,The Angels Grill and Drinks,53900,6200,60100
106,107,21-10-2020 14:43:20.082922,Típica · Parrilla,El Portal de la Antigua,39700,5600,45300
107,108,21-10-2020 14:43:20.439460,Saludable,MIMA,18900,3700,22600
108,109,21-10-2020 14:43:20.595627,Saludable · Desayunos,Agua Dulce,65000,3700,68700
109,110,21-10-2020 14:43:20.801861,Desayunos · Típica,Calentao Express,8900,6000,14900
110,111,21-10-2020 14:43:21.158239,Sushi · Asiática,Tu Sushi,45800,6400,52200
111,112,21-10-2020 14:43:21.314514,Desayunos · Típica,Rojo Gourmet,45800,4700,50500
112,113,21-10-2020 14:43:21.420578,Desayunos,El Fogón Castellano,15600,3200,18800
113,114,21-10-2020 14:43:21.626828,Desayunos · Panadería,Santa Juana Food Bar,23000,5900,28900
114,115,21-10-2020 14:43:21.732983,Pollo · Pescados y Mariscos,Bang Bang Rice,23000,3400,26400
115,116,21-10-2020 14:43:21.839233,Saludable · Desayunos,Fresh Co,35000,5600,40600
116,117,21-10-2020 14:43:22.195641,Típica,Salsig,15000,5600,20600
117,118,21-10-2020 14:43:22.552057,Pizza,18 Scalini,10700,4300,15000
118,119,21-10-2020 14:43:22.708356,Desayunos,Sunny Breakfast Brunch,7500,4300,11800
119,120,21-10-2020 14:43:22.964578,Postres · Desayunos,Restaurante Cornelia,18900,5500,24400
120,121,21-10-2020 14:43:23.070713,Jugos y Batidos,Pomponio,13000,3600,16600
121,122,21-10-2020 14:43:23.376988,Desayunos,Don Leo,23000,6000,29000
122,123,21-10-2020 14:43:23.633431,Postres,Levelma,27800,6200,34000
123,124,21-10-2020 14:43:23.889772,Típica,Cazuelitas 93,24300,3900,28200
124,125,21-10-2020 14:43:24.095945,Desayunos · Empanadas,Empanadas Doraditas.com,13600,3000,16600
125,126,21-10-2020 14:43:24.202101,Italiana,F*cking Good Pizza,11870,4200,16070
126,127,21-10-2020 14:43:24.308150,Saludable · Desayunos,Copacabana Açai Bowls,15600,3000,18600
127,128,21-10-2020 14:43:24.514454,Postres · Café,Celestino Café,8900,5900,14800
128,129,21-10-2020 14:43:24.820723,Típica,Cabrito Santandereano,37900,6600,44500
129,130,21-10-2020 14:43:25.178253,Desayunos · Típica,La Frijolada,17800,4500,22300
130,131,21-10-2020 14:43:25.334600,Pollo · Saludable,Tremenda Sal y Dulce,45800,6500,52300
131,132,21-10-2020 14:43:25.640959,Desayunos · Café,Frambas,27800,3400,31200
132,133,21-10-2020 14:43:25.947343,Desayunos · Helados,San Giorgio Gelateria,23000,3100,26100
133,134,21-10-2020 14:43:26.053526,Típica · Pescados y Mariscos,La Vitualla,12500,6300,18800
134,135,21-10-2020 14:43:26.409972,Típica,Cabrito Santandereano,15600,6600,22200
135,136,21-10-2020 14:43:26.616126,Desayunos,Archies Desayunos,9000,3100,12100
136,137,21-10-2020 14:43:26.722375,Peruana,Uma Cantina Peruana,15000,3200,18200
137,138,21-10-2020 14:43:27.028765,Parrilla,El Tambor,31800,6800,38600
138,139,21-10-2020 14:43:27.135000,Pizza,Pastas Laurentina,27800,4800,32600
139,140,21-10-2020 14:43:27.341314,Saludable,Puro Verde,7500,5700,13200
140,141,21-10-2020 14:43:27.697826,Comida Rápida,Fiesta Digital Andrés,24300,3100,27400
141,142,21-10-2020 14:43:27.803969,Pollo,Señor Fantástico,37900,4700,42600
142,143,21-10-2020 14:43:27.960253,Sushi,Umi,24200,5600,29800
143,144,21-10-2020 14:43:28.166617,Desayunos · Empanadas,Empanadas Doraditas.com,53400,3000,56400
144,145,21-10-2020 14:43:28.473031,Típica,Campo Victoria,27800,3000,30800
145,146,21-10-2020 14:43:28.729392,Típica,La Olla de Barro,31800,5300,37100
146,147,21-10-2020 14:43:28.835478,Desayunos · Panadería,Artesanos,53400,4300,57700
147,148,21-10-2020 14:43:29.141937,Postres · Café,Loló Coffee & Snacks,27800,4600,32400
148,149,21-10-2020 14:43:29.498383,Parrilla,Campocina,45800,4600,50400
149,150,21-10-2020 14:43:29.754776,Postres · Desayunos,BagBog Bagels,34500,6400,40900
150,151,21-10-2020 14:43:29.961066,Postres · Desayunos,Restaurante Cornelia,65000,5500,70500
151,152,21-10-2020 14:43:30.218447,Desayunos · Panadería,Le Pain Quotidien,17800,3900,21700
152,153,21-10-2020 14:43:30.575188,Desayunos · Café,Matchacha,12500,5900,18400
153,154,21-10-2020 14:43:30.681436,Típica · Parrilla,La Parilla de David,35000,3100,38100
154,155,21-10-2020 14:43:30.837751,Típica · Pescados y Mariscos,La Vitualla,23000,6300,29300
155,156,21-10-2020 14:43:31.144198,Desayunos,Jacinta Arepas de Huevo,27800,4000,31800
156,157,21-10-2020 14:43:31.350652,Pescados y Mariscos,La Gran Cazuela,31800,3200,35000
157,158,21-10-2020 14:43:31.556988,Alta Cocina · Italiana,Trattoria de la Plaza,17800,6000,23800
158,159,21-10-2020 14:43:31.713387,Desayunos · Panadería,Artesanos,24300,4300,28600
159,160,21-10-2020 14:43:31.969815,Asiática,TeT,13000,5900,18900
160,161,21-10-2020 14:43:32.126182,Comida Rápida,Fiesta Digital Andrés,48750,3100,51850
161,162,21-10-2020 14:43:32.432539,Típica,Sabrosito,35000,4000,39000
162,163,21-10-2020 14:43:32.638896,Hamburguesas · Pescados y Mariscos,El Velero,34500,6500,41000
163,164,21-10-2020 14:43:32.845367,Pizza · Italiana,Pisapore - Pizza,24300,6600,30900
164,165,21-10-2020 14:43:33.051570,Desayunos · Típica,Cochon,8900,3300,12200
165,166,21-10-2020 14:43:33.207929,Desayunos · Comida Rápida,La Veneca,15000,6300,21300
166,167,21-10-2020 14:43:33.464492,Saludable · Desayunos,Malú,53900,3700,57600
167,168,21-10-2020 14:43:33.670974,Típica,Sopitas y Más,12500,4200,16700
168,169,21-10-2020 14:43:33.977389,Parrilla,Restaurante Bar Mi Ranchito,13000,5200,18200
169,170,21-10-2020 14:43:34.133648,Típica,Carbón & Mondongos,53900,6400,60300
170,171,21-10-2020 14:43:34.440096,Desayunos · Típica,Criollomania,18900,5200,24100
171,172,21-10-2020 14:43:34.646648,Pollo · Pescados y Mariscos,Bang Bang Rice,70000,3400,73400
172,173,21-10-2020 14:43:35.003235,Parrilla · Café,Figaro Café/ Restaurante Argentino,53400,5800,59200
173,174,21-10-2020 14:43:35.209692,Desayunos · Sánduches,Frutos del Bosque,53400,3500,56900
174,175,21-10-2020 14:43:35.316835,Pizza · Parrilla,Urban Lunch,35000,4000,39000
175,176,21-10-2020 14:43:35.523333,Sushi · Desayunos,Maki Roll,15000,4300,19300
176,177,21-10-2020 14:43:35.829974,Pollo · China,China Tao,35000,3500,38500
177,178,21-10-2020 14:43:35.936185,Hamburguesas · Saludable,Restaurant Inn,15600,6100,21700
178,179,21-10-2020 14:43:36.042579,Pollo · Pescados y Mariscos,Bang Bang Rice,48750,3400,52150
179,180,21-10-2020 14:43:36.399082,Pizza,18 Scalini,13000,4300,17300
180,181,21-10-2020 14:43:36.555481,Desayunos · Típica,90 Calentados,29500,3700,33200
181,182,21-10-2020 14:43:36.811924,Postres · Desayunos,Café Quindio,13000,5700,18700
182,183,21-10-2020 14:43:36.918205,Comida Rápida,Fiesta Digital Andrés,23000,3100,26100
183,184,21-10-2020 14:43:37.124507,Típica,Bendita S,7500,4600,12100
184,185,21-10-2020 14:43:37.330985,Parrilla · Café,Figaro Café/ Restaurante Argentino,8900,5800,14700
185,186,21-10-2020 14:43:37.687612,Hamburguesas,Gofi Burger,48750,5100,53850
186,187,21-10-2020 14:43:37.894054,Postres · Panadería,RIGHT AWAY FOODS,24300,6600,30900
187,188,21-10-2020 14:43:38.250543,Desayunos · Típica,Calentao Express,53900,6000,59900
188,189,21-10-2020 14:43:38.356875,Saludable,Puro Verde,9000,5700,14700
189,190,21-10-2020 14:43:38.563333,Postres,Levelma,15000,6200,21200
190,191,21-10-2020 14:43:38.869952,Parrilla · Internacional,Taperia de la Plaza,15000,5700,20700
191,192,21-10-2020 14:43:39.176386,Desayunos · Árabe,Boniato Sabores Vivos,65000,5300,70300
192,193,21-10-2020 14:43:39.332674,Típica,Campo Victoria,7500,3000,10500
193,194,21-10-2020 14:43:39.539128,Desayunos · Café,vereda central calle 99,24200,5700,29900
194,195,21-10-2020 14:43:39.745709,Típica,Carbón & Mondongos,7500,6400,13900
195,196,21-10-2020 14:43:40.052270,Comida Rápida,Fiesta Digital Andrés,15600,3100,18700
196,197,21-10-2020 14:43:40.308723,Desayunos · Típica,Parrilla Farandula Típico,45800,5900,51700
197,198,21-10-2020 14:43:40.616494,Desayunos · Sánduches,Frutos del Bosque,35000,3500,38500
198,199,21-10-2020 14:43:40.773181,Desayunos · Panadería,Decofruta,23000,4700,27700
199,200,21-10-2020 14:43:40.979606,Desayunos,Jacinta Arepas de Huevo,18900,4000,22900
200,201,21-10-2020 14:43:41.186076,Desayunos · Sánduches,Garnish,15000,5200,20200
201,202,21-10-2020 14:43:41.492622,Peruana · Internacional,La Chifería,29500,6600,36100
202,203,21-10-2020 14:43:41.599095,Postres · Desayunos,Restaurante Cornelia,15000,5500,20500
203,204,21-10-2020 14:43:41.905763,Pollo · Saludable,Gratina,35000,4200,39200
204,205,21-10-2020 14:43:42.011970,Típica · Parrilla,La Ternera Parrilla,7500,5200,12700
205,206,21-10-2020 14:43:42.218529,Desayunos · Panadería,Siena Café,12500,3700,16200
206,207,21-10-2020 14:43:42.424992,Típica,La Herencia,9000,5900,14900
207,208,21-10-2020 14:43:42.631493,Desayunos,Butter,53400,6700,60100
208,209,21-10-2020 14:43:42.838072,Desayunos · Café,Libertario Coffee Roasters,12500,4600,17100
209,210,21-10-2020 14:43:42.944357,Típica · Parrilla,Toya,24300,4200,28500
210,211,21-10-2020 14:43:43.100797,Alta Cocina · Parrilla,Criterión,12500,6000,18500
211,212,21-10-2020 14:43:43.257370,Desayunos · Panadería,El Pan de Phillippe,35000,4600,39600
212,213,21-10-2020 14:43:43.513963,Postres · Café,Celestino Café,35000,5900,40900
213,214,21-10-2020 14:43:43.820567,Típica,Baondish,45800,5800,51600
214,215,21-10-2020 14:43:44.027153,Desayunos · Café,El Gualilo,34500,6200,40700
215,216,21-10-2020 14:43:44.383802,Postres · Desayunos,BagBog Bagels,48750,6400,55150
216,217,21-10-2020 14:43:44.590401,Sushi,Canoa To Go,7500,5900,13400
217,218,21-10-2020 14:43:44.947135,Hamburguesas,Bendito Cordero,27800,5800,33600
218,219,21-10-2020 14:43:45.103563,Parrilla,OAK Ahumado y Brebajes,53400,6000,59400
219,220,21-10-2020 14:43:45.360162,Parrilla,Beraca Parrilla Bbq,18900,5600,24500
220,221,21-10-2020 14:43:45.566760,Sushi,Umi,48750,5600,54350
221,222,21-10-2020 14:43:45.724356,Desayunos,Desayunos en Bogotá,39700,3400,43100
222,223,21-10-2020 14:43:45.981057,Parrilla,Parrilla Pimentón,9000,3400,12400
223,224,21-10-2020 14:43:46.087500,Típica,La Herencia,24300,5900,30200
224,225,21-10-2020 14:43:46.443854,Desayunos,Sr Buñuelo,17800,6400,24200
225,226,21-10-2020 14:43:46.650485,Saludable · Desayunos,Libre de Culpa,17800,4000,21800
226,227,21-10-2020 14:43:46.857066,Desayunos · Típica,Fogón Sangileño,17800,5000,22800
227,228,21-10-2020 14:43:46.963495,Típica,Baondish,18900,5800,24700
228,229,21-10-2020 14:43:47.069848,Desayunos,Sr Buñuelo,12500,6400,18900
229,230,21-10-2020 14:43:47.226344,Jugos y Batidos,Pomponio,53400,3600,57000
230,231,21-10-2020 14:43:47.382730,Saludable · Desayunos,Malú,18900,3700,22600
231,232,21-10-2020 14:43:47.539253,Típica · Parrilla,La Parilla de David,34500,3100,37600
232,233,21-10-2020 14:43:47.846061,Parrilla,Restaurante Bar Mi Ranchito,29500,5200,34700
233,234,21-10-2020 14:43:47.952439,Desayunos,El Corral - Desayunos,31800,5000,36800
234,235,21-10-2020 14:43:48.309243,Postres · Desayunos,Protein Bakes,15000,5900,20900
235,236,21-10-2020 14:43:48.665913,Desayunos · Panadería,El Pan de Phillippe,48750,4600,53350
236,237,21-10-2020 14:43:48.972547,Mexicana,Cantina La 15,31800,4300,36100
237,238,21-10-2020 14:43:49.129096,Hamburguesas,Gofi Burger,9000,5100,14100
238,239,21-10-2020 14:43:49.285777,Postres,La Galeta,12500,3000,15500
239,240,21-10-2020 14:43:49.542406,Saludable · Desayunos,Raices Bienestar Gourmet,10700,6600,17300
240,241,21-10-2020 14:43:49.648943,Desayunos · Típica,D'Porco - Lechona,13600,6300,19900
241,242,21-10-2020 14:43:49.905600,Saludable · Desayunos,La Estampilla,53900,6000,59900
242,243,21-10-2020 14:43:50.112075,Desayunos · Panadería,Choclofee,7500,4700,12200
243,244,21-10-2020 14:43:50.368687,Sánduches · Pescados y Mariscos,Pacific Comida de Mar,29500,4000,33500
244,245,21-10-2020 14:43:50.625375,Alta Cocina · Parrilla,Criterión,31800,6000,37800
245,246,21-10-2020 14:43:50.832976,Perros Calientes,Dog Shop - Rapida,8900,4900,13800
246,247,21-10-2020 14:43:51.189818,Postres,La Galeta,65000,3000,68000
247,248,21-10-2020 14:43:51.296347,Desayunos · Típica,Papadió - Colombianas,70000,5700,75700
248,249,21-10-2020 14:43:51.452855,Desayunos,El Corral - Desayunos,24300,5000,29300
249,250,21-10-2020 14:43:51.809666,Parrilla,Restaurante Bar Mi Ranchito,10700,5200,15900
250,251,21-10-2020 14:43:51.966047,Postres · Café,Loló Coffee & Snacks,24200,4600,28800
251,252,21-10-2020 14:43:52.322907,Desayunos · Típica,Peninsula Calentados y Parrilla,17800,3400,21200
252,253,21-10-2020 14:43:52.529450,Pollo · Saludable,Gratina,24300,4200,28500
253,254,21-10-2020 14:43:52.786138,Pollo,Heart & Cooking,48750,5000,53750
254,255,21-10-2020 14:43:53.142896,Parrilla,Campocina,34500,4600,39100
255,256,21-10-2020 14:43:53.449585,Pollo · Desayunos,Abasto,29500,3600,33100
256,257,21-10-2020 14:43:53.606149,Sushi,Sushi Reel,24200,4700,28900
257,258,21-10-2020 14:43:53.912814,Pollo,Heart & Cooking,24300,5000,29300
258,259,21-10-2020 14:43:54.069407,Parrilla,Campocina,10700,4600,15300
259,260,21-10-2020 14:43:54.325919,Italiana,F*cking Good Pizza,53400,4200,57600
260,261,21-10-2020 14:43:54.432432,Desayunos · Café,Libertario Coffee Roasters,9000,4600,13600
261,262,21-10-2020 14:43:54.689252,Desayunos · Pescados y Mariscos,Luzí­a - Mediterranea,24300,5700,30000
262,263,21-10-2020 14:43:54.895796,Parrilla,Rústico Picadería,13000,3800,16800
263,264,21-10-2020 14:43:55.102417,Pollo · Típica,Auyama,65000,3900,68900
264,265,21-10-2020 14:43:55.209047,Desayunos · Café,Libertario Coffee Roasters,53900,4600,58500
265,266,21-10-2020 14:43:55.415788,Postres,Toledo Pastelería,13000,6800,19800
266,267,21-10-2020 14:43:55.622576,Pescados y Mariscos,Fish Place - Del Mar,9000,5400,14400
267,268,21-10-2020 14:43:55.980368,Comida Rápida,Fiesta Digital Andrés,39700,3100,42800
268,269,21-10-2020 14:43:56.337222,Típica · Parrilla,El Santandereano,65000,5200,70200
269,270,21-10-2020 14:43:56.443636,Sánduches,Submarin,15600,3800,19400
270,271,21-10-2020 14:43:56.800553,Desayunos · Italiana,Rceta By Rausch,29500,3600,33100
271,272,21-10-2020 14:43:57.107331,Desayunos · Comida Rápida,Chocolatto,37900,3400,41300
272,273,21-10-2020 14:43:57.414220,Hamburguesas · Saludable,Restaurant Inn,48750,6100,54850
273,274,21-10-2020 14:43:57.520659,Hamburguesas · Desayunos,El Inglés Gastro Pub,39700,6600,46300
274,275,21-10-2020 14:43:57.677279,Crepes,San Crepes,31800,4900,36700
275,276,21-10-2020 14:43:57.983896,Peruana,Masivo,23000,5800,28800
276,277,21-10-2020 14:43:58.340761,Típica,Cazuelitas 93,53900,3900,57800
277,278,21-10-2020 14:43:58.597707,Postres · Desayunos,Amelie Helados,17800,6400,24200
278,279,21-10-2020 14:43:58.854661,Pollo,Señor Fantástico,35000,4700,39700
279,280,21-10-2020 14:43:58.961236,Desayunos · Pescados y Mariscos,Luzí­a - Mediterranea,15600,5700,21300
280,281,21-10-2020 14:43:59.217838,Desayunos · Café,Matchacha,12500,5900,18400
281,282,21-10-2020 14:43:59.324402,Helados,Orso To Go,23000,6800,29800
282,283,21-10-2020 14:43:59.681386,Desayunos · Café,Aromacafé el Placer de Compartir,15000,5000,20000
283,284,21-10-2020 14:43:59.787883,Típica,Sabores De Mi Tierra,12500,5400,17900
284,285,21-10-2020 14:43:59.994674,Desayunos · Típica,Fogón Sangileño,18900,5000,23900
285,286,21-10-2020 14:44:00.301463,Típica · Parrilla,Toya,15000,4200,19200
286,287,21-10-2020 14:44:00.558047,Típica,El Mondongo y Mucho Mas,7500,5600,13100
287,288,21-10-2020 14:44:00.814981,Alta Cocina · Postres,La Pinta,11870,4500,16370
288,289,21-10-2020 14:44:01.022836,Pizza · Italiana,Piatto - Pizza,70000,6600,76600
289,290,21-10-2020 14:44:01.279831,Sánduches · China,Peru Mix,12500,5900,18400
290,291,21-10-2020 14:44:01.536583,Hamburguesas,Burger Society,23000,4100,27100
291,292,21-10-2020 14:44:01.893527,Desayunos,El Fogón Castellano,35000,3200,38200
292,293,21-10-2020 14:44:02.100091,Saludable · Desayunos,Guadalupe - Fruteria,23000,5900,28900
293,294,21-10-2020 14:44:02.356873,Postres,Beiked,23000,4000,27000
294,295,21-10-2020 14:44:02.563663,Desayunos · Café,Matchacha,9000,5900,14900
295,296,21-10-2020 14:44:02.870558,Saludable · Desayunos,Re.al Alimentos Reales,53400,4000,57400
296,297,21-10-2020 14:44:02.977109,Desayunos,El Fogón Castellano,39700,3200,42900
297,298,21-10-2020 14:44:03.133793,Mexicana,Hidalgo Taquería,70000,4900,74900
298,299,21-10-2020 14:44:03.340439,Sánduches · China,Peru Mix,15000,5900,20900
299,300,21-10-2020 14:44:03.697408,Parrilla · Café,Figaro Café/ Restaurante Argentino,31800,5800,37600
300,301,21-10-2020 14:44:04.054331,Helados,Orso To Go,24300,6800,31100
301,302,21-10-2020 14:44:04.361037,Típica · Parrilla,Parrilla Farandula Gourmet,45800,5100,50900
302,303,21-10-2020 14:44:04.567796,Saludable · Desayunos,Guadalupe - Fruteria,29500,5900,35400
303,304,21-10-2020 14:44:04.924755,Típica · Pescados y Mariscos,Arroces Mrg,35000,4300,39300
304,305,21-10-2020 14:44:05.281726,Postres,Toledo Pastelería,34500,6800,41300
305,306,21-10-2020 14:44:05.538510,Postres · Desayunos,Restaurante Cornelia,27800,5500,33300
306,307,21-10-2020 14:44:05.695394,Desayunos,Señor Desayuno,10700,6800,17500
307,308,21-10-2020 14:44:05.902146,Saludable · Parrilla,Box,23000,3700,26700
308,309,21-10-2020 14:44:06.008688,Mexicana,Mexicanachos,34500,3900,38400
309,310,21-10-2020 14:44:06.366696,Sushi,Umi,18900,5600,24500
310,311,21-10-2020 14:44:06.623716,Pollo · Pescados y Mariscos,Bang Bang Rice,24200,3400,27600
311,312,21-10-2020 14:44:06.780345,Pizza,Pizza Andante,70000,6300,76300
312,313,21-10-2020 14:44:06.937079,Mexicana,Mexicanachos,34500,3900,38400
313,314,21-10-2020 14:44:07.243960,Típica,Bandejas Mrg,15000,3800,18800
314,315,21-10-2020 14:44:07.500811,Pizza · Parrilla,Urban Lunch,23000,4000,27000
315,316,21-10-2020 14:44:07.657680,Hamburguesas · Alitas,Beer,37900,6600,44500
316,317,21-10-2020 14:44:07.914587,Típica,Campo Victoria,23000,3000,26000
317,318,21-10-2020 14:44:08.021273,Internacional,La Esquina con Sabor Parrilla,24300,3000,27300
318,319,21-10-2020 14:44:08.278021,Pollo · Saludable,Yerbabuena,15600,3900,19500
319,320,21-10-2020 14:44:08.484905,Crepes,San Crepes,45800,4900,50700
320,321,21-10-2020 14:44:08.841869,Crepes,La Chabatta,37900,5900,43800
321,322,21-10-2020 14:44:08.948470,Alta Cocina · Italiana,Trattoria de la Plaza,12500,6000,18500
322,323,21-10-2020 14:44:09.155346,Saludable · Desayunos,Básico y elemental,15600,5000,20600
323,324,21-10-2020 14:44:09.512335,Típica,Cazuelitas 93,27800,3900,31700
324,325,21-10-2020 14:44:09.869455,Internacional,La Esquina con Sabor Parrilla,18900,3000,21900
325,326,21-10-2020 14:44:10.026127,Desayunos · Típica,Fogón Sangileño,24200,5000,29200
326,327,21-10-2020 14:44:10.232940,Típica,Sabores De Mi Tierra,53900,5400,59300
327,328,21-10-2020 14:44:10.389798,Pollo · Desayunos,Workzone,24300,3100,27400
328,329,21-10-2020 14:44:10.646653,Pollo · Desayunos,Piaf,24300,6500,30800
329,330,21-10-2020 14:44:10.803306,Pizza · Italiana,Piatto - Pizza,24200,6600,30800
330,331,21-10-2020 14:44:11.060123,Típica,El Mondongo y Mucho Mas,11870,5600,17470
331,332,21-10-2020 14:44:11.216800,Desayunos · Sánduches,Garnish,23000,5200,28200
332,333,21-10-2020 14:44:11.323666,Perros Calientes,Dog Shop - Rapida,29500,4900,34400
333,334,21-10-2020 14:44:11.631807,Postres · Desayunos,Jacques Pastelería,23000,5900,28900
334,335,21-10-2020 14:44:11.888754,Sushi · Desayunos,Maki Roll,15600,4300,19900
335,336,21-10-2020 14:44:12.095556,Saludable · Típica,Saludable Mrg,10700,5800,16500
336,337,21-10-2020 14:44:12.302491,Típica,El Mondongo y Mucho Mas,23000,5600,28600
337,338,21-10-2020 14:44:12.609447,Desayunos,Sr Buñuelo,37900,6400,44300
338,339,21-10-2020 14:44:12.816322,Pescados y Mariscos,Fish Place - Del Mar,15000,5400,20400
339,340,21-10-2020 14:44:13.173393,Típica · Pescados y Mariscos,La Vitualla,35000,6300,41300
340,341,21-10-2020 14:44:13.380108,Postres · Café,Celestino Café,53400,5900,59300
341,342,21-10-2020 14:44:13.687117,Pollo,Señor Fantástico,48750,4700,53450
342,343,21-10-2020 14:44:13.894085,Desayunos · Típica,90 Calentados,15600,3700,19300
343,344,21-10-2020 14:44:14.000823,Desayunos · Empanadas,Empanadas Doraditas.com,8900,3000,11900
344,345,21-10-2020 14:44:14.257724,Desayunos · Internacional,Camilia,35000,3900,38900
345,346,21-10-2020 14:44:14.364471,Desayunos,Desayunos en Bogotá,24200,3400,27600
346,347,21-10-2020 14:44:14.521400,Saludable · Desayunos,Re.al Alimentos Reales,70000,4000,74000
347,348,21-10-2020 14:44:14.828262,Postres,La Galeta,39700,3000,42700
348,349,21-10-2020 14:44:15.085065,Postres,La Galeta,15000,3000,18000
349,350,21-10-2020 14:44:15.391996,Desayunos · Café,Matchacha,13000,5900,18900
350,351,21-10-2020 14:44:15.699035,Típica · Pescados y Mariscos,Arroces Mrg,9000,4300,13300
351,352,21-10-2020 14:44:15.905994,Crepes,La Chabatta,35000,5900,40900
352,353,21-10-2020 14:44:16.063257,Pollo · Pescados y Mariscos,Bang Bang Rice,39700,3400,43100
353,354,21-10-2020 14:44:16.220168,Peruana · Internacional,La Chifería,29500,6600,36100
354,355,21-10-2020 14:44:16.427130,Internacional,La Esquina con Sabor Parrilla,27800,3000,30800
355,356,21-10-2020 14:44:16.583942,Sushi,Umi,23000,5600,28600
356,357,21-10-2020 14:44:16.691679,Pizza · Italiana,Piatto - Pizza,9000,6600,15600
357,358,21-10-2020 14:44:16.848695,Desayunos · Típica,Rojo Gourmet,13600,4700,18300
358,359,21-10-2020 14:44:17.155793,Desayunos · Panadería,Santa Juana Food Bar,13600,5900,19500
359,360,21-10-2020 14:44:17.312592,Postres · Desayunos,Restaurante Cornelia,27800,5500,33300
360,361,21-10-2020 14:44:17.519679,Sushi · Asiática,Tu Sushi,53400,6400,59800
361,362,21-10-2020 14:44:17.726676,Saludable · Desayunos,Distrito Gourmet,34500,3700,38200
362,363,21-10-2020 14:44:18.033674,Postres · Desayunos,Gelateria Da Favola,7500,6500,14000
363,364,21-10-2020 14:44:18.140347,Típica · Parrilla,Parrilla Farandula Gourmet,17800,5100,22900
364,365,21-10-2020 14:44:18.297435,Típica · Parrilla,El Portal de la Antigua,17800,5600,23400
365,366,21-10-2020 14:44:18.604669,Postres · Desayunos,Buñuelos nacho,13600,6600,20200
366,367,21-10-2020 14:44:18.811782,Típica · Pescados y Mariscos,Arroces Mrg,45800,4300,50100
367,368,21-10-2020 14:44:19.018763,Italiana,F*cking Good Pizza,53400,4200,57600
368,369,21-10-2020 14:44:19.225668,Desayunos,El Fogón Castellano,45800,3200,49000
369,370,21-10-2020 14:44:19.532577,Pollo · Saludable,Gratina,15000,4200,19200
370,371,21-10-2020 14:44:19.639448,Pizza · Italiana,Piatto - Pizza,31800,6600,38400
371,372,21-10-2020 14:44:19.746325,Asiática,TeT,18900,5900,24800
372,373,21-10-2020 14:44:20.103450,Parrilla,Rústico Picadería,65000,3800,68800
373,374,21-10-2020 14:44:20.210369,Hamburguesas · Pescados y Mariscos,El Velero,7500,6500,14000
374,375,21-10-2020 14:44:20.467365,Desayunos · Panadería,Choclofee,13600,4700,18300
375,376,21-10-2020 14:44:20.624353,Postres · Desayunos,Protein Bakes,34500,5900,40400
376,377,21-10-2020 14:44:20.781421,Helados,Orso To Go,18900,6800,25700
377,378,21-10-2020 14:44:21.038323,Típica,Carbón & Mondongos,8900,6400,15300
378,379,21-10-2020 14:44:21.395424,Típica,Sabores De Mi Tierra,7500,5400,12900
379,380,21-10-2020 14:44:21.502436,Parrilla,Parrilla Pimentón,18900,3400,22300
380,381,21-10-2020 14:44:21.860870,Parrilla,OAK Ahumado y Brebajes,18900,6000,24900
381,382,21-10-2020 14:44:22.117972,Pollo · Pescados y Mariscos,Bang Bang Rice,23000,3400,26400
382,383,21-10-2020 14:44:22.324889,Pizza,Pastas Laurentina,15000,4800,19800
383,384,21-10-2020 14:44:22.581974,Comida Rápida · Perros Calientes,Similoa - Comida Rapida,23000,3700,26700
384,385,21-10-2020 14:44:22.788929,Hamburguesas · Alitas,Beer,34500,6600,41100
385,386,21-10-2020 14:44:22.995849,Desayunos · Café,Frambas,12500,3400,15900
386,387,21-10-2020 14:44:23.152710,Parrilla · Internacional,Taperia de la Plaza,31800,5700,37500
387,388,21-10-2020 14:44:23.309769,Sánduches · China,Peru Mix,35000,5900,40900
388,389,21-10-2020 14:44:23.666957,Sushi,Sushi Reel,13000,4700,17700
389,390,21-10-2020 14:44:23.874028,Postres · Desayunos,Amelie Helados,7500,6400,13900
390,391,21-10-2020 14:44:24.181177,Hamburguesas,Burger Society,34500,4100,38600
391,392,21-10-2020 14:44:24.288135,Típica,Sabrosito,9000,4000,13000
392,393,21-10-2020 14:44:24.495268,Crepes,San Crepes,35000,4900,39900
393,394,21-10-2020 14:44:24.652257,Desayunos · Jugos y Batidos,Frutiwow,39700,4100,43800
394,395,21-10-2020 14:44:24.809247,Internacional,La Esquina con Sabor Parrilla,10700,3000,13700
395,396,21-10-2020 14:44:25.066117,Parrilla,Parrilla Pimentón,37900,3400,41300
396,397,21-10-2020 14:44:25.423327,Postres,La Galeta,37900,3000,40900
397,398,21-10-2020 14:44:25.630452,Mexicana,La leyenda mexican kitchen,13600,3200,16800
398,399,21-10-2020 14:44:25.987838,Desayunos · Panadería,Pasteleite,45800,5900,51700
399,400,21-10-2020 14:44:26.295072,Parrilla,Parrilla Pimentón,48750,3400,52150
400,401,21-10-2020 14:44:26.652334,Hamburguesas · Saludable,Restaurant Inn,53900,6100,60000
401,402,21-10-2020 14:44:26.960488,Sushi,Canoa To Go,39700,5900,45600
402,403,21-10-2020 14:44:27.117681,Saludable · Desayunos,Básico y Elemental,9000,5900,14900
403,404,21-10-2020 14:44:27.224615,Parrilla,Parrilla Pimentón,13000,3400,16400
404,405,21-10-2020 14:44:27.481684,Pollo · Desayunos,Abasto,29500,3600,33100
405,406,21-10-2020 14:44:27.788740,Típica,Sabrosito,65000,4000,69000
406,407,21-10-2020 14:44:27.895660,Parrilla,Antojo a Domicilio,27800,5000,32800
407,408,21-10-2020 14:44:28.102658,Desayunos · Empanadas,Mis Delicias,70000,3200,73200
408,409,21-10-2020 14:44:28.459951,Pollo · Saludable,Gratina,31800,4200,36000
409,410,21-10-2020 14:44:28.616872,Parrilla,El Tambor,18900,6800,25700
410,411,21-10-2020 14:44:28.723894,Saludable · Desayunos,Básico y Elemental,10700,5900,16600
411,412,21-10-2020 14:44:28.880807,Desayunos · Panadería,Decofruta,11870,4700,16570
412,413,21-10-2020 14:44:29.137858,Hamburguesas,Bendito Cordero,35000,5800,40800
413,414,21-10-2020 14:44:29.344862,Desayunos · Típica,Desayunadero de la 42,65000,5900,70900
414,415,21-10-2020 14:44:29.702144,Desayunos · Típica,Fogón Sangileño,15000,5000,20000
415,416,21-10-2020 14:44:29.909242,Sushi,Umi,10700,5600,16300
416,417,21-10-2020 14:44:30.066063,Saludable · Desayunos,Distrito Gourmet,53400,3700,57100
417,418,21-10-2020 14:44:30.273332,Desayunos,Jacinta Arepas de Huevo,8900,4000,12900
418,419,21-10-2020 14:44:30.480347,Hamburguesas · Alitas,Beer,37900,6600,44500
419,420,21-10-2020 14:44:30.787900,Mexicana,La leyenda mexican kitchen,29500,3200,32700
420,421,21-10-2020 14:44:30.997550,Desayunos · Panadería,Choclofee,35000,4700,39700
421,422,21-10-2020 14:44:31.254695,Desayunos · Típica,Cochon,18900,3300,22200
422,423,21-10-2020 14:44:31.561805,Pollo,Heart & Cooking,9000,5000,14000
423,424,21-10-2020 14:44:31.718806,Saludable · Desayunos,Re.al Alimentos Reales,23000,4000,27000
424,425,21-10-2020 14:44:31.925843,Postres · Panadería,RIGHT AWAY FOODS,18900,6600,25500
425,426,21-10-2020 14:44:32.234147,Pollo · Desayunos,Workzone,9000,3100,12100
426,427,21-10-2020 14:44:32.541477,Parrilla,Restaurante Bar Mi Ranchito,53900,5200,59100
427,428,21-10-2020 14:44:32.698391,Desayunos,Desayunos en Bogotá,9000,3400,12400
428,429,21-10-2020 14:44:33.055556,Sushi · Asiática,Arigato,23000,5300,28300
429,430,21-10-2020 14:44:33.412660,Típica,Baondish,37900,5800,43700
430,431,21-10-2020 14:44:33.719964,Pollo · Pescados y Mariscos,Bang Bang Rice,18900,3400,22300
431,432,21-10-2020 14:44:34.027161,Postres · Desayunos,Gelateria Da Favola,15600,6500,22100
432,433,21-10-2020 14:44:34.234132,Sushi,Canoa To Go,24300,5900,30200
433,434,21-10-2020 14:44:34.341003,Desayunos · Helados,San Giorgio Gelateria,53900,3100,57000
434,435,21-10-2020 14:44:34.598129,Desayunos · Sánduches,Danilo Colombia,35000,3300,38300
435,436,21-10-2020 14:44:34.905451,Desayunos,Bagel Shop,10700,3200,13900
436,437,21-10-2020 14:44:35.012357,Sánduches,Submarin,53900,3800,57700
437,438,21-10-2020 14:44:35.119385,Hamburguesas,Bendito Cordero,53400,5800,59200
438,439,21-10-2020 14:44:35.376428,Desayunos,El Fogón Castellano,53900,3200,57100
439,440,21-10-2020 14:44:35.483930,Italiana,F*cking Good Pizza,24200,4200,28400
440,441,21-10-2020 14:44:35.640930,Hamburguesas,Gofi Burger,18900,5100,24000
441,442,21-10-2020 14:44:35.847917,Pizza,pizza andante,8900,4200,13100
442,443,21-10-2020 14:44:36.155240,Típica,Cabrito Santandereano,35000,6600,41600
443,444,21-10-2020 14:44:36.412284,Saludable · Desayunos,Copacabana Açai Bowls,31800,3000,34800
444,445,21-10-2020 14:44:36.719541,Desayunos · Jugos y Batidos,Kuriwaji,35000,6300,41300
445,446,21-10-2020 14:44:36.826527,Hamburguesas,Monchis - Hamburguesa,37900,4300,42200
446,447,21-10-2020 14:44:37.183833,Típica · Parrilla,Parrilla Farandula Gourmet,8900,5100,14000
447,448,21-10-2020 14:44:37.292104,Desayunos · Parrilla,Mi Patria,70000,4600,74600
448,449,21-10-2020 14:44:37.399212,Desayunos,Butter,34500,6700,41200
449,450,21-10-2020 14:44:37.756564,Parrilla,El Tambor,15000,6800,21800
450,451,21-10-2020 14:44:38.063787,Hamburguesas,Gofi Burger,24300,5100,29400
451,452,21-10-2020 14:44:38.170775,Pollo,Chicken House,18900,4200,23100
452,453,21-10-2020 14:44:38.428186,Desayunos · Café,Norma's Ice Cream Café,9000,6300,15300
453,454,21-10-2020 14:44:38.535299,Saludable · Desayunos,Fresh Co,15000,5600,20600
454,455,21-10-2020 14:44:38.692381,Peruana · Internacional,La Chifería,18900,6600,25500
455,456,21-10-2020 14:44:38.949564,Parrilla · Café,Gaira Café,13000,4400,17400
456,457,21-10-2020 14:44:39.206701,Postres,La Galeta,29500,3000,32500
457,458,21-10-2020 14:44:39.313730,Típica · Parrilla,Parrilla Farandula Gourmet,35000,5100,40100
458,459,21-10-2020 14:44:39.470805,Desayunos · Café,Aromacafé el Placer de Compartir,39700,5000,44700
459,460,21-10-2020 14:44:39.728049,Desayunos · Típica,Papadió - Colombianas,35000,5700,40700
460,461,21-10-2020 14:44:40.085358,Postres,Toledo Pastelería,23000,6800,29800
461,462,21-10-2020 14:44:40.392456,Desayunos,Sr Buñuelo,65000,6400,71400
462,463,21-10-2020 14:44:40.649645,Desayunos · Panadería,Limarys,53400,6500,59900
463,464,21-10-2020 14:44:40.906743,Desayunos · Comida Rápida,La Veneca,15000,6300,21300
464,465,21-10-2020 14:44:41.063774,Típica,Sabrosito,31800,4000,35800
465,466,21-10-2020 14:44:41.321056,Saludable,A2manos,39700,4200,43900
466,467,21-10-2020 14:44:41.528130,Típica · Parrilla,Parrilla Farandula Gourmet,15000,5100,20100
467,468,21-10-2020 14:44:41.785406,Saludable · Parrilla,The Angels Grill and Drinks,53900,6200,60100
468,469,21-10-2020 14:44:42.042695,Postres · Helados,Mahé,17800,6000,23800
469,470,21-10-2020 14:44:42.149860,China,China Food Col,39700,3600,43300
470,471,21-10-2020 14:44:42.308039,Sushi · Asiática,Arigato,34500,5300,39800
471,472,21-10-2020 14:44:42.665498,Desayunos · Sánduches,Garnish,12500,5200,17700
472,473,21-10-2020 14:44:42.872521,Postres · Desayunos,Sweet Tale,35000,5800,40800
473,474,21-10-2020 14:44:43.179866,Típica · Parrilla,El Portal de la Antigua,31800,5600,37400
474,475,21-10-2020 14:44:43.387073,Típica · Parrilla,El Portal de la Antigua,15000,5600,20600
475,476,21-10-2020 14:44:43.644332,Desayunos · Panadería,Ficchi Panadería,23000,3100,26100
476,477,21-10-2020 14:44:43.751376,Alta Cocina · Postres,La Pinta,37900,4500,42400
477,478,21-10-2020 14:44:44.058762,Saludable · Desayunos,Básico y Elemental,18900,5900,24800
478,479,21-10-2020 14:44:44.366027,Desayunos · Café,Matchacha,31800,5900,37700
479,480,21-10-2020 14:44:44.723455,Internacional,Rio Sabores y Experiencias,53400,4100,57500
480,481,21-10-2020 14:44:44.880635,Pescados y Mariscos,Fish Place - Del Mar,24300,5400,29700
481,482,21-10-2020 14:44:45.188001,Desayunos · Típica,Peninsula Calentados y Parrilla,18900,3400,22300
482,483,21-10-2020 14:44:45.545363,Desayunos · Panadería,El Pan de Phillippe,11870,4600,16470
483,484,21-10-2020 14:44:45.852498,Postres · Desayunos,Sweet Tale,18900,5800,24700
484,485,21-10-2020 14:44:46.109847,Típica · Parrilla,Toya,15000,4200,19200
485,486,21-10-2020 14:44:46.417243,Desayunos · Panadería,El Pan de Phillippe,70000,4600,74600
486,487,21-10-2020 14:44:46.574452,Comida Rápida · Perros Calientes,Similoa - Comida Rapida,8900,3700,12600
487,488,21-10-2020 14:44:46.881750,Pollo,Señor Fantástico,34500,4700,39200
488,489,21-10-2020 14:44:47.088826,Parrilla,Restaurante Bar Mi Ranchito,7500,5200,12700
489,490,21-10-2020 14:44:47.296145,Desayunos · Panadería,Juliana Restaurante,8900,6100,15000
490,491,21-10-2020 14:44:47.554784,Postres · Desayunos,Gelateria Da Favola,15000,6500,21500
491,492,21-10-2020 14:44:47.912242,Desayunos · Típica,Cochon,9000,3300,12300
492,493,21-10-2020 14:44:48.119527,Asiática,Thai Station,45800,6000,51800
493,494,21-10-2020 14:44:48.226753,Crepes,La Chabatta,45800,5900,51700
494,495,21-10-2020 14:44:48.384030,Desayunos · Panadería,Choclofee,23000,4700,27700
495,496,21-10-2020 14:44:48.541190,Pollo · Saludable,Gratina,37900,4200,42100
496,497,21-10-2020 14:44:48.698296,Típica,La Herencia,39700,5900,45600
497,498,21-10-2020 14:44:48.855421,Parrilla · Café,Figaro Café/ Restaurante Argentino,53400,5800,59200
498,499,21-10-2020 14:44:48.962643,Panadería,Boul,37900,3100,41000
499,500,21-10-2020 14:44:49.270100,Desayunos · Internacional,Camilia,29500,3900,33400
500,501,21-10-2020 14:44:49.577473,Mexicana,La leyenda mexican kitchen,35000,3200,38200
501,502,21-10-2020 14:44:49.734882,Desayunos,Jacinta Arepas de Huevo,23000,4000,27000
502,503,21-10-2020 14:44:49.842113,Sánduches,Submarin,10700,3800,14500
503,504,21-10-2020 14:44:50.099429,Postres,Levelma,10700,6200,16900
504,505,21-10-2020 14:44:50.456881,Postres · Desayunos,Cosmo Cookies,65000,5900,70900
505,506,21-10-2020 14:44:50.614045,Típica,Campo Victoria,37900,3000,40900
506,507,21-10-2020 14:44:50.921565,Saludable · Parrilla,The Angels Grill and Drinks,13600,6200,19800
507,508,21-10-2020 14:44:51.178804,Desayunos · Pescados y Mariscos,Luzí­a - Mediterranea,37900,5700,43600
508,509,21-10-2020 14:44:51.285992,Alta Cocina · Postres,La Pinta,39700,4500,44200
509,510,21-10-2020 14:44:51.493358,Pollo,Chicken House,45800,4200,50000
510,511,21-10-2020 14:44:51.600511,Perros Calientes,Dog Shop - Rapida,8900,4900,13800
511,512,21-10-2020 14:44:51.907932,Saludable · Desayunos,Básico y elemental,27800,5000,32800
512,513,21-10-2020 14:44:52.065112,Pollo · China,China Tao,9000,3500,12500
513,514,21-10-2020 14:44:52.322495,Típica,Salsig,13600,5600,19200
514,515,21-10-2020 14:44:52.529938,Postres · Panadería,RIGHT AWAY FOODS,53900,6600,60500
515,516,21-10-2020 14:44:52.638238,Desayunos · Panadería,El Pan de Phillippe,48750,4600,53350
516,517,21-10-2020 14:44:52.745660,Helados,Orso To Go,39700,6800,46500
517,518,21-10-2020 14:44:52.902908,Desayunos · Típica,La Frijolada,9000,4500,13500
518,519,21-10-2020 14:44:53.010156,Desayunos · Comida Rápida,Chocolatto,13000,3400,16400
519,520,21-10-2020 14:44:53.167488,Saludable · Desayunos,Re.al Alimentos Reales,24200,4000,28200
520,521,21-10-2020 14:44:53.374881,Desayunos · Café,Frambas,24200,3400,27600
521,522,21-10-2020 14:44:53.582832,Saludable,Ventura Soup y Salad,23000,3800,26800
522,523,21-10-2020 14:44:53.840502,Saludable · Típica,Saludable Mrg,7500,5800,13300
523,524,21-10-2020 14:44:53.998088,Pescados y Mariscos,La Gran Cazuela,17800,3200,21000
524,525,21-10-2020 14:44:54.205781,Postres · Café,Celestino Café,17800,5900,23700
525,526,21-10-2020 14:44:54.463703,Hamburguesas,Burger Society,45800,4100,49900
526,527,21-10-2020 14:44:54.671428,Desayunos · Internacional,Camilia,23000,3900,26900
527,528,21-10-2020 14:44:54.829399,Desayunos · Sánduches,Frutos del Bosque,39700,3500,43200
528,529,21-10-2020 14:44:55.137496,Típica · Parrilla,Toya,24300,4200,28500
529,530,21-10-2020 14:44:55.445950,Postres · Desayunos,Cosmo Cookies,34500,5900,40400
530,531,21-10-2020 14:44:55.553191,Desayunos · Jugos y Batidos,Frutiwow,9000,4100,13100
531,532,21-10-2020 14:44:55.710411,Parrilla · Internacional,Taperia de la Plaza,35000,5700,40700
532,533,21-10-2020 14:44:55.867660,Saludable,Amor Propio saludable,70000,4000,74000
533,534,21-10-2020 14:44:55.974939,Desayunos · Sánduches,Frutos del Bosque,15000,3500,18500
534,535,21-10-2020 14:44:56.182330,Saludable · Desayunos,Bawana - Sandwich,7500,3400,10900
535,536,21-10-2020 14:44:56.289563,Pollo · Saludable,Tremenda Sal y Dulce,53400,6500,59900
536,537,21-10-2020 14:44:56.396652,Desayunos · Panadería,El Pan de Phillippe,13600,4600,18200
537,538,21-10-2020 14:44:56.754211,Saludable · Típica,Sopas Mrg,7500,3100,10600
538,539,21-10-2020 14:44:56.961791,Desayunos · Comida Rápida,Chocolatto,23000,3400,26400
539,540,21-10-2020 14:44:57.269343,Sánduches · China,Peru Mix,9000,5900,14900
540,541,21-10-2020 14:44:57.576807,Postres · Helados,Mahé,10700,6000,16700
541,542,21-10-2020 14:44:57.835456,Desayunos,Archies Desayunos,13600,3100,16700
542,543,21-10-2020 14:44:58.143146,Postres · Desayunos,Jacques Pastelería,24300,5900,30200
543,544,21-10-2020 14:44:58.250302,Pollo · Saludable,Tremenda Sal y Dulce,45800,6500,52300
544,545,21-10-2020 14:44:58.407697,Pescados y Mariscos,Pescadero Héroes del Mar,23000,6600,29600
545,546,21-10-2020 14:44:58.715296,Típica · Pescados y Mariscos,Arroces Mrg,11870,4300,16170
546,547,21-10-2020 14:44:58.922747,Postres · Panadería,RIGHT AWAY FOODS,15000,6600,21600
547,548,21-10-2020 14:44:59.180261,Desayunos · Típica,D´Porco,18900,3900,22800
548,549,21-10-2020 14:44:59.437960,Desayunos,Desayunos en Bogotá,65000,3400,68400
549,550,21-10-2020 14:44:59.545511,Hamburguesas · Panadería,NYC Burgers,8900,6200,15100
550,551,21-10-2020 14:44:59.803045,Desayunos · Panadería,El Pan de Phillippe,15600,4600,20200
551,552,21-10-2020 14:44:59.960514,Saludable · Típica,Sopas Mrg,70000,3100,73100
552,553,21-10-2020 14:45:00.167796,Crepes,San Crepes,65000,4900,69900
553,554,21-10-2020 14:45:00.425291,Desayunos,Butter,24300,6700,31000
554,555,21-10-2020 14:45:00.582610,Jugos y Batidos,Pomponio,15600,3600,19200
555,556,21-10-2020 14:45:00.790000,Típica · Parrilla,Mi Ranchito Parrilla,24200,4400,28600
556,557,21-10-2020 14:45:00.997368,Pizza,18 Scalini,12500,4300,16800
557,558,21-10-2020 14:45:01.304828,Parrilla,El Tambor,35000,6800,41800
558,559,21-10-2020 14:45:01.612352,Desayunos · Típica,D'Porco - Lechona,35000,6300,41300
559,560,21-10-2020 14:45:01.769753,Pollo · Desayunos,Workzone,70000,3100,73100
560,561,21-10-2020 14:45:02.127271,Saludable · Desayunos,Maracuyá,27800,6700,34500
561,562,21-10-2020 14:45:02.384704,Típica,Cazuelitas 93,15600,3900,19500
562,563,21-10-2020 14:45:02.742488,Saludable · Desayunos,Básico y Elemental,15600,5900,21500
563,564,21-10-2020 14:45:03.001239,Desayunos · Jugos y Batidos,Frutiwow,37900,4100,42000
564,565,21-10-2020 14:45:03.108604,Postres · Desayunos,Jacques Pastelería,18900,5900,24800
565,566,21-10-2020 14:45:03.466393,Desayunos · Típica,Calentao Express,48750,6000,54750
566,567,21-10-2020 14:45:03.623793,Postres · Desayunos,Cosmo Cookies,15000,5900,20900
567,568,21-10-2020 14:45:03.931465,Postres · Desayunos,Sweet Tale,12500,5800,18300
568,569,21-10-2020 14:45:04.289095,Típica · Parrilla,El Portal de la Antigua,27800,5600,33400
569,570,21-10-2020 14:45:04.446397,Desayunos · Sánduches,Frutos del Bosque,45800,3500,49300
570,571,21-10-2020 14:45:04.703893,Saludable,Amor Propio saludable,48750,4000,52750
571,572,21-10-2020 14:45:05.011450,Mexicana,Cantina La 15,31800,4300,36100
572,573,21-10-2020 14:45:05.268952,Típica · Parrilla,Mi Ranchito Parrilla,37900,4400,42300
573,574,21-10-2020 14:45:05.626614,Desayunos,Archies Desayunos,24300,3100,27400
574,575,21-10-2020 14:45:05.884230,Saludable · Desayunos,Malú,13600,3700,17300
575,576,21-10-2020 14:45:06.241980,Desayunos,Fratelli - Desayunos,10700,4600,15300
576,577,21-10-2020 14:45:06.599679,Postres · Desayunos,Restaurante Cornelia,17800,5500,23300
577,578,21-10-2020 14:45:06.957407,Pizza · Italiana,Piatto - Pizza,8900,6600,15500
578,579,21-10-2020 14:45:07.114980,Típica,Bendita S,70000,4600,74600
579,580,21-10-2020 14:45:07.222464,Sushi,Sushi Reel,8900,4700,13600
580,581,21-10-2020 14:45:07.530106,Postres · Desayunos,Aury Postres - Comidas & Picadas,39700,4700,44400
581,582,21-10-2020 14:45:07.687583,Pollo · Desayunos,Caserito Gourmet,48750,6700,55450
582,583,21-10-2020 14:45:07.895169,Desayunos · Jugos y Batidos,Frutiwow,9000,4100,13100
583,584,21-10-2020 14:45:08.202915,Desayunos · Típica,Peninsula Calentados y Parrilla,15000,3400,18400
584,585,21-10-2020 14:45:08.410577,Saludable · Desayunos,Básico y Elemental,35000,5900,40900
585,586,21-10-2020 14:45:08.518085,Desayunos · Típica,Papadió - Colombianas,12500,5700,18200
586,587,21-10-2020 14:45:08.825686,Pizza · Italiana,Pisapore - Pizza,10700,6600,17300
587,588,21-10-2020 14:45:08.933298,Postres · Desayunos,Sweet Tale,70000,5800,75800
588,589,21-10-2020 14:45:09.190948,Postres · Desayunos,Amelie Helados,23000,6400,29400
589,590,21-10-2020 14:45:09.348429,Desayunos,Butter,18900,6700,25600
590,591,21-10-2020 14:45:09.506345,Hamburguesas,Burger Society,53400,4100,57500
591,592,21-10-2020 14:45:09.763894,Pollo · Sánduches,Pollos Century,7500,3000,10500
592,593,21-10-2020 14:45:10.071502,Desayunos · Mexicana,La Mera Mera - Mexicana,17800,3100,20900
593,594,21-10-2020 14:45:10.278987,Típica · Parrilla,Mi Ranchito Parrilla,13600,4400,18000
594,595,21-10-2020 14:45:10.436559,Saludable,Hanai - Bowls Saludables,15600,5900,21500
595,596,21-10-2020 14:45:10.744384,Desayunos · Típica,Calentao Express,13600,6000,19600
596,597,21-10-2020 14:45:10.851853,Parrilla,Arepaisa de Medellín,35000,5600,40600
597,598,21-10-2020 14:45:11.009218,Pizza,pizza andante,23000,4200,27200
598,599,21-10-2020 14:45:11.116536,Desayunos · Panadería,Le Pain Quotidien,12500,3900,16400
599,600,21-10-2020 14:45:11.324114,Desayunos,Butter,15000,6700,21700
600,601,21-10-2020 14:45:11.631868,Parrilla,Arroces Maria Paula,35000,6800,41800
601,602,21-10-2020 14:45:11.839450,Parrilla,Parrilla Pimentón,13600,3400,17000
602,603,21-10-2020 14:45:12.046951,Desayunos · Jugos y Batidos,Kuriwaji,65000,6300,71300
603,604,21-10-2020 14:45:12.254535,China,China Food Col,8900,3600,12500
604,605,21-10-2020 14:45:12.362074,Desayunos · Comida Rápida,Chocolatto,53900,3400,57300
605,606,21-10-2020 14:45:12.569587,Pescados y Mariscos,Pescadero Héroes del Mar,34500,6600,41100
606,607,21-10-2020 14:45:12.927217,Típica,Sabrosito,7500,4000,11500
607,608,21-10-2020 14:45:13.184780,Postres · Saludable,Ana Rebana,35000,6300,41300
608,609,21-10-2020 14:45:13.393449,Panadería,Boul,45800,3100,48900
609,610,21-10-2020 14:45:13.751203,Postres · Café,Celestino Café,48750,5900,54650
610,611,21-10-2020 14:45:13.908691,Desayunos · Típica,Casa Vieja,37900,6000,43900
611,612,21-10-2020 14:45:14.216321,Desayunos · Típica,Alce,15000,4900,19900
612,613,21-10-2020 14:45:14.524109,Típica,Baondish,13000,5800,18800
613,614,21-10-2020 14:45:14.731740,Comida Rápida · Perros Calientes,Similoa - Comida Rapida,15000,3700,18700
614,615,21-10-2020 14:45:14.939317,Típica,La Olla de Barro,24300,5300,29600
615,616,21-10-2020 14:45:15.096862,Postres · Desayunos,Maria Luisa - Postres,12500,4300,16800
616,617,21-10-2020 14:45:15.254439,Pollo · Saludable,Yerbabuena,35000,3900,38900
617,618,21-10-2020 14:45:15.562260,Desayunos · Café,Moramia,24200,4700,28900
618,619,21-10-2020 14:45:15.669768,Desayunos · Típica,Papadió - Colombianas,31800,5700,37500
619,620,21-10-2020 14:45:15.827152,Típica · Parrilla,La Ternera Parrilla,31800,5200,37000
620,621,21-10-2020 14:45:15.984685,China,China Food Col,9000,3600,12600
621,622,21-10-2020 14:45:16.092165,Parrilla · Café,Gaira Café,34500,4400,38900
622,623,21-10-2020 14:45:16.249805,Desayunos · Pescados y Mariscos,Luzí­a - Mediterranea,13000,5700,18700
623,624,21-10-2020 14:45:16.457531,Desayunos,Desayunos en Bogotá,13000,3400,16400
624,625,21-10-2020 14:45:16.615038,Postres · Desayunos,Café Quindio,23000,5700,28700
625,626,21-10-2020 14:45:16.972897,China,China Food Col,15000,3600,18600
626,627,21-10-2020 14:45:17.330599,Desayunos · Panadería,Premium Break Bakery,10700,3700,14400
627,628,21-10-2020 14:45:17.688380,Saludable,MIMA,13600,3700,17300
628,629,21-10-2020 14:45:17.946462,Desayunos · Panadería,Ficchi Panadería,65000,3100,68100
629,630,21-10-2020 14:45:18.154038,Saludable · Desayunos,Fresh Co,10700,5600,16300
630,631,21-10-2020 14:45:18.311703,Postres · Desayunos,Protein Bakes,24300,5900,30200
631,632,21-10-2020 14:45:18.520241,Saludable · Desayunos,Re.al Alimentos Reales,9000,4000,13000
632,633,21-10-2020 14:45:18.627939,Pescados y Mariscos,Fish Place - Del Mar,9000,5400,14400
633,634,21-10-2020 14:45:18.935631,Saludable · Típica,Sopas Mrg,13000,3100,16100
634,635,21-10-2020 14:45:19.043222,Pollo,Señor Fantástico,34500,4700,39200
635,636,21-10-2020 14:45:19.200731,Saludable · Desayunos,Libre de Culpa,65000,4000,69000
636,637,21-10-2020 14:45:19.358203,Peruana,Uma Cantina Peruana,35000,3200,38200
637,638,21-10-2020 14:45:19.716027,Desayunos,Sunny Breakfast Brunch,12500,4300,16800
638,639,21-10-2020 14:45:19.973729,Típica · Parrilla,La Parilla de David,11870,3100,14970
639,640,21-10-2020 14:45:20.331520,Postres · Desayunos,Sharmus,53900,6100,60000
640,641,21-10-2020 14:45:20.489053,Pollo · Desayunos,Caserito Gourmet,8900,6700,15600
641,642,21-10-2020 14:45:20.796649,Desayunos,La Frijolada Desayunos,65000,4400,69400
642,643,21-10-2020 14:45:20.904197,Típica · Parrilla,El Portal de la Antigua,34500,5600,40100
643,644,21-10-2020 14:45:21.011753,Desayunos,El Fogón Castellano,24200,3200,27400
644,645,21-10-2020 14:45:21.119194,Postres · Desayunos,Vivalight Market.,37900,6500,44400
645,646,21-10-2020 14:45:21.226772,Hamburguesas,Gofi Burger,29500,5100,34600
646,647,21-10-2020 14:45:21.534460,Típica,Sabrosito,23000,4000,27000
647,648,21-10-2020 14:45:21.892268,Desayunos · Café,Frambas,13600,3400,17000
648,649,21-10-2020 14:45:22.049919,Italiana,Bocatto Di Passo,23000,5000,28000
649,650,21-10-2020 14:45:22.257620,Desayunos · Pescados y Mariscos,Gypsy Bistro,12500,4500,17000
650,651,21-10-2020 14:45:22.615447,Desayunos · Típica,D'Porco - Lechona,15000,6300,21300
651,652,21-10-2020 14:45:22.723170,Pizza,18 Scalini,9000,4300,13300
652,653,21-10-2020 14:45:23.030972,Mexicana,Cantina La 15,11870,4300,16170
653,654,21-10-2020 14:45:23.188545,Parrilla,OAK Ahumado y Brebajes,37900,6000,43900
654,655,21-10-2020 14:45:23.296190,Saludable · Desayunos,Distrito Gourmet,24300,3700,28000
655,656,21-10-2020 14:45:23.555125,Desayunos · Panadería,Limarys,53400,6500,59900
656,657,21-10-2020 14:45:23.813036,Saludable · Parrilla,The Angels Grill and Drinks,45800,6200,52000
657,658,21-10-2020 14:45:24.020792,Desayunos · Árabe,Boniato Sabores Vivos,70000,5300,75300
658,659,21-10-2020 14:45:24.178477,Desayunos · Panadería,Ficchi Panadería,39700,3100,42800
659,660,21-10-2020 14:45:24.336145,Postres · Desayunos,Café Quindio,23000,5700,28700
660,661,21-10-2020 14:45:24.643897,Desayunos · Panadería,El Pan de Phillippe,15000,4600,19600
661,662,21-10-2020 14:45:25.001754,Postres · Desayunos,Café Quindio,23000,5700,28700
662,663,21-10-2020 14:45:25.109378,Pollo · Típica,Auyama,24300,3900,28200
663,664,21-10-2020 14:45:25.417088,Postres,Levelma,24300,6200,30500
664,665,21-10-2020 14:45:25.624831,Poke,Poke Go,23000,4600,27600
665,666,21-10-2020 14:45:25.882578,Desayunos · Empanadas,Mis Delicias,70000,3200,73200
666,667,21-10-2020 14:45:26.190281,Peruana · Internacional,La Chifería,53400,6600,60000
667,668,21-10-2020 14:45:26.398038,Postres · Desayunos,Protein Bakes,17800,5900,23700
668,669,21-10-2020 14:45:26.555648,Saludable · Desayunos,Raices Bienestar Gourmet,10700,6600,17300
669,670,21-10-2020 14:45:26.813281,Desayunos · Panadería,Santa Juana Food Bar,10700,5900,16600
670,671,21-10-2020 14:45:27.020813,Desayunos · Panadería,Santa Juana Food Bar,18900,5900,24800
671,672,21-10-2020 14:45:27.278555,Desayunos · Típica,Cochon,39700,3300,43000
672,673,21-10-2020 14:45:27.486321,Pollo,Oliva Va,53900,5600,59500
673,674,21-10-2020 14:45:27.593956,Hamburguesas · Saludable,Restaurant Inn,13000,6100,19100
674,675,21-10-2020 14:45:27.801770,Pollo,Señor Fantástico,35000,4700,39700
675,676,21-10-2020 14:45:28.109618,Poke,Poke Go,53900,4600,58500
676,677,21-10-2020 14:45:28.267275,Típica,Cabrito Santandereano,15000,6600,21600
677,678,21-10-2020 14:45:28.474976,Desayunos · Comida Rápida,La Veneca,29500,6300,35800
678,679,21-10-2020 14:45:28.683573,Típica · Parrilla,La Parilla de David,9000,3100,12100
679,680,21-10-2020 14:45:28.991473,Desayunos · Café,Frambas,53900,3400,57300
680,681,21-10-2020 14:45:29.149116,Desayunos · Panadería,Ficchi Panadería,23000,3100,26100
681,682,21-10-2020 14:45:29.356722,Saludable · Típica,Saludable Mrg,29500,5800,35300
682,683,21-10-2020 14:45:29.714824,Saludable · Desayunos,Maracuyá,65000,6700,71700
683,684,21-10-2020 14:45:29.822428,Pollo · Sánduches,Pollos Century,15000,3000,18000
684,685,21-10-2020 14:45:30.130136,Helados,Orso To Go,13000,6800,19800
685,686,21-10-2020 14:45:30.488119,Parrilla · Internacional,Taperia de la Plaza,35000,5700,40700
686,687,21-10-2020 14:45:30.846147,Sushi,Kim Pop,10700,5400,16100
687,688,21-10-2020 14:45:31.003876,Pollo · Sánduches,Pollos Century,39700,3000,42700
688,689,21-10-2020 14:45:31.211986,Postres · Café,Loló Coffee & Snacks,7500,4600,12100
689,690,21-10-2020 14:45:31.469810,Típica,La Cocina,24300,4600,28900
690,691,21-10-2020 14:45:31.777593,Mexicana,Mexicanachos,35000,3900,38900
691,692,21-10-2020 14:45:32.135632,Saludable · Desayunos,Raices Bienestar Gourmet,15000,6600,21600
692,693,21-10-2020 14:45:32.243436,Mexicana,La leyenda mexican kitchen,24300,3200,27500
693,694,21-10-2020 14:45:32.401059,Desayunos,La Frijolada Desayunos,15600,4400,20000
694,695,21-10-2020 14:45:32.759012,Desayunos · Panadería,Limarys,27800,6500,34300
695,696,21-10-2020 14:45:33.016797,Sushi · Asiática,Arigato,31800,5300,37100
696,697,21-10-2020 14:45:33.224493,Típica,Bandejas Mrg,27800,3800,31600
697,698,21-10-2020 14:45:33.482400,Desayunos · Panadería,Siena Café,18900,3700,22600
698,699,21-10-2020 14:45:33.842113,Típica,Lo Nuestro,34500,3100,37600
699,700,21-10-2020 14:45:34.000099,Postres · Desayunos,Jacques Pastelería,15600,5900,21500
700,701,21-10-2020 14:45:34.107964,Parrilla · Internacional,Taperia de la Plaza,48750,5700,54450
701,702,21-10-2020 14:45:34.466051,Desayunos · Panadería,Decofruta,15000,4700,19700
702,703,21-10-2020 14:45:34.824048,Desayunos,Butter,53400,6700,60100
703,704,21-10-2020 14:45:34.982013,Típica,Sopitas y Más,24300,4200,28500
704,705,21-10-2020 14:45:35.139823,Desayunos · Panadería,Ficchi Panadería,11870,3100,14970
705,706,21-10-2020 14:45:35.347610,Pescados y Mariscos,La Gran Cazuela,24300,3200,27500
706,707,21-10-2020 14:45:35.655528,Pollo,Señor Fantástico,35000,4700,39700
707,708,21-10-2020 14:45:35.963439,Hamburguesas · Saludable,Restaurant Inn,37900,6100,44000
708,709,21-10-2020 14:45:36.071034,Pollo · Desayunos,Workzone,23000,3100,26100
709,710,21-10-2020 14:45:36.278824,Típica · Parrilla,El Portal de la Antigua,24200,5600,29800
710,711,21-10-2020 14:45:36.486722,Desayunos,Archies Desayunos,53900,3100,57000
711,712,21-10-2020 14:45:36.594593,Hamburguesas · Saludable,Restaurant Inn,39700,6100,45800
712,713,21-10-2020 14:45:36.852572,Desayunos · Típica,D´Porco,31800,3900,35700
713,714,21-10-2020 14:45:37.010298,Parrilla,Parrilla Pimentón,31800,3400,35200
714,715,21-10-2020 14:45:37.318251,Pollo · Desayunos,Workzone,13000,3100,16100
715,716,21-10-2020 14:45:37.576177,Postres · Desayunos,Sharmus,39700,6100,45800
716,717,21-10-2020 14:45:37.834097,Postres,Beiked,29500,4000,33500
717,718,21-10-2020 14:45:37.941800,Postres,Levelma,11870,6200,18070
718,719,21-10-2020 14:45:38.149695,Saludable · Desayunos,Raices Bienestar Gourmet,35000,6600,41600
719,720,21-10-2020 14:45:38.307460,Típica,El Mondongo y Mucho Mas,12500,5600,18100
720,721,21-10-2020 14:45:38.515403,Alta Cocina · Parrilla,Criterión,18900,6000,24900
721,722,21-10-2020 14:45:38.673207,Desayunos · Panadería,Siena Café,48750,3700,52450
722,723,21-10-2020 14:45:38.780803,Pollo · Desayunos,Piaf,39700,6500,46200
723,724,21-10-2020 14:45:39.039610,Saludable · Desayunos,Raices Bienestar Gourmet,13600,6600,20200
724,725,21-10-2020 14:45:39.297714,Desayunos,Fratelli - Desayunos,7500,4600,12100
725,726,21-10-2020 14:45:39.655754,Desayunos · Panadería,Siena Café,7500,3700,11200
726,727,21-10-2020 14:45:40.013683,Desayunos · Mexicana,La Mera Mera - Mexicana,70000,3100,73100
727,728,21-10-2020 14:45:40.121384,Peruana · Internacional,La Chifería,45800,6600,52400
728,729,21-10-2020 14:45:40.279058,Pollo,Heart & Cooking,10700,5000,15700
729,730,21-10-2020 14:45:40.486845,Pescados y Mariscos,La Gran Cazuela,10700,3200,13900
730,731,21-10-2020 14:45:40.594571,Desayunos · Típica,Fogón Sangileño,13000,5000,18000
731,732,21-10-2020 14:45:40.952596,Asiática,TeT,48750,5900,54650
732,733,21-10-2020 14:45:41.310588,Desayunos · Mexicana,La Mera Mera - Mexicana,9000,3100,12100
733,734,21-10-2020 14:45:41.668644,Pollo,Oliva Va,13600,5600,19200
734,735,21-10-2020 14:45:41.976621,Desayunos,La Frijolada Desayunos,53400,4400,57800
735,736,21-10-2020 14:45:42.134548,Desayunos · Panadería,Juliana Restaurante,65000,6100,71100
736,737,21-10-2020 14:45:42.292391,Parrilla,Rústico Picadería,35000,3800,38800
737,738,21-10-2020 14:45:42.400170,Desayunos,El Fogón Castellano,53900,3200,57100
738,739,21-10-2020 14:45:42.508058,Parrilla,Antojo a Domicilio,29500,5000,34500
739,740,21-10-2020 14:45:42.766153,Parrilla,Parrilla Pimentón,15000,3400,18400
740,741,21-10-2020 14:45:43.124248,Desayunos · Panadería,Artesanos,17800,4300,22100
741,742,21-10-2020 14:45:43.332300,Jugos y Batidos,Pomponio,13000,3600,16600
742,743,21-10-2020 14:45:43.540408,Parrilla,Parrilla Pimentón,7500,3400,10900
743,744,21-10-2020 14:45:43.748428,Típica,Lo Nuestro,34500,3100,37600
744,745,21-10-2020 14:45:43.906294,Saludable · Desayunos,Malú,9000,3700,12700
745,746,21-10-2020 14:45:44.014257,Desayunos,Señor Desayuno,17800,6800,24600
746,747,21-10-2020 14:45:44.223388,Pizza,pizza andante,9000,4200,13200
747,748,21-10-2020 14:45:44.431500,Hamburguesas,Gofi Burger,34500,5100,39600
748,749,21-10-2020 14:45:44.589386,Desayunos · Típica,D'Porco - Lechona,39700,6300,46000
749,750,21-10-2020 14:45:44.847412,Desayunos · Jugos y Batidos,Frutiwow,53900,4100,58000
750,751,21-10-2020 14:45:45.055417,Desayunos · Empanadas,Empanadas Doraditas.com,34500,3000,37500
751,752,21-10-2020 14:45:45.263478,Pollo · Desayunos,Workzone,24200,3100,27300
752,753,21-10-2020 14:45:45.521640,Mexicana,La leyenda mexican kitchen,9000,3200,12200
753,754,21-10-2020 14:45:45.729557,Típica,Sabores De Mi Tierra,35000,5400,40400
754,755,21-10-2020 14:45:45.887418,Saludable · Desayunos,Maracuyá,29500,6700,36200
755,756,21-10-2020 14:45:46.095409,Hamburguesas · Alitas,Beer,53400,6600,60000
756,757,21-10-2020 14:45:46.253355,Internacional,Rio Sabores y Experiencias,15600,4100,19700
757,758,21-10-2020 14:45:46.361089,Desayunos · Comida Rápida,La Veneca,45800,6300,52100
758,759,21-10-2020 14:45:46.468831,Pollo · Saludable,Yerbabuena,8900,3900,12800
759,760,21-10-2020 14:45:46.826923,Saludable · Desayunos,Bon Eat - Saludable,39700,4800,44500
760,761,21-10-2020 14:45:46.984670,Saludable · Desayunos,Copacabana Açai Bowls,18900,3000,21900
761,762,21-10-2020 14:45:47.342754,Típica,Sabores De Mi Tierra,65000,5400,70400
762,763,21-10-2020 14:45:47.450516,Peruana · Internacional,La Chifería,53900,6600,60500
763,764,21-10-2020 14:45:47.808660,Postres · Café,Celestino Café,31800,5900,37700
764,765,21-10-2020 14:45:47.916441,Café · Helados,Sofia heladería y café,11870,5800,17670
765,766,21-10-2020 14:45:48.074344,Desayunos · Panadería,Premium Break Bakery,35000,3700,38700
766,767,21-10-2020 14:45:48.332342,Saludable · Parrilla,The Angels Grill and Drinks,39700,6200,45900
767,768,21-10-2020 14:45:48.690482,Desayunos · Jugos y Batidos,Kuriwaji,17800,6300,24100
768,769,21-10-2020 14:45:48.898538,Postres · Desayunos,Maltihelado,65000,4500,69500
769,770,21-10-2020 14:45:49.206591,Parrilla,Parrilla Pimentón,37900,3400,41300
770,771,21-10-2020 14:45:49.465603,Sushi,Kim Pop,35000,5400,40400
771,772,21-10-2020 14:45:49.673759,Parrilla,Arepaisa de Medellín,11870,5600,17470
772,773,21-10-2020 14:45:49.831553,Típica,La Olla de Barro,18900,5300,24200
773,774,21-10-2020 14:45:50.189672,Saludable · Desayunos,Agua Dulce,48750,3700,52450
774,775,21-10-2020 14:45:50.397650,Típica,Carbón & Mondongos,35000,6400,41400
775,776,21-10-2020 14:45:50.555609,Alta Cocina · Italiana,Trattoria de la Plaza,39700,6000,45700
776,777,21-10-2020 14:45:50.863754,Pollo · Saludable,Gratina,8900,4200,13100
777,778,21-10-2020 14:45:51.021588,Parrilla,Carnes la Zarza,29500,4900,34400
778,779,21-10-2020 14:45:51.379866,Desayunos · Típica,Fogón Sangileño,35000,5000,40000
779,780,21-10-2020 14:45:51.687958,Desayunos · Típica,Parrilla Farandula Típico,31800,5900,37700
780,781,21-10-2020 14:45:51.996201,Saludable,Puro Verde,34500,5700,40200
781,782,21-10-2020 14:45:52.204185,Saludable,Puro Verde,31800,5700,37500
782,783,21-10-2020 14:45:52.512161,Crepes,La Chabatta,37900,5900,43800
783,784,21-10-2020 14:45:52.820385,Sushi,Kim Pop,39700,5400,45100
784,785,21-10-2020 14:45:53.078420,Postres · Desayunos,Sweet Tale,35000,5800,40800
785,786,21-10-2020 14:45:53.186276,Postres · Helados,Mahé,34500,6000,40500
786,787,21-10-2020 14:45:53.294184,Desayunos · Café,Matchacha,10700,5900,16600
787,788,21-10-2020 14:45:53.452071,Postres · Saludable,Ana Rebana,15000,6300,21300
788,789,21-10-2020 14:45:53.810369,Crepes,San Crepes,34500,4900,39400
789,790,21-10-2020 14:45:54.018388,Desayunos · Típica,Rojo Gourmet,29500,4700,34200
790,791,21-10-2020 14:45:54.126251,Desayunos,Señor Desayuno,8900,6800,15700
791,792,21-10-2020 14:45:54.384316,Saludable · Desayunos,La Cesta,13000,4700,17700
792,793,21-10-2020 14:45:54.543589,Desayunos · Panadería,Decofruta,48750,4700,53450
793,794,21-10-2020 14:45:54.651675,Desayunos · Panadería,Juliana Restaurante,12500,6100,18600
794,795,21-10-2020 14:45:55.009965,Desayunos · Típica,90 Calentados,29500,3700,33200
795,796,21-10-2020 14:45:55.267998,Postres · Panadería,RIGHT AWAY FOODS,37900,6600,44500
796,797,21-10-2020 14:45:55.526314,Postres · Desayunos,BagBog Bagels,15000,6400,21400
797,798,21-10-2020 14:45:55.634228,Desayunos · Típica,La Frijolada,31800,4500,36300
798,799,21-10-2020 14:45:55.742240,Parrilla,Arepaisa de Medellín,70000,5600,75600
799,800,21-10-2020 14:45:56.050704,Desayunos · Panadería,Premium Break Bakery,53400,3700,57100
800,801,21-10-2020 14:45:56.258737,Postres · Desayunos,Protein Bakes,53900,5900,59800
801,802,21-10-2020 14:45:56.466890,Desayunos · Típica,Desayunadero de la 42,48750,5900,54650
802,803,21-10-2020 14:45:56.675059,Saludable · Desayunos,Re.al Alimentos Reales,12500,4000,16500
803,804,21-10-2020 14:45:56.983166,Sánduches,Submarin,34500,3800,38300
804,805,21-10-2020 14:45:57.291351,Desayunos · Típica,90 Calentados,48750,3700,52450
805,806,21-10-2020 14:45:57.399365,Mexicana,La leyenda mexican kitchen,10700,3200,13900
806,807,21-10-2020 14:45:57.507389,Hamburguesas · Alitas,Beer,24300,6600,30900
807,808,21-10-2020 14:45:57.665456,Típica,Bendita S,17800,4600,22400
808,809,21-10-2020 14:45:58.023661,Típica,Salsig,24200,5600,29800
809,810,21-10-2020 14:45:58.281745,Pollo · Sánduches,Pollos Century,13000,3000,16000
810,811,21-10-2020 14:45:58.590062,Pescados y Mariscos,La Gran Cazuela,48750,3200,51950
811,812,21-10-2020 14:45:58.698299,Desayunos · Típica,90 Calentados,70000,3700,73700
812,813,21-10-2020 14:45:59.006680,Sushi · Asiática,Tu Sushi,34500,6400,40900
813,814,21-10-2020 14:45:59.164861,Típica,El Cucharón - Tipica,15000,4400,19400
814,815,21-10-2020 14:45:59.423216,Desayunos · Sánduches,Garnish,12500,5200,17700
815,816,21-10-2020 14:45:59.632389,Internacional,La Esquina con Sabor Parrilla,17800,3000,20800
816,817,21-10-2020 14:45:59.890677,Alta Cocina · Parrilla,Criterión,13000,6000,19000
817,818,21-10-2020 14:46:00.048669,Pollo · Típica,Auyama,18900,3900,22800
818,819,21-10-2020 14:46:00.306731,Postres · Desayunos,Sharmus,53400,6100,59500
819,820,21-10-2020 14:46:00.664939,Desayunos,Jacinta Arepas de Huevo,53400,4000,57400
820,821,21-10-2020 14:46:00.822854,Postres · Desayunos,Maria Luisa - Postres,65000,4300,69300
821,822,21-10-2020 14:46:01.080976,Típica,Bendita S,9000,4600,13600
822,823,21-10-2020 14:46:01.239002,Saludable,Puro Verde,53400,5700,59100
823,824,21-10-2020 14:46:01.397229,Típica · Parrilla,La Parilla de David,45800,3100,48900
824,825,21-10-2020 14:46:01.555317,Desayunos,Sunny Breakfast Brunch,48750,4300,53050
825,826,21-10-2020 14:46:01.813452,Pizza · Italiana,Piatto - Pizza,8900,6600,15500
826,827,21-10-2020 14:46:02.071526,Desayunos · Típica,Alce,70000,4900,74900
827,828,21-10-2020 14:46:02.279640,Postres · Desayunos,Vivalight Market.,12500,6500,19000
828,829,21-10-2020 14:46:02.537722,Desayunos · Café,Moramia,23000,4700,27700
829,830,21-10-2020 14:46:02.796012,Postres · Desayunos,Buñuelos nacho,15000,6600,21600
830,831,21-10-2020 14:46:02.954130,Postres · Desayunos,Maltihelado,29500,4500,34000
831,832,21-10-2020 14:46:03.112185,Desayunos,Sr Buñuelo,9000,6400,15400
832,833,21-10-2020 14:46:03.420465,Pescados y Mariscos,La Gran Cazuela,10700,3200,13900
833,834,21-10-2020 14:46:03.628710,Sánduches,Submarin,35000,3800,38800
834,835,21-10-2020 14:46:03.786938,Internacional,Rio Sabores y Experiencias,11870,4100,15970
835,836,21-10-2020 14:46:04.145407,Saludable · Desayunos,Libre de Culpa,17800,4000,21800
836,837,21-10-2020 14:46:04.403665,Parrilla,Arepaisa de Medellín,15600,5600,21200
837,838,21-10-2020 14:46:04.713334,Parrilla,Parrilla Pimentón,35000,3400,38400
838,839,21-10-2020 14:46:05.071641,Desayunos · Panadería,Pasteleite,31800,5900,37700
839,840,21-10-2020 14:46:05.179749,Postres,Levelma,17800,6200,24000
840,841,21-10-2020 14:46:05.337910,Saludable · Parrilla,The Angels Grill and Drinks,48750,6200,54950
841,842,21-10-2020 14:46:05.446049,Saludable · Desayunos,Bawana - Sandwich,53400,3400,56800
842,843,21-10-2020 14:46:05.604150,Mexicana,Hidalgo Taquería,13600,4900,18500
843,844,21-10-2020 14:46:05.712289,Pizza,Pastas Laurentina,13600,4800,18400
844,845,21-10-2020 14:46:05.920794,Postres · Desayunos,Maria Luisa - Postres,39700,4300,44000
845,846,21-10-2020 14:46:06.228915,Parrilla · Café,Figaro Café/ Restaurante Argentino,23000,5800,28800
846,847,21-10-2020 14:46:06.487123,Internacional,Rio Sabores y Experiencias,13600,4100,17700
847,848,21-10-2020 14:46:06.745423,Típica,Cabrito Santandereano,53900,6600,60500
848,849,21-10-2020 14:46:06.903519,Perros Calientes,Dog Shop - Rapida,65000,4900,69900
849,850,21-10-2020 14:46:07.061601,Pizza,Pizza Andante,45800,6300,52100
850,851,21-10-2020 14:46:07.269641,Pollo · Desayunos,Caserito Gourmet,23000,6700,29700
851,852,21-10-2020 14:46:07.377893,Pollo · Desayunos,Piaf,13000,6500,19500
852,853,21-10-2020 14:46:07.586123,Típica · Pescados y Mariscos,La Vitualla,17800,6300,24100
853,854,21-10-2020 14:46:07.894532,Desayunos · Panadería,Ficchi Panadería,13600,3100,16700
854,855,21-10-2020 14:46:08.252898,Desayunos · Típica,Peninsula Calentados y Parrilla,13600,3400,17000
855,856,21-10-2020 14:46:08.611282,Sushi · Asiática,Arigato,24200,5300,29500
856,857,21-10-2020 14:46:08.919626,Típica,Lo Nuestro,34500,3100,37600
857,858,21-10-2020 14:46:09.027778,Saludable · Desayunos,Copacabana Açai Bowls,53900,3000,56900
858,859,21-10-2020 14:46:09.186043,Pollo,Chicken House,13000,4200,17200
859,860,21-10-2020 14:46:09.494451,Saludable · Desayunos,La Estampilla,27800,6000,33800
860,861,21-10-2020 14:46:09.753667,Postres,La Tertulia,39700,3400,43100
861,862,21-10-2020 14:46:09.912335,Postres · Desayunos,Amelie Helados,9000,6400,15400
862,863,21-10-2020 14:46:10.220844,Típica,Cazuelitas 93,23000,3900,26900
863,864,21-10-2020 14:46:10.328907,Saludable · Desayunos,Copacabana Açai Bowls,31800,3000,34800
864,865,21-10-2020 14:46:10.487017,Hamburguesas,Monchis - Hamburguesa,24200,4300,28500
865,866,21-10-2020 14:46:10.645193,Desayunos · Italiana,Rceta By Rausch,70000,3600,73600
866,867,21-10-2020 14:46:10.903382,Sushi,Kim Pop,34500,5400,39900
867,868,21-10-2020 14:46:11.211630,Desayunos · Empanadas,Mis Delicias,37900,3200,41100
868,869,21-10-2020 14:46:11.419914,Desayunos · Típica,Cochon,9000,3300,12300
869,870,21-10-2020 14:46:11.628192,Italiana,F*cking Good Pizza,7500,4200,11700
870,871,21-10-2020 14:46:11.736425,Saludable · Jugos y Batidos,Berdes Drinks & Salads,45800,3500,49300
871,872,21-10-2020 14:46:12.044738,Sushi,Canoa To Go,23000,5900,28900
872,873,21-10-2020 14:46:12.302973,Desayunos,Sr Buñuelo,7500,6400,13900
873,874,21-10-2020 14:46:12.411176,Postres · Desayunos,La Folie - Postres,70000,3300,73300
874,875,21-10-2020 14:46:12.619296,Postres · Café,Celestino Café,12500,5900,18400
875,876,21-10-2020 14:46:12.777457,Desayunos · Italiana,Rceta By Rausch,23000,3600,26600
876,877,21-10-2020 14:46:12.885488,Pollo · Pescados y Mariscos,Bang Bang Rice,48750,3400,52150
877,878,21-10-2020 14:46:13.093686,Saludable · Parrilla,The Angels Grill and Drinks,15000,6200,21200
878,879,21-10-2020 14:46:13.351935,Postres · Café,Celestino Café,9000,5900,14900
879,880,21-10-2020 14:46:13.660473,Típica,Sabrosito,45800,4000,49800
880,881,21-10-2020 14:46:13.918804,Desayunos · Típica,Peninsula Calentados y Parrilla,9000,3400,12400
881,882,21-10-2020 14:46:14.277283,Desayunos · Italiana,Rceta By Rausch,70000,3600,73600
882,883,21-10-2020 14:46:14.385413,Típica · Parrilla,Mi Ranchito Parrilla,12500,4400,16900
883,884,21-10-2020 14:46:14.693722,Desayunos · Típica,90 Calentados,70000,3700,73700
884,885,21-10-2020 14:46:14.853421,Pollo · Pescados y Mariscos,Bang Bang Rice,39700,3400,43100
885,886,21-10-2020 14:46:14.961719,Desayunos · Pescados y Mariscos,Gypsy Bistro,53900,4500,58400
886,887,21-10-2020 14:46:15.220146,Desayunos · Típica,Papadió - Colombianas,8900,5700,14600
887,888,21-10-2020 14:46:15.428419,Desayunos · Empanadas,Mis Delicias,10700,3200,13900
888,889,21-10-2020 14:46:15.636703,Desayunos · Panadería,Ficchi Panadería,29500,3100,32600
889,890,21-10-2020 14:46:15.894986,Desayunos · Jugos y Batidos,Frutiwow,48750,4100,52850
890,891,21-10-2020 14:46:16.253452,Hamburguesas · Alitas,Beer,39700,6600,46300
891,892,21-10-2020 14:46:16.411640,Típica · Parrilla,Toya,15000,4200,19200
892,893,21-10-2020 14:46:16.619980,Saludable,Ventura Soup y Salad,70000,3800,73800
893,894,21-10-2020 14:46:16.828379,Pizza · Italiana,Pisapore - Pizza,53900,6600,60500
894,895,21-10-2020 14:46:16.986704,Desayunos · Panadería,Santa Juana Food Bar,65000,5900,70900
895,896,21-10-2020 14:46:17.094931,Asiática,TeT,23000,5900,28900
896,897,21-10-2020 14:46:17.453449,Desayunos,Bagel Shop,7500,3200,10700
897,898,21-10-2020 14:46:17.711781,Pollo · Saludable,Gratina,24300,4200,28500
898,899,21-10-2020 14:46:17.870007,Pollo · Saludable,Yerbabuena,24300,3900,28200
899,900,21-10-2020 14:46:18.028217,Típica · Parrilla,Typykos,23000,6000,29000
900,901,21-10-2020 14:46:18.336807,Típica,Juan Chorizo,35000,3900,38900
901,902,21-10-2020 14:46:18.545261,Parrilla,Campocina,35000,4600,39600
902,903,21-10-2020 14:46:18.703489,China,China Food Col,23000,3600,26600
903,904,21-10-2020 14:46:18.861922,Crepes,La Chabatta,8900,5900,14800
904,905,21-10-2020 14:46:19.070262,Parrilla,Restaurante Bar Mi Ranchito,29500,5200,34700
905,906,21-10-2020 14:46:19.428745,Saludable,Amor Propio saludable,17800,4000,21800
906,907,21-10-2020 14:46:19.737216,Hamburguesas,Gofi Burger,29500,5100,34600
907,908,21-10-2020 14:46:20.095746,Típica,Salsig,24300,5600,29900
908,909,21-10-2020 14:46:20.354201,Desayunos · Panadería,Le Pain Quotidien,65000,3900,68900
909,910,21-10-2020 14:46:20.712803,Desayunos · Panadería,Pasteleite,65000,5900,70900
910,911,21-10-2020 14:46:20.871219,Desayunos · Panadería,Artesanos,27800,4300,32100
911,912,21-10-2020 14:46:21.129643,Típica,Salsig,53900,5600,59500
912,913,21-10-2020 14:46:21.388034,Típica,El Cucharón - Tipica,29500,4400,33900
913,914,21-10-2020 14:46:21.746639,Típica · Parrilla,Mi Ranchito Parrilla,17800,4400,22200
914,915,21-10-2020 14:46:22.005058,Desayunos · Café,Aromacafé el Placer de Compartir,18900,5000,23900
915,916,21-10-2020 14:46:22.213344,Comida Rápida · Perros Calientes,Similoa - Comida Rapida,29500,3700,33200
916,917,21-10-2020 14:46:22.371557,Postres · Desayunos,KOKOA & co.,70000,4700,74700
917,918,21-10-2020 14:46:22.679978,Saludable,Amor Propio saludable,70000,4000,74000
918,919,21-10-2020 14:46:22.988474,Pollo,Señor Fantástico,13600,4700,18300
919,920,21-10-2020 14:46:23.296865,Mexicana,Mexicanachos,7500,3900,11400
920,921,21-10-2020 14:46:23.505159,Parrilla,OAK Ahumado y Brebajes,8900,6000,14900
921,922,21-10-2020 14:46:23.863892,Desayunos,Sunny Breakfast Brunch,10700,4300,15000
922,923,21-10-2020 14:46:24.072256,Típica,Sopitas y Más,17800,4200,22000
923,924,21-10-2020 14:46:24.230486,Saludable · Parrilla,Box,23000,3700,26700
924,925,21-10-2020 14:46:24.388847,Hamburguesas · Saludable,Restaurant Inn,24200,6100,30300
925,926,21-10-2020 14:46:24.697477,Postres · Desayunos,Aury Postres - Comidas & Picadas,13600,4700,18300
926,927,21-10-2020 14:46:24.855858,Pollo · Desayunos,Abasto,23000,3600,26600
927,928,21-10-2020 14:46:25.064174,Sushi,Umi,45800,5600,51400
928,929,21-10-2020 14:46:25.423898,Típica · Parrilla,Toya,37900,4200,42100
929,930,21-10-2020 14:46:25.582478,Pollo · Típica,Auyama,70000,3900,73900
930,931,21-10-2020 14:46:25.690717,Pollo · Saludable,Yerbabuena,39700,3900,43600
931,932,21-10-2020 14:46:25.949238,Postres · Saludable,Ana Rebana,48750,6300,55050
932,933,21-10-2020 14:46:26.157533,Pescados y Mariscos,Pescadero Héroes del Mar,13000,6600,19600
933,934,21-10-2020 14:46:26.415921,Postres · Desayunos,Gelateria Da Favola,15600,6500,22100
934,935,21-10-2020 14:46:26.524236,Pizza,Pastas Laurentina,39700,4800,44500
935,936,21-10-2020 14:46:26.632472,Típica,Sopitas y Más,35000,4200,39200
936,937,21-10-2020 14:46:26.790750,Sánduches,Submarin,34500,3800,38300
937,938,21-10-2020 14:46:26.999242,Panadería,Boul,70000,3100,73100
938,939,21-10-2020 14:46:27.157806,Postres · Panadería,RIGHT AWAY FOODS,15000,6600,21600
939,940,21-10-2020 14:46:27.366286,Café · Helados,Sofia heladería y café,70000,5800,75800
940,941,21-10-2020 14:46:27.674963,Saludable · Desayunos,Guadalupe - Fruteria,45800,5900,51700
941,942,21-10-2020 14:46:27.933508,Desayunos · Café,El Gualilo,23000,6200,29200
942,943,21-10-2020 14:46:28.192014,Desayunos,Jacinta Arepas de Huevo,10700,4000,14700
943,944,21-10-2020 14:46:28.450517,Postres · Desayunos,Sweet Tale,37900,5800,43700
944,945,21-10-2020 14:46:28.659308,Desayunos · Panadería,Limarys,15600,6500,22100
945,946,21-10-2020 14:46:28.867977,Desayunos · Parrilla,Mi Patria,29500,4600,34100
946,947,21-10-2020 14:46:29.026368,Hamburguesas,Burger Society,7500,4100,11600
947,948,21-10-2020 14:46:29.234898,Parrilla,Rústico Picadería,48750,3800,52550
948,949,21-10-2020 14:46:29.443445,Perros Calientes,Dog Shop - Rapida,35000,4900,39900
949,950,21-10-2020 14:46:29.702050,Desayunos · Típica,D'Porco - Lechona,12500,6300,18800
950,951,21-10-2020 14:46:29.960668,Saludable,Amor Propio saludable,31800,4000,35800
951,952,21-10-2020 14:46:30.219220,Típica,Cabrito Santandereano,15600,6600,22200
952,953,21-10-2020 14:46:30.529386,Saludable · Desayunos,Re.al Alimentos Reales,7500,4000,11500
953,954,21-10-2020 14:46:30.637854,Postres · Desayunos,Amelie Helados,48750,6400,55150
954,955,21-10-2020 14:46:30.896433,Típica,La Olla de Barro,24300,5300,29600
955,956,21-10-2020 14:46:31.054953,Desayunos,La Frijolada Desayunos,7500,4400,11900
956,957,21-10-2020 14:46:31.213353,Desayunos,Jacinta Arepas de Huevo,70000,4000,74000
957,958,21-10-2020 14:46:31.371758,Crepes,La Chabatta,34500,5900,40400
958,959,21-10-2020 14:46:31.580347,Italiana,F*cking Good Pizza,8900,4200,13100
959,960,21-10-2020 14:46:31.888936,Desayunos,El Corral - Desayunos,35000,5000,40000
960,961,21-10-2020 14:46:31.997239,Desayunos · Italiana,Rceta By Rausch,11870,3600,15470
961,962,21-10-2020 14:46:32.155662,Desayunos · Jugos y Batidos,Dont Be Hungry,7500,5600,13100
962,963,21-10-2020 14:46:32.314184,Pollo · Saludable,Yerbabuena,45800,3900,49700
963,964,21-10-2020 14:46:32.422566,Postres · Desayunos,Maria Luisa - Postres,15600,4300,19900
964,965,21-10-2020 14:46:32.530834,Hamburguesas,Monchis - Hamburguesa,15000,4300,19300
965,966,21-10-2020 14:46:32.689286,Pollo,Chicken House,39700,4200,43900
966,967,21-10-2020 14:46:32.997792,Pescados y Mariscos,La Gran Cazuela,39700,3200,42900
967,968,21-10-2020 14:46:33.306311,Pollo · Saludable,Tremenda Sal y Dulce,23000,6500,29500
968,969,21-10-2020 14:46:33.664975,Saludable · Jugos y Batidos,Berdes Drinks & Salads,45800,3500,49300
969,970,21-10-2020 14:46:33.773298,Saludable · Desayunos,Fresh Co,31800,5600,37400
970,971,21-10-2020 14:46:33.981655,Desayunos · Pescados y Mariscos,Gypsy Bistro,34500,4500,39000
971,972,21-10-2020 14:46:34.140061,Panadería,Boul,8900,3100,12000
972,973,21-10-2020 14:46:34.448622,Desayunos,El Fogón Castellano,37900,3200,41100
973,974,21-10-2020 14:46:34.807389,Pollo,Oliva Va,31800,5600,37400
974,975,21-10-2020 14:46:34.915836,Hamburguesas · Pescados y Mariscos,El Velero,24300,6500,30800
975,976,21-10-2020 14:46:35.124347,Desayunos · Típica,La Parrilla Dorada Polo,37900,6600,44500
976,977,21-10-2020 14:46:35.382921,Saludable · Desayunos,Malú,24300,3700,28000
977,978,21-10-2020 14:46:35.592946,Desayunos · Helados,San Giorgio Gelateria,27800,3100,30900
978,979,21-10-2020 14:46:35.952406,Desayunos · Internacional,Camilia,13000,3900,16900
979,980,21-10-2020 14:46:36.311874,Desayunos · Típica,D'Porco - Lechona,65000,6300,71300
980,981,21-10-2020 14:46:36.570938,Pollo,Heart & Cooking,17800,5000,22800
981,982,21-10-2020 14:46:36.930351,Pollo,Señor Fantástico,13000,4700,17700
982,983,21-10-2020 14:46:37.189561,Peruana · Internacional,La Chifería,18900,6600,25500
983,984,21-10-2020 14:46:37.549067,Desayunos · Típica,Alce,10700,4900,15600
984,985,21-10-2020 14:46:37.657981,Saludable · Parrilla,The Angels Grill and Drinks,17800,6200,24000
985,986,21-10-2020 14:46:37.967401,Hamburguesas · Desayunos,El Inglés Gastro Pub,15000,6600,21600
986,987,21-10-2020 14:46:38.126474,Postres · Desayunos,Sharmus,13600,6100,19700
987,988,21-10-2020 14:46:38.285633,China,China Food Col,39700,3600,43300
988,989,21-10-2020 14:46:38.445018,Peruana · Internacional,La Chifería,7500,6600,14100
989,990,21-10-2020 14:46:38.753671,Saludable · Desayunos,Copacabana Açai Bowls,45800,3000,48800
990,991,21-10-2020 14:46:39.013042,Desayunos · Panadería,Le Pain Quotidien,23000,3900,26900
991,992,21-10-2020 14:46:39.371865,Italiana,F*cking Good Pizza,23000,4200,27200
992,993,21-10-2020 14:46:39.681465,Saludable · Desayunos,Bawana - Sandwich,29500,3400,32900
993,994,21-10-2020 14:46:39.940031,Parrilla,Rústico Picadería,17800,3800,21600
994,995,21-10-2020 14:46:40.249379,Desayunos · Jugos y Batidos,Frutiwow,13600,4100,17700
995,996,21-10-2020 14:46:40.558100,Desayunos · Panadería,Choclofee,24200,4700,28900
996,997,21-10-2020 14:46:40.718278,Desayunos · Sánduches,Garnish,13000,5200,18200
997,998,21-10-2020 14:46:40.977098,Saludable · Desayunos,Fresh Co,13000,5600,18600
998,999,21-10-2020 14:46:41.136455,Parrilla,Restaurante Bar Mi Ranchito,45800,5200,51000
999,1000,21-10-2020 14:46:41.245084,Pizza · Italiana,Piatto - Pizza,27800,6600,34400
1000,1001,21-10-2020 14:46:41.404301,Postres · Café,Loló Coffee & Snacks,7500,4600,12100
1001,1002,21-10-2020 14:46:41.512686,Saludable · Desayunos,Distrito Gourmet,65000,3700,68700
1002,1003,21-10-2020 14:46:41.871624,Pollo,Señor Fantástico,53900,4700,58600
1003,1004,21-10-2020 14:46:42.080228,Desayunos,Bagel Shop,7500,3200,10700
1004,1005,21-10-2020 14:46:42.439180,Pollo,Chicken House,53900,4200,58100
1005,1006,21-10-2020 14:46:42.547685,Desayunos,El Corral - Desayunos,18900,5000,23900
1006,1007,21-10-2020 14:46:42.856331,Parrilla,Coquitas,10700,5600,16300
1007,1008,21-10-2020 14:46:43.165035,Típica,Bandejas Mrg,53900,3800,57700
1008,1009,21-10-2020 14:46:43.523686,Típica,Lo Nuestro,12500,3100,15600
1009,1010,21-10-2020 14:46:43.832460,Desayunos · Típica,Fogón Sangileño,12500,5000,17500
1010,1011,21-10-2020 14:46:43.990926,Parrilla,Beraca Parrilla Bbq,15000,5600,20600
1011,1012,21-10-2020 14:46:44.149484,Desayunos · Empanadas,Mis Delicias,13000,3200,16200
1012,1013,21-10-2020 14:46:44.508182,Sushi · Asiática,Arigato,53900,5300,59200
1013,1014,21-10-2020 14:46:44.867000,Peruana · Internacional,La Chifería,53900,6600,60500
1014,1015,21-10-2020 14:46:45.225859,Típica,La Herencia,7500,5900,13400
1015,1016,21-10-2020 14:46:45.384394,Saludable · Desayunos,Maracuyá,8900,6700,15600
1016,1017,21-10-2020 14:46:45.693300,Sushi,Canoa To Go,48750,5900,54650
1017,1018,21-10-2020 14:46:46.053358,Desayunos · Panadería,Artesanos,53400,4300,57700
1018,1019,21-10-2020 14:46:46.412356,Saludable,Hanai - Bowls Saludables,24300,5900,30200
1019,1020,21-10-2020 14:46:46.771520,Desayunos · Típica,Cochon,37900,3300,41200
1020,1021,21-10-2020 14:46:47.130457,Pollo · Saludable,Gratina,13600,4200,17800
1021,1022,21-10-2020 14:46:47.239020,Helados,Buon Gelato,18900,4400,23300
1022,1023,21-10-2020 14:46:47.397763,Típica · Pescados y Mariscos,La Vitualla,39700,6300,46000
1023,1024,21-10-2020 14:46:47.606611,Desayunos · Panadería,Pasteleite,23000,5900,28900
1024,1025,21-10-2020 14:46:47.715392,Desayunos · Café,Aromacafé el Placer de Compartir,9000,5000,14000
1025,1026,21-10-2020 14:46:47.974269,Saludable · Desayunos,Copacabana Açai Bowls,35000,3000,38000
1026,1027,21-10-2020 14:46:48.183034,Pollo · Pescados y Mariscos,Bang Bang Rice,48750,3400,52150
1027,1028,21-10-2020 14:46:48.341846,Italiana,Bocatto Di Passo,9000,5000,14000
1028,1029,21-10-2020 14:46:48.700769,Saludable · Desayunos,La Cesta,34500,4700,39200
1029,1030,21-10-2020 14:46:49.009680,Desayunos · Panadería,Le Pain Quotidien,29500,3900,33400
1030,1031,21-10-2020 14:46:49.368702,Desayunos,La Frijolada Desayunos,35000,4400,39400
1031,1032,21-10-2020 14:46:49.727566,Peruana,Masivo,8900,5800,14700
1032,1033,21-10-2020 14:46:49.886366,Postres,La Tertulia,8900,3400,12300
1033,1034,21-10-2020 14:46:50.245435,Desayunos · Café,El Gualilo,34500,6200,40700
1034,1035,21-10-2020 14:46:50.454146,Sushi,Kim Pop,35000,5400,40400
1035,1036,21-10-2020 14:46:50.813053,Típica · Parrilla,Mi Ranchito Parrilla,31800,4400,36200
1036,1037,21-10-2020 14:46:51.021827,Postres · Desayunos,Gelateria Da Favola,27800,6500,34300
1037,1038,21-10-2020 14:46:51.231837,Internacional,Rio Sabores y Experiencias,18900,4100,23000
1038,1039,21-10-2020 14:46:51.490941,Típica,La Olla de Barro,10700,5300,16000
1039,1040,21-10-2020 14:46:51.649828,Pizza,Pastas Laurentina,39700,4800,44500
1040,1041,21-10-2020 14:46:51.858722,Crepes,La Chabatta,34500,5900,40400
1041,1042,21-10-2020 14:46:52.217772,Típica,Sabrosito,31800,4000,35800
1042,1043,21-10-2020 14:46:52.426810,Hamburguesas · Pescados y Mariscos,El Velero,13600,6500,20100
1043,1044,21-10-2020 14:46:52.535524,Saludable,A2manos,13000,4200,17200
1044,1045,21-10-2020 14:46:52.794466,Desayunos · Pescados y Mariscos,Gypsy Bistro,53400,4500,57900
1045,1046,21-10-2020 14:46:53.103502,Desayunos · Helados,San Giorgio Gelateria,24200,3100,27300
1046,1047,21-10-2020 14:46:53.462641,Desayunos · Típica,Desayunadero de la 42,15000,5900,20900
1047,1048,21-10-2020 14:46:53.671509,Saludable · Típica,Saludable Mrg,15600,5800,21400
1048,1049,21-10-2020 14:46:53.930373,Desayunos · Café,Libertario Coffee Roasters,15600,4600,20200
1049,1050,21-10-2020 14:46:54.039209,Crepes,San Crepes,9000,4900,13900
1050,1051,21-10-2020 14:46:54.348277,Saludable · Desayunos,Guadalupe - Fruteria,10700,5900,16600
1051,1052,21-10-2020 14:46:54.507058,Sushi,Umi,27800,5600,33400
1052,1053,21-10-2020 14:46:54.866003,Desayunos · Panadería,Limarys,35000,6500,41500
1053,1054,21-10-2020 14:46:55.175016,Saludable · Desayunos,Básico y Elemental,7500,5900,13400
1054,1055,21-10-2020 14:46:55.283851,Postres · Desayunos,Sweet Tale,7500,5800,13300
1055,1056,21-10-2020 14:46:55.542646,Postres · Saludable,Ana Rebana,12500,6300,18800
1056,1057,21-10-2020 14:46:55.851603,Desayunos · Árabe,Boniato Sabores Vivos,45800,5300,51100
1057,1058,21-10-2020 14:46:56.060352,Mexicana,Cantina La 15,48750,4300,53050
1058,1059,21-10-2020 14:46:56.169025,Típica · Parrilla,Toya,23000,4200,27200
1059,1060,21-10-2020 14:46:56.278854,Postres · Desayunos,Aury Postres - Comidas & Picadas,17800,4700,22500
1060,1061,21-10-2020 14:46:56.587964,Peruana,Masivo,23000,5800,28800
1061,1062,21-10-2020 14:46:56.946749,Crepes,San Crepes,27800,4900,32700
1062,1063,21-10-2020 14:46:57.055457,Saludable · Desayunos,Bawana - Sandwich,31800,3400,35200
1063,1064,21-10-2020 14:46:57.164137,Típica · Parrilla,Typykos,39700,6000,45700
1064,1065,21-10-2020 14:46:57.372875,Pollo · Típica,Auyama,37900,3900,41800
1065,1066,21-10-2020 14:46:57.681797,Hamburguesas · Pescados y Mariscos,El Velero,45800,6500,52300
1066,1067,21-10-2020 14:46:58.040818,Pizza · Italiana,Piatto - Pizza,23000,6600,29600
1067,1068,21-10-2020 14:46:58.399791,China,China Food Col,31800,3600,35400
1068,1069,21-10-2020 14:46:58.658816,Típica,Cazuelitas 93,13000,3900,16900
1069,1070,21-10-2020 14:46:58.967626,Sushi,Kim Pop,39700,5400,45100
1070,1071,21-10-2020 14:46:59.326450,Desayunos · Helados,San Giorgio Gelateria,15600,3100,18700
1071,1072,21-10-2020 14:46:59.685391,Desayunos · Café,Norma's Ice Cream Café,8900,6300,15200
1072,1073,21-10-2020 14:46:59.894098,Pollo · Sánduches,Pollos Century,23000,3000,26000
1073,1074,21-10-2020 14:47:00.103408,Desayunos · Típica,Cochon,29500,3300,32800
1074,1075,21-10-2020 14:47:00.312399,Desayunos,Sr Buñuelo,45800,6400,52200
1075,1076,21-10-2020 14:47:00.671475,Típica · Pescados y Mariscos,La Vitualla,37900,6300,44200
1076,1077,21-10-2020 14:47:00.780225,Desayunos · Café,El Gualilo,35000,6200,41200
1077,1078,21-10-2020 14:47:01.089202,Hamburguesas,Bendito Cordero,24200,5800,30000
1078,1079,21-10-2020 14:47:01.247903,Sushi · Asiática,Arigato,34500,5300,39800
1079,1080,21-10-2020 14:47:01.557592,Postres · Desayunos,Café Quindio,45800,5700,51500
1080,1081,21-10-2020 14:47:01.916639,Sushi · Asiática,Tu Sushi,53900,6400,60300
1081,1082,21-10-2020 14:47:02.125463,Típica,Campo Victoria,48750,3000,51750
1082,1083,21-10-2020 14:47:02.234095,Desayunos · Panadería,Choclofee,17800,4700,22500
1083,1084,21-10-2020 14:47:02.342850,Postres,Beiked,24300,4000,28300
1084,1085,21-10-2020 14:47:02.601708,Postres · Café,Celestino Café,45800,5900,51700
1085,1086,21-10-2020 14:47:02.760613,Desayunos · Pescados y Mariscos,Gypsy Bistro,53900,4500,58400
1086,1087,21-10-2020 14:47:02.969423,Pollo · Sánduches,Pollos Century,15600,3000,18600
1087,1088,21-10-2020 14:47:03.328153,Parrilla,Carnes la Zarza,53400,4900,58300
1088,1089,21-10-2020 14:47:03.586986,Típica,Sabrosito,13000,4000,17000
1089,1090,21-10-2020 14:47:03.946070,Desayunos · Café,Matchacha,9000,5900,14900
1090,1091,21-10-2020 14:47:04.305109,Parrilla,Beraca Parrilla Bbq,53400,5600,59000
1091,1092,21-10-2020 14:47:04.413720,Desayunos · Típica,Fogón Sangileño,15000,5000,20000
1092,1093,21-10-2020 14:47:04.572374,Parrilla,Restaurante Bar Mi Ranchito,70000,5200,75200
1093,1094,21-10-2020 14:47:04.931508,Desayunos · Jugos y Batidos,Dont Be Hungry,65000,5600,70600
1094,1095,21-10-2020 14:47:05.240604,Típica · Parrilla,El Portal de la Antigua,13000,5600,18600
1095,1096,21-10-2020 14:47:05.549529,Desayunos · Sánduches,Frutos del Bosque,24200,3500,27700
1096,1097,21-10-2020 14:47:05.858395,Típica,Bendita S,13600,4600,18200
1097,1098,21-10-2020 14:47:06.017071,Pollo · Desayunos,Caserito Gourmet,37900,6700,44600
1098,1099,21-10-2020 14:47:06.175799,Pollo,Señor Fantástico,39700,4700,44400
1099,1100,21-10-2020 14:47:06.434547,Saludable · Jugos y Batidos,Berdes Drinks & Salads,24200,3500,27700
1100,1101,21-10-2020 14:47:06.543330,Hamburguesas,Burger Society,29500,4100,33600
1101,1102,21-10-2020 14:47:06.803342,Pollo,Señor Fantástico,24300,4700,29000
1102,1103,21-10-2020 14:47:07.062247,Desayunos,La Frijolada Desayunos,15600,4400,20000
1103,1104,21-10-2020 14:47:07.321074,Postres · Saludable,Ana Rebana,7500,6300,13800
1104,1105,21-10-2020 14:47:07.579989,Desayunos · Panadería,Pasteleite,31800,5900,37700
1105,1106,21-10-2020 14:47:07.838938,Postres · Desayunos,Aury Postres - Comidas & Picadas,15600,4700,20300
1106,1107,21-10-2020 14:47:08.047833,Desayunos · Mexicana,La Mera Mera - Mexicana,53400,3100,56500
1107,1108,21-10-2020 14:47:08.156608,Pollo · Típica,Auyama,37900,3900,41800
1108,1109,21-10-2020 14:47:08.265465,Desayunos · Café,Libertario Coffee Roasters,23000,4600,27600
1109,1110,21-10-2020 14:47:08.374299,Postres · Desayunos,Café Quindio,18900,5700,24600
1110,1111,21-10-2020 14:47:08.583570,Típica,Sopitas y Más,70000,4200,74200
1111,1112,21-10-2020 14:47:08.742452,Parrilla,Parrilla Pimentón,24300,3400,27700
1112,1113,21-10-2020 14:47:08.901402,Saludable · Desayunos,Bon Eat - Saludable,29500,4800,34300
1113,1114,21-10-2020 14:47:09.110198,Desayunos · Sánduches,Garnish,24200,5200,29400
1114,1115,21-10-2020 14:47:09.219037,Desayunos,El Fogón Castellano,39700,3200,42900
1115,1116,21-10-2020 14:47:09.478061,Desayunos · Panadería,Siena Café,27800,3700,31500
1116,1117,21-10-2020 14:47:09.736937,Saludable · Jugos y Batidos,Berdes Drinks & Salads,8900,3500,12400
1117,1118,21-10-2020 14:47:09.945758,Saludable,A2manos,29500,4200,33700
1118,1119,21-10-2020 14:47:10.104487,Desayunos · Típica,D'Porco - Lechona,9000,6300,15300
1119,1120,21-10-2020 14:47:10.313378,Desayunos,La Frijolada Desayunos,45800,4400,50200
1120,1121,21-10-2020 14:47:10.422053,Desayunos,Sr Buñuelo,70000,6400,76400
1121,1122,21-10-2020 14:47:10.530829,Desayunos · Café,vereda central calle 99,7500,5700,13200
1122,1123,21-10-2020 14:47:10.639507,Desayunos · Panadería,Decofruta,17800,4700,22500
1123,1124,21-10-2020 14:47:10.848477,Postres,La Tertulia,7500,3400,10900
1124,1125,21-10-2020 14:47:11.207553,Saludable,Amor Propio saludable,13600,4000,17600
1125,1126,21-10-2020 14:47:11.366425,Comida Rápida · Perros Calientes,Similoa - Comida Rapida,27800,3700,31500
1126,1127,21-10-2020 14:47:11.675401,Sánduches · Pescados y Mariscos,Pacific Comida de Mar,39700,4000,43700
1127,1128,21-10-2020 14:47:12.035201,Internacional,Rio Sabores y Experiencias,8900,4100,13000
1128,1129,21-10-2020 14:47:12.144153,Desayunos · Típica,Parrilla Farandula Típico,10700,5900,16600
1129,1130,21-10-2020 14:47:12.453235,Desayunos,Butter,35000,6700,41700
1130,1131,21-10-2020 14:47:12.611999,Típica · Pescados y Mariscos,Arroces Mrg,18900,4300,23200
1131,1132,21-10-2020 14:47:12.720912,Postres · Desayunos,Jacques Pastelería,10700,5900,16600
1132,1133,21-10-2020 14:47:12.829745,Parrilla,Parrilla Pimentón,11870,3400,15270
1133,1134,21-10-2020 14:47:12.938656,Parrilla,Beraca Parrilla Bbq,15600,5600,21200
1134,1135,21-10-2020 14:47:13.248019,Postres,Toledo Pastelería,9000,6800,15800
1135,1136,21-10-2020 14:47:13.457162,Saludable · Desayunos,Bon Eat - Saludable,23000,4800,27800
1136,1137,21-10-2020 14:47:13.766230,Asiática,TeT,12500,5900,18400
1137,1138,21-10-2020 14:47:14.125276,Saludable · Desayunos,Copacabana Açai Bowls,53900,3000,56900
1138,1139,21-10-2020 14:47:14.334252,Postres · Desayunos,Gelateria Da Favola,35000,6500,41500
1139,1140,21-10-2020 14:47:14.593233,Peruana,Masivo,10700,5800,16500
1140,1141,21-10-2020 14:47:14.702060,Desayunos · Panadería,Siena Café,17800,3700,21500
1141,1142,21-10-2020 14:47:14.961055,Pizza,Pastas Laurentina,39700,4800,44500
1142,1143,21-10-2020 14:47:15.320213,Desayunos · Pescados y Mariscos,Gypsy Bistro,48750,4500,53250
1143,1144,21-10-2020 14:47:15.529204,Desayunos · Sánduches,Frutos del Bosque,13600,3500,17100
1144,1145,21-10-2020 14:47:15.788233,Desayunos,Jacinta Arepas de Huevo,15600,4000,19600
1145,1146,21-10-2020 14:47:15.997295,Desayunos · Panadería,Decofruta,24200,4700,28900
1146,1147,21-10-2020 14:47:16.306414,Parrilla,Arroces Maria Paula,12500,6800,19300
1147,1148,21-10-2020 14:47:16.565440,Desayunos,Sr Buñuelo,34500,6400,40900
1148,1149,21-10-2020 14:47:16.924456,Sánduches,Submarin,17800,3800,21600
1149,1150,21-10-2020 14:47:17.034437,Saludable,Ventura Soup y Salad,29500,3800,33300
1150,1151,21-10-2020 14:47:17.193534,Desayunos · Panadería,Santa Juana Food Bar,27800,5900,33700
1151,1152,21-10-2020 14:47:17.402505,Postres · Desayunos,Amelie Helados,15000,6400,21400
1152,1153,21-10-2020 14:47:17.711696,Desayunos · Típica,Alce,11870,4900,16770
1153,1154,21-10-2020 14:47:17.820692,Desayunos · Típica,Casa Vieja,35000,6000,41000
1154,1155,21-10-2020 14:47:18.179731,Típica · Parrilla,Typykos,24300,6000,30300
1155,1156,21-10-2020 14:47:18.288681,Saludable · Jugos y Batidos,Berdes Drinks & Salads,53900,3500,57400
1156,1157,21-10-2020 14:47:18.397550,Mexicana,Mexicanachos,23000,3900,26900
1157,1158,21-10-2020 14:47:18.556364,Asiática,TeT,53400,5900,59300
1158,1159,21-10-2020 14:47:18.915587,Postres · Café,Loló Coffee & Snacks,10700,4600,15300
1159,1160,21-10-2020 14:47:19.224800,Saludable · Desayunos,Básico y Elemental,15600,5900,21500
1160,1161,21-10-2020 14:47:19.333628,Típica,El Mondongo y Mucho Mas,35000,5600,40600
1161,1162,21-10-2020 14:47:19.442378,Desayunos · Típica,D´Porco,24200,3900,28100
1162,1163,21-10-2020 14:47:19.601400,Italiana,Bocatto Di Passo,9000,5000,14000
1163,1164,21-10-2020 14:47:19.710346,Desayunos · Panadería,Choclofee,13600,4700,18300
1164,1165,21-10-2020 14:47:19.969430,Postres · Desayunos,Gelateria Da Favola,13600,6500,20100
1165,1166,21-10-2020 14:47:20.328546,Parrilla,Coquitas,17800,5600,23400
1166,1167,21-10-2020 14:47:20.537553,Típica,Carbón & Mondongos,35000,6400,41400
1167,1168,21-10-2020 14:47:20.746513,Típica,El Cucharón - Tipica,7500,4400,11900
1168,1169,21-10-2020 14:47:20.855512,Hamburguesas · Alitas,Beer,27800,6600,34400
1169,1170,21-10-2020 14:47:21.164590,Postres,Beiked,45800,4000,49800
1170,1171,21-10-2020 14:47:21.373585,Alta Cocina · Parrilla,Criterión,35000,6000,41000
1171,1172,21-10-2020 14:47:21.532595,Postres,Beiked,24300,4000,28300
1172,1173,21-10-2020 14:47:21.641724,Sushi · Asiática,Tu Sushi,13600,6400,20000
1173,1174,21-10-2020 14:47:21.800752,Desayunos · Panadería,Choclofee,31800,4700,36500
1174,1175,21-10-2020 14:47:22.161149,Saludable · Desayunos,Raices Bienestar Gourmet,53900,6600,60500
1175,1176,21-10-2020 14:47:22.420259,Desayunos · Típica,Papadió - Colombianas,29500,5700,35200
1176,1177,21-10-2020 14:47:22.729432,Desayunos · Típica,D´Porco,27800,3900,31700
1177,1178,21-10-2020 14:47:23.038443,Asiática,TeT,37900,5900,43800
1178,1179,21-10-2020 14:47:23.197418,Postres · Café,Celestino Café,39700,5900,45600
1179,1180,21-10-2020 14:47:23.406345,Desayunos · Comida Rápida,La Veneca,24200,6300,30500
1180,1181,21-10-2020 14:47:23.715656,Típica,Lo Nuestro,23000,3100,26100
1181,1182,21-10-2020 14:47:24.074761,Típica,La Herencia,48750,5900,54650
1182,1183,21-10-2020 14:47:24.333857,Sushi · Desayunos,Maki Roll,53400,4300,57700
1183,1184,21-10-2020 14:47:24.643058,Típica,Bandejas Mrg,53900,3800,57700
1184,1185,21-10-2020 14:47:24.852115,Parrilla,Arroces Maria Paula,27800,6800,34600
1185,1186,21-10-2020 14:47:25.161463,Postres · Desayunos,Protein Bakes,53400,5900,59300
1186,1187,21-10-2020 14:47:25.270361,Parrilla,Antojo a Domicilio,70000,5000,75000
1187,1188,21-10-2020 14:47:25.629679,Típica · Parrilla,Mi Ranchito Parrilla,35000,4400,39400
1188,1189,21-10-2020 14:47:25.838788,Pollo · Desayunos,Abasto,23000,3600,26600
1189,1190,21-10-2020 14:47:26.198091,Italiana,Bocatto Di Passo,35000,5000,40000
1190,1191,21-10-2020 14:47:26.507340,Sánduches · Pescados y Mariscos,Pacific Comida de Mar,53900,4000,57900
1191,1192,21-10-2020 14:47:26.616341,Desayunos · Panadería,Limarys,8900,6500,15400
1192,1193,21-10-2020 14:47:26.825588,Desayunos · Sánduches,Frutos del Bosque,8900,3500,12400
1193,1194,21-10-2020 14:47:26.984623,Pizza,Pizza Andante,31800,6300,38100
1194,1195,21-10-2020 14:47:27.194855,Saludable · Desayunos,Re.al Alimentos Reales,24300,4000,28300
1195,1196,21-10-2020 14:47:27.504196,Saludable,Puro Verde,24200,5700,29900
1196,1197,21-10-2020 14:47:27.713470,Desayunos · Panadería,Juliana Restaurante,13600,6100,19700
1197,1198,21-10-2020 14:47:27.972481,Típica,Sabrosito,27800,4000,31800
1198,1199,21-10-2020 14:47:28.081407,Desayunos,Bagel Shop,17800,3200,21000
1199,1200,21-10-2020 14:47:28.440709,Postres · Desayunos,Gelateria Da Favola,18900,6500,25400
1200,1201,21-10-2020 14:47:28.699877,Pollo,Oliva Va,29500,5600,35100
1201,1202,21-10-2020 14:47:29.009023,Saludable · Desayunos,Agua Dulce,70000,3700,73700
1202,1203,21-10-2020 14:47:29.268150,Saludable · Típica,Saludable Mrg,65000,5800,70800
1203,1204,21-10-2020 14:47:29.427175,Típica,La Cocina,24300,4600,28900
1204,1205,21-10-2020 14:47:29.586227,Parrilla,Arepaisa de Medellín,65000,5600,70600
1205,1206,21-10-2020 14:47:29.745381,Parrilla,El Tambor,37900,6800,44700
1206,1207,21-10-2020 14:47:29.904523,Desayunos · Panadería,Artesanos,24300,4300,28600
1207,1208,21-10-2020 14:47:30.163833,Típica,La Cocina,35000,4600,39600
1208,1209,21-10-2020 14:47:30.322947,Típica · Parrilla,El Portal de la Antigua,24300,5600,29900
1209,1210,21-10-2020 14:47:30.632224,Sushi · Desayunos,Maki Roll,13000,4300,17300
1210,1211,21-10-2020 14:47:30.991625,China,China Food Col,65000,3600,68600
1211,1212,21-10-2020 14:47:31.301203,Desayunos · Panadería,Premium Break Bakery,23000,3700,26700
1212,1213,21-10-2020 14:47:31.610301,Típica · Parrilla,Mi Ranchito Parrilla,35000,4400,39400
1213,1214,21-10-2020 14:47:31.969646,Parrilla,Rústico Picadería,24300,3800,28100
1214,1215,21-10-2020 14:47:32.178770,Típica,Cazuelitas 93,13600,3900,17500
1215,1216,21-10-2020 14:47:32.288956,Desayunos · Café,Matchacha,35000,5900,40900
1216,1217,21-10-2020 14:47:32.598329,China,China Food Col,13600,3600,17200
1217,1218,21-10-2020 14:47:32.957751,Desayunos · Típica,Peninsula Calentados y Parrilla,15600,3400,19000
1218,1219,21-10-2020 14:47:33.116786,Pollo,Chicken House,24200,4200,28400
1219,1220,21-10-2020 14:47:33.225763,Desayunos,Bagel Shop,48750,3200,51950
1220,1221,21-10-2020 14:47:33.434997,Pollo · Sánduches,Pollos Century,35000,3000,38000
1221,1222,21-10-2020 14:47:33.544204,Jugos y Batidos,Pomponio,12500,3600,16100
1222,1223,21-10-2020 14:47:33.803500,Típica,Baondish,70000,5800,75800
1223,1224,21-10-2020 14:47:34.162816,Saludable · Desayunos,Malú,11870,3700,15570
1224,1225,21-10-2020 14:47:34.271848,Típica,Juan Chorizo,31800,3900,35700
1225,1226,21-10-2020 14:47:34.381022,Italiana,F*cking Good Pizza,37900,4200,42100
1226,1227,21-10-2020 14:47:34.740284,Saludable · Desayunos,Agua Dulce,9000,3700,12700
1227,1228,21-10-2020 14:47:34.949471,Postres,Toledo Pastelería,11870,6800,18670
1228,1229,21-10-2020 14:47:35.208621,Saludable · Desayunos,Malú,24300,3700,28000
1229,1230,21-10-2020 14:47:35.518203,Desayunos · Café,El Gualilo,27800,6200,34000
1230,1231,21-10-2020 14:47:35.877497,Típica,Cazuelitas 93,10700,3900,14600
1231,1232,21-10-2020 14:47:36.186687,Desayunos · Panadería,Limarys,29500,6500,36000
1232,1233,21-10-2020 14:47:36.546048,Hamburguesas · Desayunos,El Inglés Gastro Pub,11870,6600,18470
1233,1234,21-10-2020 14:47:36.805395,Desayunos · Típica,Alce,24300,4900,29200
1234,1235,21-10-2020 14:47:37.014474,Saludable · Desayunos,Bon Eat - Saludable,18900,4800,23700
1235,1236,21-10-2020 14:47:37.325029,Pollo,Señor Fantástico,13000,4700,17700
1236,1237,21-10-2020 14:47:37.434043,Hamburguesas · Panadería,NYC Burgers,23000,6200,29200
1237,1238,21-10-2020 14:47:37.793484,Desayunos,Sr Buñuelo,11870,6400,18270
1238,1239,21-10-2020 14:47:38.052730,Típica,La Herencia,45800,5900,51700
1239,1240,21-10-2020 14:47:38.412119,Saludable,MIMA,39700,3700,43400
1240,1241,21-10-2020 14:47:38.621372,Típica · Parrilla,Mi Ranchito Parrilla,7500,4400,11900
1241,1242,21-10-2020 14:47:38.830486,Saludable · Desayunos,Malú,17800,3700,21500
1242,1243,21-10-2020 14:47:38.989625,Desayunos · Típica,Criollomania,18900,5200,24100
1243,1244,21-10-2020 14:47:39.348855,Desayunos · Café,Frambas,35000,3400,38400
1244,1245,21-10-2020 14:47:39.508025,Saludable,MIMA,45800,3700,49500
1245,1246,21-10-2020 14:47:39.667321,Saludable · Desayunos,Copacabana Açai Bowls,24300,3000,27300
1246,1247,21-10-2020 14:47:40.026668,Postres · Desayunos,Sweet Tale,48750,5800,54550
1247,1248,21-10-2020 14:47:40.185762,Pescados y Mariscos,La Gran Cazuela,10700,3200,13900
1248,1249,21-10-2020 14:47:40.495042,Saludable · Jugos y Batidos,Berdes Drinks & Salads,31800,3500,35300
1249,1250,21-10-2020 14:47:40.854519,Postres · Desayunos,KOKOA & co.,53400,4700,58100
1250,1251,21-10-2020 14:47:41.013734,Desayunos · Jugos y Batidos,Kuriwaji,15000,6300,21300
1251,1252,21-10-2020 14:47:41.373260,Desayunos · Café,Aromacafé el Placer de Compartir,8900,5000,13900
1252,1253,21-10-2020 14:47:41.582516,Hamburguesas · Panadería,NYC Burgers,13600,6200,19800
1253,1254,21-10-2020 14:47:41.691767,Desayunos · Panadería,Santa Juana Food Bar,9000,5900,14900
1254,1255,21-10-2020 14:47:41.851148,Saludable,Amor Propio saludable,70000,4000,74000
1255,1256,21-10-2020 14:47:41.960272,Desayunos · Típica,Criollomania,31800,5200,37000
1256,1257,21-10-2020 14:47:42.269678,Pollo,Señor Fantástico,27800,4700,32500
1257,1258,21-10-2020 14:47:42.529973,Desayunos · Panadería,Santa Juana Food Bar,53400,5900,59300
1258,1259,21-10-2020 14:47:42.639267,Alta Cocina · Italiana,Trattoria de la Plaza,35000,6000,41000
1259,1260,21-10-2020 14:47:42.848652,Postres · Desayunos,Aury Postres - Comidas & Picadas,39700,4700,44400
1260,1261,21-10-2020 14:47:43.057812,Postres · Desayunos,Maria Luisa - Postres,11870,4300,16170
1261,1262,21-10-2020 14:47:43.317023,Saludable · Típica,Saludable Mrg,45800,5800,51600
1262,1263,21-10-2020 14:47:43.576271,Pollo,Chicken House,15600,4200,19800
1263,1264,21-10-2020 14:47:43.935747,Típica,Bendita S,17800,4600,22400
1264,1265,21-10-2020 14:47:44.044876,Desayunos · Panadería,Premium Break Bakery,65000,3700,68700
1265,1266,21-10-2020 14:47:44.354294,Típica,Cabrito Santandereano,10700,6600,17300
1266,1267,21-10-2020 14:47:44.713744,Desayunos,Sunny Breakfast Brunch,18900,4300,23200
1267,1268,21-10-2020 14:47:45.073166,Típica · Pescados y Mariscos,La Vitualla,24200,6300,30500
1268,1269,21-10-2020 14:47:45.382460,Postres,Toledo Pastelería,9000,6800,15800
1269,1270,21-10-2020 14:47:45.491681,Saludable · Parrilla,The Angels Grill and Drinks,39700,6200,45900
1270,1271,21-10-2020 14:47:45.801119,Desayunos · Panadería,Pasteleite,53900,5900,59800
1271,1272,21-10-2020 14:47:45.960304,Desayunos · Café,Libertario Coffee Roasters,23000,4600,27600
1272,1273,21-10-2020 14:47:46.069417,Desayunos · Jugos y Batidos,Frutiwow,24200,4100,28300
1273,1274,21-10-2020 14:47:46.428759,Pollo · Desayunos,Workzone,13000,3100,16100
1274,1275,21-10-2020 14:47:46.788233,Desayunos · Jugos y Batidos,Frutiwow,24300,4100,28400
1275,1276,21-10-2020 14:47:47.047782,Desayunos · Pescados y Mariscos,Luzí­a - Mediterranea,8900,5700,14600
1276,1277,21-10-2020 14:47:47.207002,Postres,Beiked,23000,4000,27000
1277,1278,21-10-2020 14:47:47.416243,Postres · Helados,Mahé,34500,6000,40500
1278,1279,21-10-2020 14:47:47.776748,Desayunos · Típica,Alce,24200,4900,29100
1279,1280,21-10-2020 14:47:47.886159,Típica · Parrilla,El Santandereano,9000,5200,14200
1280,1281,21-10-2020 14:47:47.995346,Pizza,pizza andante,53900,4200,58100
1281,1282,21-10-2020 14:47:48.104470,Desayunos · Panadería,Ficchi Panadería,39700,3100,42800
1282,1283,21-10-2020 14:47:48.363916,Desayunos · Jugos y Batidos,Dont Be Hungry,18900,5600,24500
1283,1284,21-10-2020 14:47:48.473210,Postres · Desayunos,Amelie Helados,15000,6400,21400
1284,1285,21-10-2020 14:47:48.582392,Pizza,18 Scalini,53900,4300,58200
1285,1286,21-10-2020 14:47:48.942000,Parrilla,Arepaisa de Medellín,8900,5600,14500
1286,1287,21-10-2020 14:47:49.251396,Pollo · Desayunos,Workzone,23000,3100,26100
1287,1288,21-10-2020 14:47:49.560985,Desayunos,El Corral - Desayunos,23000,5000,28000
1288,1289,21-10-2020 14:47:49.920485,Saludable · Desayunos,Malú,7500,3700,11200
1289,1290,21-10-2020 14:47:50.129847,Postres · Desayunos,Gelateria Da Favola,24200,6500,30700
1290,1291,21-10-2020 14:47:50.439237,Saludable · Jugos y Batidos,Berdes Drinks & Salads,35000,3500,38500
1291,1292,21-10-2020 14:47:50.598621,Típica · Pescados y Mariscos,Arroces Mrg,18900,4300,23200
1292,1293,21-10-2020 14:47:50.808134,Saludable · Desayunos,Guadalupe - Fruteria,53400,5900,59300
1293,1294,21-10-2020 14:47:50.917368,Típica,Bandejas Mrg,17800,3800,21600
1294,1295,21-10-2020 14:47:51.126636,Desayunos · Comida Rápida,Chocolatto,34500,3400,37900
1295,1296,21-10-2020 14:47:51.386037,Desayunos,Sr Buñuelo,70000,6400,76400
1296,1297,21-10-2020 14:47:51.545413,Típica · Parrilla,El Santandereano,31800,5200,37000
1297,1298,21-10-2020 14:47:51.804694,Desayunos · Típica,Fogón Sangileño,9000,5000,14000
1298,1299,21-10-2020 14:47:51.913979,Parrilla,Arepaisa de Medellín,10700,5600,16300
1299,1300,21-10-2020 14:47:52.123335,Desayunos,Cafetería el Kippe,48750,3200,51950
1300,1301,21-10-2020 14:47:52.232560,Desayunos,El Fogón Castellano,18900,3200,22100
1301,1302,21-10-2020 14:47:52.441963,Desayunos · Sánduches,Frutos del Bosque,13600,3500,17100
1302,1303,21-10-2020 14:47:52.701590,Saludable,A2manos,8900,4200,13100
1303,1304,21-10-2020 14:47:52.811861,Café · Helados,Sofia heladería y café,15000,5800,20800
1304,1305,21-10-2020 14:47:52.971255,Típica · Parrilla,Typykos,17800,6000,23800
1305,1306,21-10-2020 14:47:53.280890,Típica,Sabrosito,70000,4000,74000
1306,1307,21-10-2020 14:47:53.590344,Pollo,Oliva Va,13600,5600,19200
1307,1308,21-10-2020 14:47:53.699568,Hamburguesas,Gofi Burger,11870,5100,16970
1308,1309,21-10-2020 14:47:53.908881,Pizza,Pizza Andante,13000,6300,19300
1309,1310,21-10-2020 14:47:54.068291,Parrilla,Rústico Picadería,53900,3800,57700
1310,1311,21-10-2020 14:47:54.227530,Desayunos,La Frijolada Desayunos,10700,4400,15100
1311,1312,21-10-2020 14:47:54.587066,Desayunos,Jacinta Arepas de Huevo,8900,4000,12900
1312,1313,21-10-2020 14:47:54.846462,Pescados y Mariscos,Pescadero Héroes del Mar,37900,6600,44500
1313,1314,21-10-2020 14:47:55.206076,Desayunos · Panadería,Ficchi Panadería,24200,3100,27300
1314,1315,21-10-2020 14:47:55.315389,Desayunos · Típica,La Parrilla Dorada Polo,15600,6600,22200
1315,1316,21-10-2020 14:47:55.424601,Hamburguesas,Bendito Cordero,13000,5800,18800
1316,1317,21-10-2020 14:47:55.633979,Saludable · Desayunos,Fresh Co,37900,5600,43500
1317,1318,21-10-2020 14:47:55.743325,Desayunos · Típica,D´Porco,23000,3900,26900
1318,1319,21-10-2020 14:47:56.002719,Desayunos · Jugos y Batidos,Dont Be Hungry,53900,5600,59500
1319,1320,21-10-2020 14:47:56.312328,Postres,La Galeta,18900,3000,21900
1320,1321,21-10-2020 14:47:56.621758,Desayunos,Don Leo,15000,6000,21000
1321,1322,21-10-2020 14:47:56.781062,Postres,Beiked,27800,4000,31800
1322,1323,21-10-2020 14:47:57.140641,Desayunos · Empanadas,Empanadas Doraditas.com,24300,3000,27300
1323,1324,21-10-2020 14:47:57.400081,Postres · Desayunos,Maltihelado,53900,4500,58400
1324,1325,21-10-2020 14:47:57.659652,Sushi · Asiática,Arigato,39700,5300,45000
1325,1326,21-10-2020 14:47:58.020338,Desayunos · Panadería,Choclofee,7500,4700,12200
1326,1327,21-10-2020 14:47:58.329998,Postres · Desayunos,Maltihelados,13000,6200,19200
1327,1328,21-10-2020 14:47:58.639571,Desayunos,La Frijolada Desayunos,29500,4400,33900
1328,1329,21-10-2020 14:47:58.949292,Desayunos · Empanadas,Empanadas Doraditas.com,24200,3000,27200
1329,1330,21-10-2020 14:47:59.058556,Postres · Desayunos,Sweet Tale,15600,5800,21400
1330,1331,21-10-2020 14:47:59.318023,Saludable · Desayunos,Fresh Co,34500,5600,40100
1331,1332,21-10-2020 14:47:59.427433,Parrilla,Parrilla Pimentón,53400,3400,56800
1332,1333,21-10-2020 14:47:59.537018,Típica,Lo Nuestro,53900,3100,57000
1333,1334,21-10-2020 14:47:59.646470,Pollo · Desayunos,Abasto,53900,3600,57500
1334,1335,21-10-2020 14:47:59.756049,Pollo,Chicken House,15600,4200,19800
1335,1336,21-10-2020 14:47:59.915814,Desayunos · Pescados y Mariscos,Gypsy Bistro,24300,4500,28800
1336,1337,21-10-2020 14:48:00.225645,Sánduches · China,Peru Mix,23000,5900,28900
1337,1338,21-10-2020 14:48:00.535309,Saludable · Desayunos,Básico y Elemental,48750,5900,54650
1338,1339,21-10-2020 14:48:00.844952,Típica · Pescados y Mariscos,Arroces Mrg,27800,4300,32100
1339,1340,21-10-2020 14:48:01.204844,Saludable,Puro Verde,15600,5700,21300
1340,1341,21-10-2020 14:48:01.364359,Hamburguesas,Bendito Cordero,23000,5800,28800
1341,1342,21-10-2020 14:48:01.523992,Jugos y Batidos,Pomponio,12500,3600,16100
1342,1343,21-10-2020 14:48:01.683402,Desayunos · Café,Norma's Ice Cream Café,24200,6300,30500
1343,1344,21-10-2020 14:48:01.793055,Típica · Pescados y Mariscos,Arroces Mrg,29500,4300,33800
1344,1345,21-10-2020 14:48:02.102718,Hamburguesas,Burger Society,27800,4100,31900
1345,1346,21-10-2020 14:48:02.362427,Pescados y Mariscos,Pescadero Héroes del Mar,12500,6600,19100
1346,1347,21-10-2020 14:48:02.471876,Saludable,A2manos,65000,4200,69200
1347,1348,21-10-2020 14:48:02.681424,Saludable,Hanai - Bowls Saludables,18900,5900,24800
1348,1349,21-10-2020 14:48:03.042056,Pollo · Desayunos,Piaf,15000,6500,21500
1349,1350,21-10-2020 14:48:03.201604,Típica,El Mondongo y Mucho Mas,53400,5600,59000
1350,1351,21-10-2020 14:48:03.461358,Comida Rápida · Perros Calientes,Similoa - Comida Rapida,37900,3700,41600
1351,1352,21-10-2020 14:48:03.771027,Hamburguesas · Saludable,Restaurant Inn,53900,6100,60000
1352,1353,21-10-2020 14:48:04.130859,Pollo,Oliva Va,37900,5600,43500
1353,1354,21-10-2020 14:48:04.440673,Hamburguesas · Alitas,Beer,12500,6600,19100
1354,1355,21-10-2020 14:48:04.600252,Desayunos · Típica,D´Porco,34500,3900,38400
1355,1356,21-10-2020 14:48:04.859864,Parrilla · Internacional,Taperia de la Plaza,53400,5700,59100
1356,1357,21-10-2020 14:48:05.119501,Helados,Buon Gelato,45800,4400,50200
1357,1358,21-10-2020 14:48:05.379421,Desayunos,Bagel Shop,17800,3200,21000
1358,1359,21-10-2020 14:48:05.489028,Desayunos · Empanadas,Empanadas Doraditas.com,10700,3000,13700
1359,1360,21-10-2020 14:48:05.798637,Desayunos · Café,Frambas,65000,3400,68400
1360,1361,21-10-2020 14:48:06.108319,Pollo · Pescados y Mariscos,Bang Bang Rice,29500,3400,32900
1361,1362,21-10-2020 14:48:06.267789,Desayunos · Panadería,Premium Break Bakery,35000,3700,38700
1362,1363,21-10-2020 14:48:06.477405,Desayunos · Empanadas,Mis Delicias,12500,3200,15700
1363,1364,21-10-2020 14:48:06.787111,Desayunos · Café,Libertario Coffee Roasters,17800,4600,22400
1364,1365,21-10-2020 14:48:07.046801,Saludable · Desayunos,Distrito Gourmet,53400,3700,57100
1365,1366,21-10-2020 14:48:07.356430,Desayunos · Panadería,Siena Café,8900,3700,12600
1366,1367,21-10-2020 14:48:07.666176,Alta Cocina · Parrilla,Criterión,53400,6000,59400
1367,1368,21-10-2020 14:48:07.875765,Postres · Desayunos,Gelateria Da Favola,45800,6500,52300
1368,1369,21-10-2020 14:48:08.086523,Pescados y Mariscos,Fish Place - Del Mar,15000,5400,20400
1369,1370,21-10-2020 14:48:08.196131,Parrilla,Restaurante Bar Mi Ranchito,48750,5200,53950
1370,1371,21-10-2020 14:48:08.505957,Desayunos,Jacinta Arepas de Huevo,15600,4000,19600
1371,1372,21-10-2020 14:48:08.815803,Pollo · Desayunos,Caserito Gourmet,12500,6700,19200
1372,1373,21-10-2020 14:48:08.975292,Saludable,A2manos,53900,4200,58100
1373,1374,21-10-2020 14:48:09.284986,Desayunos,El Fogón Castellano,13000,3200,16200
1374,1375,21-10-2020 14:48:09.544560,Pollo · Desayunos,Workzone,7500,3100,10600
1375,1376,21-10-2020 14:48:09.654031,Desayunos · Mexicana,La Mera Mera - Mexicana,23000,3100,26100
1376,1377,21-10-2020 14:48:09.963625,Parrilla · Internacional,Taperia de la Plaza,10700,5700,16400
1377,1378,21-10-2020 14:48:10.073006,Pollo · Saludable,Yerbabuena,27800,3900,31700
1378,1379,21-10-2020 14:48:10.232440,Típica,Sabrosito,23000,4000,27000
1379,1380,21-10-2020 14:48:10.391927,Desayunos · Café,Moramia,29500,4700,34200
1380,1381,21-10-2020 14:48:10.551445,Desayunos,El Corral - Desayunos,48750,5000,53750
1381,1382,21-10-2020 14:48:10.911258,Típica,Bandejas Mrg,31800,3800,35600
1382,1383,21-10-2020 14:48:11.120939,Postres · Desayunos,Restaurante Cornelia,18900,5500,24400
1383,1384,21-10-2020 14:48:11.280571,Saludable · Desayunos,Básico y Elemental,15600,5900,21500
1384,1385,21-10-2020 14:48:11.390120,Italiana,Bocatto Di Passo,15000,5000,20000
1385,1386,21-10-2020 14:48:11.599792,Postres · Desayunos,BagBog Bagels,37900,6400,44300
1386,1387,21-10-2020 14:48:11.909578,Parrilla,OAK Ahumado y Brebajes,8900,6000,14900
1387,1388,21-10-2020 14:48:12.269359,Típica,Bandejas Mrg,10700,3800,14500
1388,1389,21-10-2020 14:48:12.528970,Típica · Pescados y Mariscos,Arroces Mrg,23000,4300,27300
1389,1390,21-10-2020 14:48:12.688588,Desayunos,Cafetería el Kippe,13600,3200,16800
1390,1391,21-10-2020 14:48:13.048459,Desayunos · Pescados y Mariscos,Gypsy Bistro,37900,4500,42400
1391,1392,21-10-2020 14:48:13.159016,Parrilla,Carnes la Zarza,10700,4900,15600
1392,1393,21-10-2020 14:48:13.518971,Sushi,Sushi Reel,53900,4700,58600
1393,1394,21-10-2020 14:48:13.628620,Desayunos · Panadería,Le Pain Quotidien,53400,3900,57300
1394,1395,21-10-2020 14:48:13.888405,Saludable · Desayunos,La Cesta,23000,4700,27700
1395,1396,21-10-2020 14:48:14.198202,Desayunos · Internacional,Camilia,48750,3900,52650
1396,1397,21-10-2020 14:48:14.407970,Saludable · Desayunos,Básico y elemental,15600,5000,20600
1397,1398,21-10-2020 14:48:14.667686,Sushi,Kim Pop,31800,5400,37200
1398,1399,21-10-2020 14:48:14.777180,Saludable · Desayunos,Básico y elemental,27800,5000,32800
1399,1400,21-10-2020 14:48:14.986686,Hamburguesas · Desayunos,El Inglés Gastro Pub,34500,6600,41100
1400,1401,21-10-2020 14:48:15.096186,Saludable · Desayunos,Bawana - Sandwich,8900,3400,12300
1401,1402,21-10-2020 14:48:15.356034,Pollo · Sánduches,Pollos Century,17800,3000,20800
1402,1403,21-10-2020 14:48:15.665836,Típica · Parrilla,El Portal de la Antigua,53400,5600,59000
1403,1404,21-10-2020 14:48:15.775336,Crepes,San Crepes,31800,4900,36700
1404,1405,21-10-2020 14:48:15.934900,Sushi · Asiática,Arigato,29500,5300,34800
1405,1406,21-10-2020 14:48:16.244614,Saludable · Desayunos,Distrito Gourmet,27800,3700,31500
1406,1407,21-10-2020 14:48:16.604493,Hamburguesas · Panadería,NYC Burgers,12500,6200,18700
1407,1408,21-10-2020 14:48:16.864309,Desayunos · Sánduches,Garnish,45800,5200,51000
1408,1409,21-10-2020 14:48:17.023828,Saludable,Puro Verde,11870,5700,17570
1409,1410,21-10-2020 14:48:17.233420,Italiana,Bocatto Di Passo,11870,5000,16870
1410,1411,21-10-2020 14:48:17.393020,Sushi,Umi,48750,5600,54350
1411,1412,21-10-2020 14:48:17.652763,Sánduches · Pescados y Mariscos,Pacific Comida de Mar,9000,4000,13000
1412,1413,21-10-2020 14:48:17.912357,Típica,Cazuelitas 93,12500,3900,16400
1413,1414,21-10-2020 14:48:18.122054,Desayunos · Panadería,Pasteleite,15000,5900,20900
1414,1415,21-10-2020 14:48:18.383166,Peruana,Uma Cantina Peruana,8900,3200,12100
1415,1416,21-10-2020 14:48:18.643082,Saludable · Parrilla,The Angels Grill and Drinks,45800,6200,52000
1416,1417,21-10-2020 14:48:19.002955,Sushi,Kim Pop,70000,5400,75400
1417,1418,21-10-2020 14:48:19.212696,Típica,Sabrosito,53400,4000,57400
1418,1419,21-10-2020 14:48:19.422427,Desayunos · Típica,Fogón Sangileño,12500,5000,17500
1419,1420,21-10-2020 14:48:19.632192,Asiática,Thai Station,10700,6000,16700
1420,1421,21-10-2020 14:48:19.841856,Sánduches,Submarin,37900,3800,41700
1421,1422,21-10-2020 14:48:20.151515,Sánduches · China,Peru Mix,45800,5900,51700
1422,1423,21-10-2020 14:48:20.461362,Hamburguesas,Monchis - Hamburguesa,39700,4300,44000
1423,1424,21-10-2020 14:48:20.670978,Mexicana,Hidalgo Taquería,37900,4900,42800
1424,1425,21-10-2020 14:48:20.880668,Desayunos · Parrilla,Mi Patria,53400,4600,58000
1425,1426,21-10-2020 14:48:21.190449,Desayunos · Típica,D'Porco - Lechona,15600,6300,21900
1426,1427,21-10-2020 14:48:21.300123,Desayunos · Comida Rápida,La Veneca,7500,6300,13800
1427,1428,21-10-2020 14:48:21.609933,Postres · Desayunos,Aury Postres - Comidas & Picadas,45800,4700,50500
1428,1429,21-10-2020 14:48:21.969847,Desayunos · Comida Rápida,Chocolatto,23000,3400,26400
1429,1430,21-10-2020 14:48:22.129567,Desayunos,Cafetería el Kippe,35000,3200,38200
1430,1431,21-10-2020 14:48:22.289370,Postres · Desayunos,Buñuelos nacho,53400,6600,60000
1431,1432,21-10-2020 14:48:22.398887,Postres · Helados,Mahé,11870,6000,17870
1432,1433,21-10-2020 14:48:22.658710,Panadería,Boul,34500,3100,37600
1433,1434,21-10-2020 14:48:23.018604,Mexicana,La leyenda mexican kitchen,23000,3200,26200
1434,1435,21-10-2020 14:48:23.178308,Desayunos,Sr Buñuelo,23000,6400,29400
1435,1436,21-10-2020 14:48:23.337951,Saludable · Desayunos,Re.al Alimentos Reales,24200,4000,28200
1436,1437,21-10-2020 14:48:23.549253,Desayunos,Desayunos en Bogotá,48750,3400,52150
1437,1438,21-10-2020 14:48:23.859310,Desayunos · Jugos y Batidos,Frutiwow,53400,4100,57500
1438,1439,21-10-2020 14:48:24.069373,Desayunos · Mexicana,La Mera Mera - Mexicana,9000,3100,12100
1439,1440,21-10-2020 14:48:24.429341,Desayunos · Típica,Calentao Express,35000,6000,41000
1440,1441,21-10-2020 14:48:24.739183,Parrilla,Rústico Picadería,23000,3800,26800
1441,1442,21-10-2020 14:48:24.948986,Típica,Sabrosito,27800,4000,31800
1442,1443,21-10-2020 14:48:25.208761,Típica · Parrilla,Mi Ranchito Parrilla,15000,4400,19400
1443,1444,21-10-2020 14:48:25.368746,Sushi · Desayunos,Maki Roll,13000,4300,17300
1444,1445,21-10-2020 14:48:25.729318,Pizza,Pastas Laurentina,65000,4800,69800
1445,1446,21-10-2020 14:48:26.039887,Helados,Orso To Go,39700,6800,46500
1446,1447,21-10-2020 14:48:26.200151,Típica,El Cucharón - Tipica,34500,4400,38900
1447,1448,21-10-2020 14:48:26.410663,Desayunos · Café,Frambas,35000,3400,38400
1448,1449,21-10-2020 14:48:26.671075,Típica · Parrilla,Typykos,48750,6000,54750
1449,1450,21-10-2020 14:48:26.981667,Mexicana,Cantina La 15,24300,4300,28600
1450,1451,21-10-2020 14:48:27.091990,Desayunos · Típica,La Parrilla Dorada Polo,17800,6600,24400
1451,1452,21-10-2020 14:48:27.452772,Desayunos · Típica,La Frijolada,23000,4500,27500
1452,1453,21-10-2020 14:48:27.613249,Helados,Buon Gelato,65000,4400,69400
1453,1454,21-10-2020 14:48:27.773715,Típica,El Cucharón - Tipica,35000,4400,39400
1454,1455,21-10-2020 14:48:28.134173,Desayunos · Sánduches,Garnish,37900,5200,43100
1455,1456,21-10-2020 14:48:28.394720,Desayunos · Café,Matchacha,17800,5900,23700
1456,1457,21-10-2020 14:48:28.606826,Desayunos,Sunny Breakfast Brunch,23000,4300,27300
1457,1458,21-10-2020 14:48:28.716885,Postres · Desayunos,La Folie - Postres,18900,3300,22200
1458,1459,21-10-2020 14:48:29.077511,Desayunos · Típica,Fogón Sangileño,13000,5000,18000
1459,1460,21-10-2020 14:48:29.337407,Pizza,18 Scalini,35000,4300,39300
1460,1461,21-10-2020 14:48:29.648003,Típica,Juan Chorizo,37900,3900,41800
1461,1462,21-10-2020 14:48:29.807680,Pollo · Sánduches,Pollos Century,10700,3000,13700
1462,1463,21-10-2020 14:48:29.918046,Postres · Desayunos,Buñuelos nacho,24300,6600,30900
1463,1464,21-10-2020 14:48:30.278123,Típica,El Mondongo y Mucho Mas,24300,5600,29900
1464,1465,21-10-2020 14:48:30.638862,Desayunos · Sánduches,Garnish,13000,5200,18200
1465,1466,21-10-2020 14:48:30.798798,Crepes,San Crepes,10700,4900,15600
1466,1467,21-10-2020 14:48:31.059301,Desayunos · Café,El Gualilo,45800,6200,52000
1467,1468,21-10-2020 14:48:31.219175,Típica,Cabrito Santandereano,24200,6600,30800
1468,1469,21-10-2020 14:48:31.380041,Desayunos · Panadería,Pasteleite,17800,5900,23700
1469,1470,21-10-2020 14:48:31.590094,Típica,Cazuelitas 93,24200,3900,28100
1470,1471,21-10-2020 14:48:31.800146,Pescados y Mariscos,Pescadero Héroes del Mar,11870,6600,18470
1471,1472,21-10-2020 14:48:31.960027,Postres · Desayunos,BagBog Bagels,53400,6400,59800
1472,1473,21-10-2020 14:48:32.320037,Postres · Saludable,Ana Rebana,53900,6300,60200
1473,1474,21-10-2020 14:48:32.680299,Desayunos · Helados,San Giorgio Gelateria,70000,3100,73100
1474,1475,21-10-2020 14:48:33.040269,Postres · Desayunos,Vivalight Market.,27800,6500,34300
1475,1476,21-10-2020 14:48:33.200087,Desayunos · Panadería,Juliana Restaurante,37900,6100,44000
1476,1477,21-10-2020 14:48:33.560252,Pollo · Desayunos,Abasto,18900,3600,22500
1477,1478,21-10-2020 14:48:33.921081,Parrilla,Antojo a Domicilio,24200,5000,29200
1478,1479,21-10-2020 14:48:34.281276,Saludable · Desayunos,Re.al Alimentos Reales,23000,4000,27000
1479,1480,21-10-2020 14:48:34.441171,Desayunos,Sr Buñuelo,7500,6400,13900
1480,1481,21-10-2020 14:48:34.601044,Jugos y Batidos,Pomponio,23000,3600,26600
1481,1482,21-10-2020 14:48:34.860902,Desayunos,Sunny Breakfast Brunch,48750,4300,53050
1482,1483,21-10-2020 14:48:34.970668,Típica,Baondish,53900,5800,59700
1483,1484,21-10-2020 14:48:35.330695,Parrilla · Café,Gaira Café,8900,4400,13300
1484,1485,21-10-2020 14:48:35.490485,Mexicana,Mexicanachos,7500,3900,11400
1485,1486,21-10-2020 14:48:35.650307,Desayunos · Típica,Casa Vieja,13600,6000,19600
1486,1487,21-10-2020 14:48:35.910247,Postres · Desayunos,BagBog Bagels,8900,6400,15300
1487,1488,21-10-2020 14:48:36.220241,Parrilla,Antojo a Domicilio,29500,5000,34500
1488,1489,21-10-2020 14:48:36.430202,Desayunos · Café,Libertario Coffee Roasters,13000,4600,17600
1489,1490,21-10-2020 14:48:36.740293,Saludable · Desayunos,Distrito Gourmet,11870,3700,15570
1490,1491,21-10-2020 14:48:37.050363,Comida Rápida · Perros Calientes,Similoa - Comida Rapida,39700,3700,43400
1491,1492,21-10-2020 14:48:37.160216,Desayunos · Típica,Desayunadero de la 42,17800,5900,23700
1492,1493,21-10-2020 14:48:37.470225,Postres · Desayunos,Café Quindio,18900,5700,24600
1493,1494,21-10-2020 14:48:37.680118,Pollo,Señor Fantástico,18900,4700,23600
1494,1495,21-10-2020 14:48:37.890197,Desayunos · Típica,Parrilla Farandula Típico,27800,5900,33700
1495,1496,21-10-2020 14:48:38.000069,Típica · Parrilla,Toya,35000,4200,39200
1496,1497,21-10-2020 14:48:38.310073,Pollo · Saludable,Gratina,15600,4200,19800
1497,1498,21-10-2020 14:48:38.469920,Desayunos · Típica,Criollomania,48750,5200,53950
1498,1499,21-10-2020 14:48:38.629926,Desayunos · Jugos y Batidos,Kuriwaji,65000,6300,71300
1499,1500,21-10-2020 14:48:38.890250,Desayunos · Típica,90 Calentados,24200,3700,27900
1500,1501,21-10-2020 14:48:39.200333,Desayunos · Típica,Casa Vieja,15000,6000,21000
1501,1502,21-10-2020 14:48:39.460379,Parrilla,Rústico Picadería,11870,3800,15670
1502,1503,21-10-2020 14:48:39.670465,Típica · Pescados y Mariscos,Arroces Mrg,8900,4300,13200
1503,1504,21-10-2020 14:48:39.880421,Saludable · Desayunos,Raices Bienestar Gourmet,13000,6600,19600
1504,1505,21-10-2020 14:48:40.040289,Desayunos,Sunny Breakfast Brunch,15000,4300,19300
1505,1506,21-10-2020 14:48:40.300234,Parrilla,Coquitas,48750,5600,54350
1506,1507,21-10-2020 14:48:40.409972,Pollo · Saludable,Yerbabuena,29500,3900,33400
1507,1508,21-10-2020 14:48:40.519896,Saludable · Típica,Sopas Mrg,65000,3100,68100
1508,1509,21-10-2020 14:48:40.880023,Saludable · Desayunos,Libre de Culpa,12500,4000,16500
1509,1510,21-10-2020 14:48:41.039983,Desayunos · Típica,La Parrilla Dorada Polo,65000,6600,71600
1510,1511,21-10-2020 14:48:41.300035,Café · Helados,Sofia heladería y café,13600,5800,19400
1511,1512,21-10-2020 14:48:41.410000,Pizza,Pastas Laurentina,23000,4800,27800
1512,1513,21-10-2020 14:48:41.519722,Pollo · Pescados y Mariscos,Bang Bang Rice,37900,3400,41300
1513,1514,21-10-2020 14:48:41.729766,Desayunos,Bagel Shop,10700,3200,13900
1514,1515,21-10-2020 14:48:41.889707,Sánduches · China,Peru Mix,18900,5900,24800
1515,1516,21-10-2020 14:48:42.199784,Pizza · Italiana,Pisapore - Pizza,34500,6600,41100
1516,1517,21-10-2020 14:48:42.509873,Parrilla,Antojo a Domicilio,53400,5000,58400
1517,1518,21-10-2020 14:48:42.819961,Típica,Sabrosito,45800,4000,49800
1518,1519,21-10-2020 14:48:43.129943,Postres · Desayunos,Amelie Helados,23000,6400,29400
1519,1520,21-10-2020 14:48:43.490104,Típica,Sabores De Mi Tierra,53900,5400,59300
1520,1521,21-10-2020 14:48:43.850433,Parrilla,Coquitas,53400,5600,59000
1521,1522,21-10-2020 14:48:44.010349,Crepes,San Crepes,37900,4900,42800
1522,1523,21-10-2020 14:48:44.271422,Parrilla,Arepaisa de Medellín,65000,5600,70600
1523,1524,21-10-2020 14:48:44.631711,Pizza · Parrilla,Urban Lunch,23000,4000,27000
1524,1525,21-10-2020 14:48:44.791786,Desayunos · Panadería,Premium Break Bakery,65000,3700,68700
1525,1526,21-10-2020 14:48:45.101990,Internacional,La Esquina con Sabor Parrilla,23000,3000,26000
1526,1527,21-10-2020 14:48:45.262248,Pollo,Chicken House,34500,4200,38700
1527,1528,21-10-2020 14:48:45.572335,Postres · Desayunos,Jacques Pastelería,24300,5900,30200
1528,1529,21-10-2020 14:48:45.732363,Desayunos · Café,Moramia,70000,4700,74700
1529,1530,21-10-2020 14:48:46.092493,Parrilla,Arepaisa de Medellín,65000,5600,70600
1530,1531,21-10-2020 14:48:46.252466,Típica,La Herencia,23000,5900,28900
1531,1532,21-10-2020 14:48:46.412496,Pollo · China,China Tao,65000,3500,68500
1532,1533,21-10-2020 14:48:46.572483,Postres · Desayunos,Gelateria Da Favola,34500,6500,41000
1533,1534,21-10-2020 14:48:46.882573,Hamburguesas,Bendito Cordero,48750,5800,54550
1534,1535,21-10-2020 14:48:47.092612,Comida Rápida,Fiesta Digital Andrés,12500,3100,15600
1535,1536,21-10-2020 14:48:47.452813,Postres,Levelma,27800,6200,34000
1536,1537,21-10-2020 14:48:47.612769,Peruana,Masivo,24200,5800,30000
1537,1538,21-10-2020 14:48:47.722717,Saludable · Típica,Saludable Mrg,53900,5800,59700
1538,1539,21-10-2020 14:48:47.882663,Desayunos · Pescados y Mariscos,Luzí­a - Mediterranea,7500,5700,13200
1539,1540,21-10-2020 14:48:48.092591,Parrilla,Carnes la Zarza,8900,4900,13800
1540,1541,21-10-2020 14:48:48.402833,Desayunos,Cafetería el Kippe,23000,3200,26200
1541,1542,21-10-2020 14:48:48.562860,Saludable · Desayunos,Distrito Gourmet,53400,3700,57100
1542,1543,21-10-2020 14:48:48.872964,Desayunos,Desayunos en Bogotá,53400,3400,56800
1543,1544,21-10-2020 14:48:49.233084,Parrilla,Arroces Maria Paula,34500,6800,41300
1544,1545,21-10-2020 14:48:49.494201,Hamburguesas · Desayunos,El Inglés Gastro Pub,18900,6600,25500
1545,1546,21-10-2020 14:48:49.704332,Pizza · Italiana,Piatto - Pizza,13600,6600,20200
1546,1547,21-10-2020 14:48:50.064506,Típica,El Cucharón - Tipica,23000,4400,27400
1547,1548,21-10-2020 14:48:50.274596,Desayunos · Panadería,Premium Break Bakery,9000,3700,12700
1548,1549,21-10-2020 14:48:50.634810,Internacional,Rio Sabores y Experiencias,65000,4100,69100
1549,1550,21-10-2020 14:48:50.995011,Desayunos · Parrilla,Mi Patria,18900,4600,23500
1550,1551,21-10-2020 14:48:51.355218,Típica · Parrilla,El Santandereano,37900,5200,43100
1551,1552,21-10-2020 14:48:51.515385,Pollo · Desayunos,Caserito Gourmet,53400,6700,60100
1552,1553,21-10-2020 14:48:51.625449,Típica,Cazuelitas 93,31800,3900,35700
1553,1554,21-10-2020 14:48:51.935544,Desayunos · Árabe,Boniato Sabores Vivos,39700,5300,45000
1554,1555,21-10-2020 14:48:52.145767,Alta Cocina · Postres,La Pinta,35000,4500,39500
1555,1556,21-10-2020 14:48:52.355849,Sánduches · Pescados y Mariscos,Pacific Comida de Mar,37900,4000,41900
1556,1557,21-10-2020 14:48:52.515997,Desayunos · Panadería,Premium Break Bakery,65000,3700,68700
1557,1558,21-10-2020 14:48:52.726191,Desayunos · Sánduches,Danilo Colombia,48750,3300,52050
1558,1559,21-10-2020 14:48:52.986390,Postres,Beiked,65000,4000,69000
1559,1560,21-10-2020 14:48:53.146370,Desayunos · Parrilla,Mi Patria,39700,4600,44300
1560,1561,21-10-2020 14:48:53.456447,Desayunos · Café,Matchacha,48750,5900,54650
1561,1562,21-10-2020 14:48:53.666620,Pescados y Mariscos,Pescadero Héroes del Mar,9000,6600,15600
1562,1563,21-10-2020 14:48:53.876703,Desayunos · Café,Libertario Coffee Roasters,13600,4600,18200
1563,1564,21-10-2020 14:48:54.136823,Desayunos · Típica,La Frijolada,53400,4500,57900
1564,1565,21-10-2020 14:48:54.498210,Perros Calientes,Dog Shop - Rapida,10700,4900,15600
1565,1566,21-10-2020 14:48:54.708227,Típica,Bandejas Mrg,34500,3800,38300
1566,1567,21-10-2020 14:48:55.068445,Pollo · Desayunos,Caserito Gourmet,53400,6700,60100
1567,1568,21-10-2020 14:48:55.278501,Típica,Juan Chorizo,53900,3900,57800
1568,1569,21-10-2020 14:48:55.438479,Saludable · Desayunos,Básico y elemental,13600,5000,18600
1569,1570,21-10-2020 14:48:55.748646,Postres · Desayunos,Jacques Pastelería,70000,5900,75900
1570,1571,21-10-2020 14:48:55.958878,Desayunos,Butter,13000,6700,19700
1571,1572,21-10-2020 14:48:56.319183,Típica,La Cocina,53400,4600,58000
1572,1573,21-10-2020 14:48:56.479149,Desayunos · Típica,D´Porco,23000,3900,26900
1573,1574,21-10-2020 14:48:56.639258,Parrilla,Arepaisa de Medellín,39700,5600,45300
1574,1575,21-10-2020 14:48:56.799416,Desayunos · Típica,Criollomania,9000,5200,14200
1575,1576,21-10-2020 14:48:57.059470,Desayunos · Empanadas,Empanadas Doraditas.com,23000,3000,26000
1576,1577,21-10-2020 14:48:57.319535,Helados,Orso To Go,34500,6800,41300
1577,1578,21-10-2020 14:48:57.680012,Pollo · Desayunos,Workzone,10700,3100,13800
1578,1579,21-10-2020 14:48:58.040270,Desayunos · Café,Libertario Coffee Roasters,27800,4600,32400
1579,1580,21-10-2020 14:48:58.250380,Postres,Beiked,13600,4000,17600
1580,1581,21-10-2020 14:48:58.510546,Postres · Panadería,RIGHT AWAY FOODS,23000,6600,29600
1581,1582,21-10-2020 14:48:58.870743,Típica,Bandejas Mrg,17800,3800,21600
1582,1583,21-10-2020 14:48:59.130937,Comida Rápida,Fiesta Digital Andrés,13000,3100,16100
1583,1584,21-10-2020 14:48:59.391117,Típica,El Mondongo y Mucho Mas,12500,5600,18100
1584,1585,21-10-2020 14:48:59.602609,Parrilla,El Tambor,13600,6800,20400
1585,1586,21-10-2020 14:48:59.812884,Desayunos,Butter,70000,6700,76700
1586,1587,21-10-2020 14:49:00.123174,Postres · Desayunos,Sweet Tale,45800,5800,51600
1587,1588,21-10-2020 14:49:00.383498,Postres,La Galeta,65000,3000,68000
1588,1589,21-10-2020 14:49:00.543617,Desayunos · Sánduches,Frutos del Bosque,48750,3500,52250
1589,1590,21-10-2020 14:49:00.803966,Postres · Desayunos,Cosmo Cookies,23000,5900,28900
1590,1591,21-10-2020 14:49:00.914101,Típica,El Cucharón - Tipica,12500,4400,16900
1591,1592,21-10-2020 14:49:01.074393,Postres · Desayunos,Maltihelados,34500,6200,40700
1592,1593,21-10-2020 14:49:01.234566,Hamburguesas,Gofi Burger,48750,5100,53850
1593,1594,21-10-2020 14:49:01.394701,Postres · Saludable,Ana Rebana,15600,6300,21900
1594,1595,21-10-2020 14:49:01.604861,Desayunos,Jacinta Arepas de Huevo,53900,4000,57900
1595,1596,21-10-2020 14:49:01.865207,Postres,La Galeta,8900,3000,11900
1596,1597,21-10-2020 14:49:02.025254,Desayunos · Panadería,Artesanos,8900,4300,13200
1597,1598,21-10-2020 14:49:02.185440,Hamburguesas · Alitas,Beer,34500,6600,41100
1598,1599,21-10-2020 14:49:02.395592,Saludable · Desayunos,Re.al Alimentos Reales,8900,4000,12900
1599,1600,21-10-2020 14:49:02.555800,Saludable · Desayunos,Básico y elemental,53400,5000,58400
1600,1601,21-10-2020 14:49:02.916151,Típica,El Cucharón - Tipica,9000,4400,13400
1601,1602,21-10-2020 14:49:03.176535,Peruana,Uma Cantina Peruana,35000,3200,38200
1602,1603,21-10-2020 14:49:03.386705,Mexicana,Mexicanachos,53400,3900,57300
1603,1604,21-10-2020 14:49:03.747023,Pollo,Chicken House,53900,4200,58100
1604,1605,21-10-2020 14:49:03.857089,Mexicana,Hidalgo Taquería,37900,4900,42800
1605,1606,21-10-2020 14:49:04.017299,Postres · Desayunos,Vivalight Market.,37900,6500,44400
1606,1607,21-10-2020 14:49:04.127387,Mexicana,Mexicanachos,23000,3900,26900
1607,1608,21-10-2020 14:49:04.487840,Típica,Carbón & Mondongos,65000,6400,71400
1608,1609,21-10-2020 14:49:04.699219,Desayunos · Típica,La Parrilla Dorada Polo,15000,6600,21600
1609,1610,21-10-2020 14:49:05.009720,Pizza · Italiana,Pisapore - Pizza,34500,6600,41100
1610,1611,21-10-2020 14:49:05.219924,China,China Food Col,12500,3600,16100
1611,1612,21-10-2020 14:49:05.580362,Sánduches,Submarin,15000,3800,18800
1612,1613,21-10-2020 14:49:05.840711,Desayunos · Típica,Desayunadero de la 42,13000,5900,18900
1613,1614,21-10-2020 14:49:06.200989,Desayunos,Sr Buñuelo,37900,6400,44300
1614,1615,21-10-2020 14:49:06.561398,Café · Helados,Sofia heladería y café,7500,5800,13300
1615,1616,21-10-2020 14:49:06.921677,Mexicana,Cantina La 15,39700,4300,44000
1616,1617,21-10-2020 14:49:07.131881,Hamburguesas,Burger Society,27800,4100,31900
1617,1618,21-10-2020 14:49:07.342155,Desayunos,Jacinta Arepas de Huevo,13000,4000,17000
1618,1619,21-10-2020 14:49:07.702586,Parrilla,Beraca Parrilla Bbq,39700,5600,45300
1619,1620,21-10-2020 14:49:07.962837,Desayunos · Típica,Calentao Express,23000,6000,29000
1620,1621,21-10-2020 14:49:08.273338,Pizza,Pastas Laurentina,31800,4800,36600
1621,1622,21-10-2020 14:49:08.483693,Sushi,Sushi Reel,11870,4700,16570
1622,1623,21-10-2020 14:49:08.844157,Parrilla · Café,Gaira Café,13000,4400,17400
1623,1624,21-10-2020 14:49:08.954394,Pizza,pizza andante,31800,4200,36000
1624,1625,21-10-2020 14:49:09.214971,Desayunos · Sánduches,Danilo Colombia,65000,3300,68300
1625,1626,21-10-2020 14:49:09.425314,Saludable · Desayunos,Raices Bienestar Gourmet,39700,6600,46300
1626,1627,21-10-2020 14:49:09.736728,Postres,La Tertulia,31800,3400,35200
1627,1628,21-10-2020 14:49:09.896957,Desayunos · Internacional,Camilia,53400,3900,57300
1628,1629,21-10-2020 14:49:10.207418,Pollo · China,China Tao,65000,3500,68500
1629,1630,21-10-2020 14:49:10.467660,Hamburguesas · Desayunos,El Inglés Gastro Pub,7500,6600,14100
1630,1631,21-10-2020 14:49:10.778212,Saludable · Desayunos,Fresh Co,7500,5600,13100
1631,1632,21-10-2020 14:49:10.888389,Desayunos · Helados,San Giorgio Gelateria,70000,3100,73100
1632,1633,21-10-2020 14:49:11.099005,Parrilla · Internacional,Taperia de la Plaza,7500,5700,13200
1633,1634,21-10-2020 14:49:11.309334,Postres · Desayunos,Buñuelos nacho,23000,6600,29600
1634,1635,21-10-2020 14:49:11.569473,Desayunos · Sánduches,Garnish,27800,5200,33000
1635,1636,21-10-2020 14:49:11.829655,Desayunos · Empanadas,Mis Delicias,24200,3200,27400
1636,1637,21-10-2020 14:49:11.989916,Alta Cocina · Parrilla,Criterión,17800,6000,23800
1637,1638,21-10-2020 14:49:12.350121,Hamburguesas,Monchis - Hamburguesa,13000,4300,17300
1638,1639,21-10-2020 14:49:12.460481,Típica,El Mondongo y Mucho Mas,27800,5600,33400
1639,1640,21-10-2020 14:49:12.770909,Pollo · Desayunos,Workzone,35000,3100,38100
1640,1641,21-10-2020 14:49:13.031171,Asiática,Thai Station,27800,6000,33800
1641,1642,21-10-2020 14:49:13.141318,Parrilla · Internacional,Taperia de la Plaza,24200,5700,29900
1642,1643,21-10-2020 14:49:13.251426,Desayunos · Café,Moramia,45800,4700,50500
1643,1644,21-10-2020 14:49:13.411726,Desayunos · Sánduches,Garnish,9000,5200,14200
1644,1645,21-10-2020 14:49:13.722388,Desayunos,Cafetería el Kippe,39700,3200,42900
1645,1646,21-10-2020 14:49:14.032766,Desayunos · Sánduches,Frutos del Bosque,39700,3500,43200
1646,1647,21-10-2020 14:49:14.143079,Desayunos · Jugos y Batidos,Frutiwow,17800,4100,21900
1647,1648,21-10-2020 14:49:14.303406,Postres · Desayunos,KOKOA & co.,15600,4700,20300
1648,1649,21-10-2020 14:49:14.663940,Desayunos · Típica,D´Porco,15600,3900,19500
1649,1650,21-10-2020 14:49:14.925513,Desayunos · Típica,Casa Vieja,8900,6000,14900
1650,1651,21-10-2020 14:49:15.286136,Desayunos · Empanadas,Empanadas Doraditas.com,34500,3000,37500
1651,1652,21-10-2020 14:49:15.496484,Pizza · Italiana,Piatto - Pizza,13600,6600,20200
1652,1653,21-10-2020 14:49:15.857105,Típica,Cabrito Santandereano,23000,6600,29600
1653,1654,21-10-2020 14:49:16.117559,Postres,Beiked,45800,4000,49800
1654,1655,21-10-2020 14:49:16.327825,Hamburguesas · Desayunos,El Inglés Gastro Pub,53900,6600,60500
1655,1656,21-10-2020 14:49:16.438068,Desayunos · Panadería,Juliana Restaurante,37900,6100,44000
1656,1657,21-10-2020 14:49:16.748740,Pollo · Desayunos,Piaf,12500,6500,19000
1657,1658,21-10-2020 14:49:16.959242,Postres · Café,Celestino Café,34500,5900,40400
1658,1659,21-10-2020 14:49:17.119559,Mexicana,Cantina La 15,70000,4300,74300
1659,1660,21-10-2020 14:49:17.229768,Parrilla,Restaurante Bar Mi Ranchito,11870,5200,17070
1660,1661,21-10-2020 14:49:17.339934,Desayunos,La Frijolada Desayunos,18900,4400,23300
1661,1662,21-10-2020 14:49:17.700748,Desayunos · Panadería,Santa Juana Food Bar,48750,5900,54650
1662,1663,21-10-2020 14:49:17.961275,Desayunos · Árabe,Boniato Sabores Vivos,7500,5300,12800
1663,1664,21-10-2020 14:49:18.271558,Desayunos · Mexicana,La Mera Mera - Mexicana,65000,3100,68100
1664,1665,21-10-2020 14:49:18.431825,Sánduches,Submarin,13000,3800,16800
1665,1666,21-10-2020 14:49:18.592214,Saludable · Parrilla,The Angels Grill and Drinks,48750,6200,54950
1666,1667,21-10-2020 14:49:18.952824,Hamburguesas,Gofi Burger,34500,5100,39600
1667,1668,21-10-2020 14:49:19.213526,Postres,Levelma,70000,6200,76200
1668,1669,21-10-2020 14:49:19.323754,Desayunos · Típica,Rojo Gourmet,23000,4700,27700
1669,1670,21-10-2020 14:49:19.634208,Pollo · Desayunos,Abasto,35000,3600,38600
1670,1671,21-10-2020 14:49:19.744640,Desayunos,Sr Buñuelo,8900,6400,15300
1671,1672,21-10-2020 14:49:19.956153,Desayunos · Pescados y Mariscos,Gypsy Bistro,53400,4500,57900
1672,1673,21-10-2020 14:49:20.116811,Parrilla,Campocina,13000,4600,17600
1673,1674,21-10-2020 14:49:20.427183,Parrilla,Parrilla Pimentón,31800,3400,35200
1674,1675,21-10-2020 14:49:20.637611,Postres · Desayunos,Sweet Tale,13000,5800,18800
1675,1676,21-10-2020 14:49:20.747915,Pizza,18 Scalini,12500,4300,16800
1676,1677,21-10-2020 14:49:21.108532,Postres · Desayunos,Sweet Tale,23000,5800,28800
1677,1678,21-10-2020 14:49:21.419195,Saludable · Desayunos,La Estampilla,53900,6000,59900
1678,1679,21-10-2020 14:49:21.780035,Parrilla,Restaurante Bar Mi Ranchito,8900,5200,14100
1679,1680,21-10-2020 14:49:22.090545,Desayunos · Panadería,Le Pain Quotidien,24300,3900,28200
1680,1681,21-10-2020 14:49:22.301051,Parrilla,Parrilla Pimentón,27800,3400,31200
1681,1682,21-10-2020 14:49:22.511499,Desayunos · Típica,D´Porco,65000,3900,68900
1682,1683,21-10-2020 14:49:22.822098,Desayunos · Café,Frambas,35000,3400,38400
1683,1684,21-10-2020 14:49:22.932244,Postres · Desayunos,Café Quindio,45800,5700,51500
1684,1685,21-10-2020 14:49:23.192829,Sushi,Canoa To Go,12500,5900,18400
1685,1686,21-10-2020 14:49:23.403328,Postres · Desayunos,KOKOA & co.,37900,4700,42600
1686,1687,21-10-2020 14:49:23.714132,Pizza,Pizza Andante,53900,6300,60200
1687,1688,21-10-2020 14:49:23.974681,Desayunos · Panadería,Siena Café,24200,3700,27900
1688,1689,21-10-2020 14:49:24.084977,Parrilla,Carnes la Zarza,45800,4900,50700
1689,1690,21-10-2020 14:49:24.245267,Asiática,Thai Station,31800,6000,37800
1690,1691,21-10-2020 14:49:24.605963,Pollo · Desayunos,Piaf,53400,6500,59900
1691,1692,21-10-2020 14:49:24.716399,Típica,La Herencia,53900,5900,59800
1692,1693,21-10-2020 14:49:25.028004,Hamburguesas,Gofi Burger,12500,5100,17600
1693,1694,21-10-2020 14:49:25.138534,Típica,Baondish,23000,5800,28800
1694,1695,21-10-2020 14:49:25.349229,Alta Cocina · Postres,La Pinta,53900,4500,58400
1695,1696,21-10-2020 14:49:25.709835,Pollo,Chicken House,18900,4200,23100
1696,1697,21-10-2020 14:49:26.070481,Helados,Buon Gelato,23000,4400,27400
1697,1698,21-10-2020 14:49:26.180858,Desayunos · Típica,D'Porco - Lechona,11870,6300,18170
1698,1699,21-10-2020 14:49:26.291194,Postres · Desayunos,Restaurante Cornelia,18900,5500,24400
1699,1700,21-10-2020 14:49:26.651831,Típica · Parrilla,La Parilla de David,23000,3100,26100
1700,1701,21-10-2020 14:49:26.762206,Típica,Bandejas Mrg,27800,3800,31600
1701,1702,21-10-2020 14:49:27.022750,Típica · Parrilla,Toya,24300,4200,28500
1702,1703,21-10-2020 14:49:27.283328,Saludable · Desayunos,Malú,15000,3700,18700
1703,1704,21-10-2020 14:49:27.543901,Saludable · Desayunos,Básico y elemental,12500,5000,17500
1704,1705,21-10-2020 14:49:27.854433,Desayunos,El Fogón Castellano,48750,3200,51950
1705,1706,21-10-2020 14:49:28.014841,Postres · Desayunos,Jacques Pastelería,15000,5900,20900
1706,1707,21-10-2020 14:49:28.225340,Pescados y Mariscos,Pescadero Héroes del Mar,23000,6600,29600
1707,1708,21-10-2020 14:49:28.585923,Saludable · Desayunos,Básico y Elemental,13000,5900,18900
1708,1709,21-10-2020 14:49:28.746286,Postres,Levelma,17800,6200,24000
1709,1710,21-10-2020 14:49:29.106944,Parrilla,Coquitas,13000,5600,18600
1710,1711,21-10-2020 14:49:29.317540,Postres · Desayunos,Vivalight Market.,53400,6500,59900
1711,1712,21-10-2020 14:49:29.628036,Pizza · Parrilla,Urban Lunch,53400,4000,57400
1712,1713,21-10-2020 14:49:29.938650,Desayunos · Típica,Parrilla Farandula Típico,29500,5900,35400
1713,1714,21-10-2020 14:49:30.199245,Desayunos · Panadería,Santa Juana Food Bar,15000,5900,20900
1714,1715,21-10-2020 14:49:30.510024,Peruana,Masivo,31800,5800,37600
1715,1716,21-10-2020 14:49:30.870613,Postres,La Tertulia,13000,3400,16400
1716,1717,21-10-2020 14:49:31.181366,Pollo · Desayunos,Piaf,70000,6500,76500
1717,1718,21-10-2020 14:49:31.541919,Alta Cocina · Parrilla,Criterión,10700,6000,16700
1718,1719,21-10-2020 14:49:31.902478,Típica,Bendita S,29500,4600,34100
1719,1720,21-10-2020 14:49:32.112941,Postres · Desayunos,KOKOA & co.,10700,4700,15400
1720,1721,21-10-2020 14:49:32.373479,Saludable · Desayunos,Maracuyá,53900,6700,60600
1721,1722,21-10-2020 14:49:32.583974,Saludable,MIMA,12500,3700,16200
1722,1723,21-10-2020 14:49:32.944625,Postres · Desayunos,Sweet Tale,8900,5800,14700
1723,1724,21-10-2020 14:49:33.255282,Sushi · Asiática,Arigato,65000,5300,70300
1724,1725,21-10-2020 14:49:33.566023,Desayunos · Típica,Calentao Express,10700,6000,16700
1725,1726,21-10-2020 14:49:33.926634,Desayunos · Empanadas,Empanadas Doraditas.com,29500,3000,32500
1726,1727,21-10-2020 14:49:34.187274,Pollo · Saludable,Tremenda Sal y Dulce,35000,6500,41500
1727,1728,21-10-2020 14:49:34.547908,Comida Rápida,Fiesta Digital Andrés,27800,3100,30900
1728,1729,21-10-2020 14:49:34.908696,Desayunos · Internacional,Camilia,53900,3900,57800
1729,1730,21-10-2020 14:49:35.069291,Desayunos · Típica,Papadió - Colombianas,53400,5700,59100
1730,1731,21-10-2020 14:49:35.231150,Alta Cocina · Parrilla,Criterión,17800,6000,23800
1731,1732,21-10-2020 14:49:35.541984,Parrilla · Internacional,Taperia de la Plaza,48750,5700,54450
1732,1733,21-10-2020 14:49:35.752704,Saludable · Desayunos,Malú,45800,3700,49500
1733,1734,21-10-2020 14:49:36.063496,Desayunos,Bagel Shop,24300,3200,27500
1734,1735,21-10-2020 14:49:36.324080,Desayunos · Panadería,Pasteleite,53400,5900,59300
1735,1736,21-10-2020 14:49:36.634951,Desayunos · Típica,Parrilla Farandula Típico,10700,5900,16600
1736,1737,21-10-2020 14:49:36.795907,Saludable,The Good Rice Bowls,10700,3500,14200
1737,1738,21-10-2020 14:49:37.106576,Típica,Campo Victoria,23000,3000,26000
1738,1739,21-10-2020 14:49:37.467378,Desayunos · Típica,Papadió - Colombianas,24300,5700,30000
1739,1740,21-10-2020 14:49:37.728061,Desayunos · Jugos y Batidos,Kuriwaji,65000,6300,71300
1740,1741,21-10-2020 14:49:37.938726,Desayunos · Café,Matchacha,70000,5900,75900
1741,1742,21-10-2020 14:49:38.149404,Perros Calientes,Dog Shop - Rapida,8900,4900,13800
1742,1743,21-10-2020 14:49:38.459965,Pollo · Desayunos,Piaf,35000,6500,41500
1743,1744,21-10-2020 14:49:38.620476,Desayunos,Bagel Shop,35000,3200,38200
1744,1745,21-10-2020 14:49:38.831227,Parrilla,OAK Ahumado y Brebajes,45800,6000,51800
1745,1746,21-10-2020 14:49:38.991533,Desayunos · Helados,San Giorgio Gelateria,17800,3100,20900
1746,1747,21-10-2020 14:49:39.102238,Helados,Orso To Go,11870,6800,18670
1747,1748,21-10-2020 14:49:39.212828,Panadería,Boul,17800,3100,20900
1748,1749,21-10-2020 14:49:39.323155,Desayunos,Butter,23000,6700,29700
1749,1750,21-10-2020 14:49:39.683813,Desayunos · Típica,D´Porco,10700,3900,14600
1750,1751,21-10-2020 14:49:39.794431,Helados,Orso To Go,70000,6800,76800
1751,1752,21-10-2020 14:49:40.155335,Desayunos · Panadería,Siena Café,39700,3700,43400
1752,1753,21-10-2020 14:49:40.317081,Helados,Buon Gelato,24200,4400,28600
1753,1754,21-10-2020 14:49:40.677871,Saludable,Puro Verde,9000,5700,14700
1754,1755,21-10-2020 14:49:40.938751,Hamburguesas,Monchis - Hamburguesa,45800,4300,50100
1755,1756,21-10-2020 14:49:41.049549,Desayunos · Café,El Gualilo,8900,6200,15100
1756,1757,21-10-2020 14:49:41.310047,Parrilla,Rústico Picadería,15000,3800,18800
1757,1758,21-10-2020 14:49:41.570731,Parrilla,OAK Ahumado y Brebajes,35000,6000,41000
1758,1759,21-10-2020 14:49:41.831327,Peruana,Uma Cantina Peruana,10700,3200,13900
1759,1760,21-10-2020 14:49:42.092041,Desayunos · Café,El Gualilo,12500,6200,18700
1760,1761,21-10-2020 14:49:42.252579,Desayunos · Mexicana,La Mera Mera - Mexicana,65000,3100,68100
1761,1762,21-10-2020 14:49:42.563342,Pollo · Típica,Auyama,17800,3900,21700
1762,1763,21-10-2020 14:49:42.673984,Postres · Desayunos,Amelie Helados,70000,6400,76400
1763,1764,21-10-2020 14:49:43.034824,Parrilla,Beraca Parrilla Bbq,12500,5600,18100
1764,1765,21-10-2020 14:49:43.195506,Típica,Cazuelitas 93,15600,3900,19500
1765,1766,21-10-2020 14:49:43.356071,Típica,La Herencia,24300,5900,30200
1766,1767,21-10-2020 14:49:43.516743,Pollo · Desayunos,Abasto,17800,3600,21400
1767,1768,21-10-2020 14:49:43.877609,Pizza,18 Scalini,13000,4300,17300
1768,1769,21-10-2020 14:49:44.088242,Desayunos · Empanadas,Empanadas Doraditas.com,27800,3000,30800
1769,1770,21-10-2020 14:49:44.449223,Desayunos,Archies Desayunos,35000,3100,38100
1770,1771,21-10-2020 14:49:44.709764,Sushi,Kim Pop,29500,5400,34900
1771,1772,21-10-2020 14:49:44.970319,Pollo · Desayunos,Caserito Gourmet,18900,6700,25600
1772,1773,21-10-2020 14:49:45.281153,Típica,Lo Nuestro,34500,3100,37600
1773,1774,21-10-2020 14:49:45.443136,Desayunos · Típica,Desayunadero de la 42,31800,5900,37700
1774,1775,21-10-2020 14:49:45.804310,Desayunos · Típica,Papadió - Colombianas,39700,5700,45400
1775,1776,21-10-2020 14:49:46.115031,Desayunos · Típica,Alce,13600,4900,18500
1776,1777,21-10-2020 14:49:46.325784,Desayunos · Típica,La Parrilla Dorada Polo,45800,6600,52400
1777,1778,21-10-2020 14:49:46.586439,Típica,Campo Victoria,17800,3000,20800
1778,1779,21-10-2020 14:49:46.947399,Parrilla,OAK Ahumado y Brebajes,39700,6000,45700
1779,1780,21-10-2020 14:49:47.057928,Desayunos · Empanadas,Mis Delicias,29500,3200,32700
1780,1781,21-10-2020 14:49:47.268594,Pollo · Sánduches,Pollos Century,12500,3000,15500
1781,1782,21-10-2020 14:49:47.379207,Desayunos · Panadería,Santa Juana Food Bar,35000,5900,40900
1782,1783,21-10-2020 14:49:47.590013,Típica,La Cocina,23000,4600,27600
1783,1784,21-10-2020 14:49:47.800831,Desayunos · Pescados y Mariscos,Gypsy Bistro,29500,4500,34000
1784,1785,21-10-2020 14:49:48.111670,Hamburguesas · Saludable,Restaurant Inn,45800,6100,51900
1785,1786,21-10-2020 14:49:48.322422,Desayunos · Típica,Rojo Gourmet,23000,4700,27700
1786,1787,21-10-2020 14:49:48.633251,Parrilla · Internacional,Taperia de la Plaza,10700,5700,16400
1787,1788,21-10-2020 14:49:48.793776,Hamburguesas,Gofi Burger,35000,5100,40100
1788,1789,21-10-2020 14:49:49.054423,Comida Rápida · Perros Calientes,Similoa - Comida Rapida,34500,3700,38200
1789,1790,21-10-2020 14:49:49.265118,Hamburguesas · Desayunos,El Inglés Gastro Pub,24300,6600,30900
1790,1791,21-10-2020 14:49:49.375618,Hamburguesas,Monchis - Hamburguesa,10700,4300,15000
1791,1792,21-10-2020 14:49:49.736468,Saludable · Desayunos,Maracuyá,70000,6700,76700
1792,1793,21-10-2020 14:49:49.847051,Típica · Pescados y Mariscos,La Vitualla,31800,6300,38100
1793,1794,21-10-2020 14:49:50.057596,Típica,Sopitas y Más,11870,4200,16070
1794,1795,21-10-2020 14:49:50.418415,Mexicana,Mexicanachos,27800,3900,31700
1795,1796,21-10-2020 14:49:50.780615,Desayunos,Desayunos en Bogotá,15600,3400,19000
1796,1797,21-10-2020 14:49:50.941675,Típica · Parrilla,El Santandereano,15600,5200,20800
1797,1798,21-10-2020 14:49:51.052194,Pollo · Pescados y Mariscos,Bang Bang Rice,29500,3400,32900
1798,1799,21-10-2020 14:49:51.212889,Hamburguesas · Panadería,NYC Burgers,31800,6200,38000
1799,1800,21-10-2020 14:49:51.523811,Desayunos · Sánduches,Danilo Colombia,24200,3300,27500
1800,1801,21-10-2020 14:49:51.784603,Desayunos,Butter,31800,6700,38500
1801,1802,21-10-2020 14:49:52.095431,Mexicana,Hidalgo Taquería,13600,4900,18500
1802,1803,21-10-2020 14:49:52.406296,Saludable,A2manos,48750,4200,52950
1803,1804,21-10-2020 14:49:52.567077,Hamburguesas · Saludable,Restaurant Inn,10700,6100,16800
1804,1805,21-10-2020 14:49:52.827943,Pollo · Sánduches,Pollos Century,53900,3000,56900
1805,1806,21-10-2020 14:49:53.088650,Postres · Saludable,Ana Rebana,13600,6300,19900
1806,1807,21-10-2020 14:49:53.349560,Desayunos,La Frijolada Desayunos,31800,4400,36200
1807,1808,21-10-2020 14:49:53.610340,Pollo,Heart & Cooking,48750,5000,53750
1808,1809,21-10-2020 14:49:53.971339,Desayunos · Café,El Gualilo,12500,6200,18700
1809,1810,21-10-2020 14:49:54.332426,Pollo,Chicken House,35000,4200,39200
1810,1811,21-10-2020 14:49:54.643305,Postres · Helados,Mahé,12500,6000,18500
1811,1812,21-10-2020 14:49:54.854089,Parrilla · Internacional,Taperia de la Plaza,45800,5700,51500
1812,1813,21-10-2020 14:49:55.014755,Pollo · China,China Tao,13000,3500,16500
1813,1814,21-10-2020 14:49:55.375537,Parrilla,OAK Ahumado y Brebajes,11870,6000,17870
1814,1815,21-10-2020 14:49:55.486578,Perros Calientes,Dog Shop - Rapida,9000,4900,13900
1815,1816,21-10-2020 14:49:55.747351,Café · Helados,Sofia heladería y café,8900,5800,14700
1816,1817,21-10-2020 14:49:56.059446,Parrilla,Carnes la Zarza,45800,4900,50700
1817,1818,21-10-2020 14:49:56.270295,Comida Rápida,Fiesta Digital Andrés,53900,3100,57000
1818,1819,21-10-2020 14:49:56.381205,Desayunos · Helados,San Giorgio Gelateria,65000,3100,68100
1819,1820,21-10-2020 14:49:56.692160,Postres · Saludable,Ana Rebana,7500,6300,13800
1820,1821,21-10-2020 14:49:56.902945,Saludable · Desayunos,Bawana - Sandwich,15000,3400,18400
1821,1822,21-10-2020 14:49:57.163907,Típica · Parrilla,La Ternera Parrilla,53900,5200,59100
1822,1823,21-10-2020 14:49:57.424674,Hamburguesas,Monchis - Hamburguesa,8900,4300,13200
1823,1824,21-10-2020 14:49:57.735557,Peruana,Uma Cantina Peruana,24200,3200,27400
1824,1825,21-10-2020 14:49:57.946311,Pizza,pizza andante,27800,4200,32000
1825,1826,21-10-2020 14:49:58.307250,Saludable · Típica,Saludable Mrg,34500,5800,40300
1826,1827,21-10-2020 14:49:58.418010,Pizza · Parrilla,Urban Lunch,23000,4000,27000
1827,1828,21-10-2020 14:49:58.678957,Hamburguesas,Bendito Cordero,35000,5800,40800
1828,1829,21-10-2020 14:49:58.789849,Café · Helados,Sofia heladería y café,53900,5800,59700
1829,1830,21-10-2020 14:49:59.150722,Sushi · Asiática,Tu Sushi,34500,6400,40900
1830,1831,21-10-2020 14:49:59.411535,Desayunos · Panadería,Pasteleite,13600,5900,19500
1831,1832,21-10-2020 14:49:59.572392,Parrilla,Arepaisa de Medellín,35000,5600,40600
1832,1833,21-10-2020 14:49:59.733062,Desayunos · Típica,D'Porco - Lechona,53900,6300,60200
1833,1834,21-10-2020 14:50:00.094355,Desayunos · Panadería,Siena Café,18900,3700,22600
1834,1835,21-10-2020 14:50:00.305317,Desayunos · Panadería,El Pan de Phillippe,11870,4600,16470
1835,1836,21-10-2020 14:50:00.666337,Saludable · Típica,Sopas Mrg,23000,3100,26100
1836,1837,21-10-2020 14:50:01.027458,Panadería,Boul,48750,3100,51850
1837,1838,21-10-2020 14:50:01.389558,Italiana,F*cking Good Pizza,65000,4200,69200
1838,1839,21-10-2020 14:50:01.700686,Saludable · Desayunos,Bawana - Sandwich,37900,3400,41300
1839,1840,21-10-2020 14:50:01.961637,Desayunos · Café,Libertario Coffee Roasters,48750,4600,53350
1840,1841,21-10-2020 14:50:02.122362,Pollo · Saludable,Gratina,24300,4200,28500
1841,1842,21-10-2020 14:50:02.433464,Hamburguesas · Saludable,Restaurant Inn,35000,6100,41100
1842,1843,21-10-2020 14:50:02.594380,Desayunos · Panadería,El Pan de Phillippe,8900,4600,13500
1843,1844,21-10-2020 14:50:02.955466,Desayunos · Pescados y Mariscos,Gypsy Bistro,13000,4500,17500
1844,1845,21-10-2020 14:50:03.266440,Parrilla,Parrilla Pimentón,13600,3400,17000
1845,1846,21-10-2020 14:50:03.377272,Pollo · Saludable,Gratina,12500,4200,16700
1846,1847,21-10-2020 14:50:03.738284,Típica,Sabores De Mi Tierra,11870,5400,17270
1847,1848,21-10-2020 14:50:03.999126,Desayunos,Don Leo,53900,6000,59900
1848,1849,21-10-2020 14:50:04.310149,Parrilla,Rústico Picadería,35000,3800,38800
1849,1850,21-10-2020 14:50:04.521178,Desayunos,Desayunos en Bogotá,15000,3400,18400
1850,1851,21-10-2020 14:50:04.631836,Desayunos · Café,Aromacafé el Placer de Compartir,15600,5000,20600
1851,1852,21-10-2020 14:50:04.942951,Desayunos · Panadería,Ficchi Panadería,9000,3100,12100
1852,1853,21-10-2020 14:50:05.254055,Saludable,A2manos,7500,4200,11700
1853,1854,21-10-2020 14:50:05.565083,Parrilla,Antojo a Domicilio,18900,5000,23900
1854,1855,21-10-2020 14:50:05.825997,Parrilla · Café,Gaira Café,37900,4400,42300
1855,1856,21-10-2020 14:50:06.086685,Típica · Parrilla,El Portal de la Antigua,13000,5600,18600
1856,1857,21-10-2020 14:50:06.297565,Típica,Lo Nuestro,48750,3100,51850
1857,1858,21-10-2020 14:50:06.509583,Típica,Carbón & Mondongos,8900,6400,15300
1858,1859,21-10-2020 14:50:06.820701,Desayunos,El Fogón Castellano,7500,3200,10700
1859,1860,21-10-2020 14:50:07.031446,Pollo,Oliva Va,65000,5600,70600
1860,1861,21-10-2020 14:50:07.342584,Saludable · Desayunos,Re.al Alimentos Reales,15600,4000,19600
1861,1862,21-10-2020 14:50:07.553543,Pollo · Saludable,Gratina,70000,4200,74200
1862,1863,21-10-2020 14:50:07.664356,Postres · Desayunos,BagBog Bagels,45800,6400,52200
1863,1864,21-10-2020 14:50:07.775137,Postres · Desayunos,Café Quindio,7500,5700,13200
1864,1865,21-10-2020 14:50:07.885912,Italiana,F*cking Good Pizza,27800,4200,32000
1865,1866,21-10-2020 14:50:07.996569,Pollo · China,China Tao,24300,3500,27800
1866,1867,21-10-2020 14:50:08.107526,Desayunos · Típica,90 Calentados,39700,3700,43400
1867,1868,21-10-2020 14:50:08.368655,Pollo · Saludable,Gratina,35000,4200,39200
1868,1869,21-10-2020 14:50:08.729783,Postres,La Galeta,24200,3000,27200
1869,1870,21-10-2020 14:50:09.090825,Crepes,San Crepes,53400,4900,58300
1870,1871,21-10-2020 14:50:09.251692,Postres · Panadería,RIGHT AWAY FOODS,7500,6600,14100
1871,1872,21-10-2020 14:50:09.462735,Desayunos · Internacional,Camilia,18900,3900,22800
1872,1873,21-10-2020 14:50:09.823824,Saludable · Desayunos,Libre de Culpa,45800,4000,49800
1873,1874,21-10-2020 14:50:09.984896,Pollo · Desayunos,Candelina,10700,5300,16000
1874,1875,21-10-2020 14:50:10.145749,Café · Helados,Sofia heladería y café,70000,5800,75800
1875,1876,21-10-2020 14:50:10.456787,Desayunos · Helados,San Giorgio Gelateria,24300,3100,27400
1876,1877,21-10-2020 14:50:10.818027,Saludable · Típica,Sopas Mrg,53400,3100,56500
1877,1878,21-10-2020 14:50:11.179009,Parrilla · Café,Gaira Café,39700,4400,44100
1878,1879,21-10-2020 14:50:11.541487,Típica,Sopitas y Más,8900,4200,13100
1879,1880,21-10-2020 14:50:11.802573,Pollo · Desayunos,Candelina,9000,5300,14300
1880,1881,21-10-2020 14:50:11.963536,Pollo,Oliva Va,7500,5600,13100
1881,1882,21-10-2020 14:50:12.324666,Desayunos · Típica,Calentao Express,70000,6000,76000
1882,1883,21-10-2020 14:50:12.435560,Desayunos · Panadería,Decofruta,15000,4700,19700
1883,1884,21-10-2020 14:50:12.546456,Postres · Desayunos,BagBog Bagels,11870,6400,18270
1884,1885,21-10-2020 14:50:12.707398,Desayunos,Butter,45800,6700,52500
1885,1886,21-10-2020 14:50:12.918300,Desayunos · Panadería,Ficchi Panadería,34500,3100,37600
1886,1887,21-10-2020 14:50:13.179428,Parrilla,Arepaisa de Medellín,24300,5600,29900
1887,1888,21-10-2020 14:50:13.540705,Típica,Campo Victoria,53400,3000,56400
1888,1889,21-10-2020 14:50:13.801893,Hamburguesas · Desayunos,El Inglés Gastro Pub,18900,6600,25500
1889,1890,21-10-2020 14:50:14.062919,Típica,El Mondongo y Mucho Mas,23000,5600,28600
1890,1891,21-10-2020 14:50:14.273851,Típica · Parrilla,El Portal de la Antigua,15600,5600,21200
1891,1892,21-10-2020 14:50:14.635125,Típica · Parrilla,La Parilla de David,11870,3100,14970
1892,1893,21-10-2020 14:50:14.946384,Desayunos,Don Leo,13000,6000,19000
1893,1894,21-10-2020 14:50:15.207381,Típica · Parrilla,La Ternera Parrilla,12500,5200,17700
1894,1895,21-10-2020 14:50:15.418771,Comida Rápida · Perros Calientes,Similoa - Comida Rapida,9000,3700,12700
1895,1896,21-10-2020 14:50:15.780004,Mexicana,La leyenda mexican kitchen,39700,3200,42900
1896,1897,21-10-2020 14:50:16.041155,Pizza · Parrilla,Urban Lunch,29500,4000,33500
1897,1898,21-10-2020 14:50:16.302804,Pizza · Italiana,Pisapore - Pizza,53400,6600,60000
1898,1899,21-10-2020 14:50:16.463647,Típica,La Herencia,53400,5900,59300
1899,1900,21-10-2020 14:50:16.575793,Parrilla,Carnes la Zarza,10700,4900,15600
1900,1901,21-10-2020 14:50:16.686861,Sushi,Sushi Reel,24300,4700,29000
1901,1902,21-10-2020 14:50:16.948097,Desayunos · Internacional,Camilia,53900,3900,57800
1902,1903,21-10-2020 14:50:17.209586,Saludable · Desayunos,Fresh Co,9000,5600,14600
1903,1904,21-10-2020 14:50:17.370647,Desayunos · Helados,San Giorgio Gelateria,13000,3100,16100
1904,1905,21-10-2020 14:50:17.681832,Saludable,MIMA,39700,3700,43400
1905,1906,21-10-2020 14:50:17.792819,Saludable · Desayunos,Malú,34500,3700,38200
1906,1907,21-10-2020 14:50:17.953861,Parrilla · Café,Gaira Café,65000,4400,69400
1907,1908,21-10-2020 14:50:18.315044,Pollo,Heart & Cooking,13600,5000,18600
1908,1909,21-10-2020 14:50:18.626411,Típica,Sabrosito,39700,4000,43700
1909,1910,21-10-2020 14:50:18.787436,Hamburguesas,Monchis - Hamburguesa,11870,4300,16170
1910,1911,21-10-2020 14:50:18.948501,Parrilla,Arepaisa de Medellín,13000,5600,18600
1911,1912,21-10-2020 14:50:19.059625,Peruana,Uma Cantina Peruana,37900,3200,41100
1912,1913,21-10-2020 14:50:19.271531,Pizza · Parrilla,Urban Lunch,18900,4000,22900
1913,1914,21-10-2020 14:50:19.533678,Saludable · Desayunos,Bawana - Sandwich,23000,3400,26400
1914,1915,21-10-2020 14:50:19.795531,Postres,La Galeta,24300,3000,27300
1915,1916,21-10-2020 14:50:20.057671,Típica,Bendita S,13000,4600,17600
1916,1917,21-10-2020 14:50:20.169332,Típica · Parrilla,El Portal de la Antigua,39700,5600,45300
1917,1918,21-10-2020 14:50:20.331144,Desayunos,Cafetería el Kippe,15000,3200,18200
1918,1919,21-10-2020 14:50:20.593059,Desayunos · Típica,Parrilla Farandula Típico,23000,5900,28900
1919,1920,21-10-2020 14:50:20.805310,Típica,La Olla de Barro,37900,5300,43200
1920,1921,21-10-2020 14:50:21.167092,Sushi · Asiática,Arigato,48750,5300,54050
1921,1922,21-10-2020 14:50:21.529266,Peruana,Masivo,13000,5800,18800
1922,1923,21-10-2020 14:50:21.691976,Saludable,Hanai - Bowls Saludables,53400,5900,59300
1923,1924,21-10-2020 14:50:21.904152,Saludable,A2manos,15000,4200,19200
1924,1925,21-10-2020 14:50:22.166417,Saludable,MIMA,15000,3700,18700
1925,1926,21-10-2020 14:50:22.427655,Postres · Desayunos,Protein Bakes,17800,5900,23700
1926,1927,21-10-2020 14:50:22.790016,Parrilla,OAK Ahumado y Brebajes,31800,6000,37800
1927,1928,21-10-2020 14:50:22.900936,Parrilla,Beraca Parrilla Bbq,39700,5600,45300
1928,1929,21-10-2020 14:50:23.262259,Desayunos · Jugos y Batidos,Dont Be Hungry,11870,5600,17470
1929,1930,21-10-2020 14:50:23.573712,Alta Cocina · Parrilla,Criterión,34500,6000,40500
1930,1931,21-10-2020 14:50:23.684796,Típica,Sabores De Mi Tierra,31800,5400,37200
1931,1932,21-10-2020 14:50:23.896124,Desayunos · Café,Libertario Coffee Roasters,13600,4600,18200
1932,1933,21-10-2020 14:50:24.107540,Saludable,A2manos,8900,4200,13100
1933,1934,21-10-2020 14:50:24.268817,Desayunos · Típica,Fogón Sangileño,48750,5000,53750
1934,1935,21-10-2020 14:50:24.429997,Panadería,Boul,11870,3100,14970
1935,1936,21-10-2020 14:50:24.741403,Típica · Parrilla,Mi Ranchito Parrilla,7500,4400,11900
1936,1937,21-10-2020 14:50:25.052814,Hamburguesas · Saludable,Restaurant Inn,23000,6100,29100
1937,1938,21-10-2020 14:50:25.164014,Desayunos,El Fogón Castellano,9000,3200,12200
1938,1939,21-10-2020 14:50:25.525443,Pizza,18 Scalini,48750,4300,53050
1939,1940,21-10-2020 14:50:25.636467,Parrilla,Restaurante Bar Mi Ranchito,65000,5200,70200
1940,1941,21-10-2020 14:50:25.997984,Parrilla,Beraca Parrilla Bbq,23000,5600,28600
1941,1942,21-10-2020 14:50:26.309386,Saludable · Desayunos,Libre de Culpa,39700,4000,43700
1942,1943,21-10-2020 14:50:26.420473,Desayunos · Jugos y Batidos,Dont Be Hungry,13000,5600,18600
1943,1944,21-10-2020 14:50:26.631768,Típica · Parrilla,La Ternera Parrilla,23000,5200,28200
1944,1945,21-10-2020 14:50:26.944257,Desayunos · Panadería,El Pan de Phillippe,13000,4600,17600
1945,1946,21-10-2020 14:50:27.305668,Postres · Desayunos,La Folie - Postres,11870,3300,15170
1946,1947,21-10-2020 14:50:27.466706,Pescados y Mariscos,Pescadero Héroes del Mar,18900,6600,25500
1947,1948,21-10-2020 14:50:27.777816,Postres · Desayunos,BagBog Bagels,23000,6400,29400
1948,1949,21-10-2020 14:50:28.139083,Típica · Parrilla,El Santandereano,9000,5200,14200
1949,1950,21-10-2020 14:50:28.500410,China,China Food Col,9000,3600,12600
1950,1951,21-10-2020 14:50:28.661737,Desayunos,Sunny Breakfast Brunch,11870,4300,16170
1951,1952,21-10-2020 14:50:28.972847,Saludable · Desayunos,Bawana - Sandwich,13600,3400,17000
1952,1953,21-10-2020 14:50:29.184053,Hamburguesas · Panadería,NYC Burgers,23000,6200,29200
1953,1954,21-10-2020 14:50:29.395260,Mexicana,La leyenda mexican kitchen,10700,3200,13900
1954,1955,21-10-2020 14:50:29.606534,Desayunos · Panadería,Premium Break Bakery,53900,3700,57600
1955,1956,21-10-2020 14:50:29.767708,Parrilla,Coquitas,23000,5600,28600
1956,1957,21-10-2020 14:50:30.078862,Desayunos · Típica,La Frijolada,35000,4500,39500
1957,1958,21-10-2020 14:50:30.340133,Saludable · Desayunos,Bawana - Sandwich,8900,3400,12300
1958,1959,21-10-2020 14:50:30.451226,Pizza,18 Scalini,53900,4300,58200
1959,1960,21-10-2020 14:50:30.712424,Desayunos,Butter,70000,6700,76700
1960,1961,21-10-2020 14:50:30.873632,Sushi · Desayunos,Maki Roll,23000,4300,27300
1961,1962,21-10-2020 14:50:31.084704,Postres · Café,Loló Coffee & Snacks,15000,4600,19600
1962,1963,21-10-2020 14:50:31.396097,Desayunos · Sánduches,Garnish,34500,5200,39700
1963,1964,21-10-2020 14:50:31.507390,Postres · Desayunos,Sharmus,9000,6100,15100
1964,1965,21-10-2020 14:50:31.868843,Pollo · Sánduches,Pollos Century,13000,3000,16000
1965,1966,21-10-2020 14:50:32.031059,Internacional,La Esquina con Sabor Parrilla,17800,3000,20800
1966,1967,21-10-2020 14:50:32.192325,Perros Calientes,Dog Shop - Rapida,15600,4900,20500
1967,1968,21-10-2020 14:50:32.353658,Postres · Desayunos,Jacques Pastelería,37900,5900,43800
1968,1969,21-10-2020 14:50:32.464615,Italiana,Bocatto Di Passo,9000,5000,14000
1969,1970,21-10-2020 14:50:32.726088,Postres · Desayunos,Sweet Tale,17800,5800,23600
1970,1971,21-10-2020 14:50:32.937424,Desayunos · Panadería,Premium Break Bakery,23000,3700,26700
1971,1972,21-10-2020 14:50:33.148673,Pizza · Italiana,Pisapore - Pizza,23000,6600,29600
1972,1973,21-10-2020 14:50:33.510209,Desayunos · Empanadas,Empanadas Doraditas.com,53400,3000,56400
1973,1974,21-10-2020 14:50:33.871918,Desayunos · Café,Matchacha,35000,5900,40900
1974,1975,21-10-2020 14:50:34.083284,Postres · Desayunos,KOKOA & co.,53400,4700,58100
1975,1976,21-10-2020 14:50:34.294608,Típica · Pescados y Mariscos,Arroces Mrg,11870,4300,16170
1976,1977,21-10-2020 14:50:34.605947,Desayunos · Café,vereda central calle 99,35000,5700,40700
1977,1978,21-10-2020 14:50:34.767265,Pizza · Italiana,Pisapore - Pizza,15600,6600,22200
1978,1979,21-10-2020 14:50:34.928523,Saludable · Desayunos,Copacabana Açai Bowls,15000,3000,18000
1979,1980,21-10-2020 14:50:35.139941,Desayunos · Comida Rápida,Chocolatto,24300,3400,27700
1980,1981,21-10-2020 14:50:35.451344,Pizza · Parrilla,Urban Lunch,34500,4000,38500
1981,1982,21-10-2020 14:50:35.612756,Pescados y Mariscos,La Gran Cazuela,23000,3200,26200
1982,1983,21-10-2020 14:50:35.974467,Saludable · Desayunos,Bawana - Sandwich,39700,3400,43100
1983,1984,21-10-2020 14:50:36.285792,Pollo · Sánduches,Pollos Century,70000,3000,73000
1984,1985,21-10-2020 14:50:36.497026,Postres · Desayunos,Maltihelado,7500,4500,12000
1985,1986,21-10-2020 14:50:36.758272,Sushi,Umi,70000,5600,75600
1986,1987,21-10-2020 14:50:36.869497,Postres · Desayunos,Maria Luisa - Postres,23000,4300,27300
1987,1988,21-10-2020 14:50:37.081628,Típica · Parrilla,La Ternera Parrilla,70000,5200,75200
1988,1989,21-10-2020 14:50:37.242912,Postres · Desayunos,Maltihelado,13000,4500,17500
1989,1990,21-10-2020 14:50:37.454290,Postres · Desayunos,Maltihelado,15000,4500,19500
1990,1991,21-10-2020 14:50:37.615506,Peruana,Masivo,15600,5800,21400
1991,1992,21-10-2020 14:50:37.976715,Saludable · Parrilla,Box,10700,3700,14400
1992,1993,21-10-2020 14:50:38.187944,Postres,Beiked,27800,4000,31800
1993,1994,21-10-2020 14:50:38.299205,Desayunos · Comida Rápida,La Veneca,35000,6300,41300
1994,1995,21-10-2020 14:50:38.610740,Hamburguesas,Burger Society,13000,4100,17100
1995,1996,21-10-2020 14:50:38.722042,Postres · Desayunos,Gelateria Da Favola,7500,6500,14000
1996,1997,21-10-2020 14:50:38.883273,Típica,Juan Chorizo,12500,3900,16400
1997,1998,21-10-2020 14:50:39.196711,Desayunos · Café,Libertario Coffee Roasters,8900,4600,13500
1998,1999,21-10-2020 14:50:39.560969,Desayunos · Parrilla,Mi Patria,17800,4600,22400
1999,2000,21-10-2020 14:50:39.822308,Desayunos,Sunny Breakfast Brunch,10700,4300,15000
2000,2001,21-10-2020 14:50:40.183807,Café · Helados,Sofia heladería y café,48750,5800,54550
2001,2002,21-10-2020 14:50:40.545405,Postres · Desayunos,BagBog Bagels,37900,6400,44300
2002,2003,21-10-2020 14:50:40.856663,Pizza · Parrilla,Urban Lunch,34500,4000,38500
2003,2004,21-10-2020 14:50:40.967629,Típica · Pescados y Mariscos,La Vitualla,31800,6300,38100
2004,2005,21-10-2020 14:50:41.228956,Postres · Desayunos,Buñuelos nacho,18900,6600,25500
2005,2006,21-10-2020 14:50:41.390148,Desayunos · Panadería,Ficchi Panadería,7500,3100,10600
2006,2007,21-10-2020 14:50:41.501401,Desayunos,Sr Buñuelo,10700,6400,17100
2007,2008,21-10-2020 14:50:41.612511,Desayunos · Parrilla,Mi Patria,39700,4600,44300
2008,2009,21-10-2020 14:50:41.923888,Típica,Salsig,35000,5600,40600
2009,2010,21-10-2020 14:50:42.086312,Desayunos · Típica,90 Calentados,34500,3700,38200
2010,2011,21-10-2020 14:50:42.447730,Saludable,The Good Rice Bowls,24200,3500,27700
2011,2012,21-10-2020 14:50:42.759221,Crepes,La Chabatta,23000,5900,28900
2012,2013,21-10-2020 14:50:43.120888,Pizza,Pizza Andante,24200,6300,30500
2013,2014,21-10-2020 14:50:43.232047,Postres · Desayunos,BagBog Bagels,18900,6400,25300
2014,2015,21-10-2020 14:50:43.393415,Desayunos · Sánduches,Garnish,13000,5200,18200
2015,2016,21-10-2020 14:50:43.704707,Desayunos · Típica,Desayunadero de la 42,35000,5900,40900
2016,2017,21-10-2020 14:50:44.066101,Desayunos · Panadería,Santa Juana Food Bar,53900,5900,59800
2017,2018,21-10-2020 14:50:44.227381,Pollo · Pescados y Mariscos,Bang Bang Rice,53900,3400,57300
2018,2019,21-10-2020 14:50:44.588765,Saludable · Desayunos,Malú,27800,3700,31500
2019,2020,21-10-2020 14:50:44.850209,Pescados y Mariscos,La Gran Cazuela,13600,3200,16800
2020,2021,21-10-2020 14:50:45.011652,Pizza,Pizza Andante,70000,6300,76300
2021,2022,21-10-2020 14:50:45.323086,Pollo · Pescados y Mariscos,Bang Bang Rice,48750,3400,52150
2022,2023,21-10-2020 14:50:45.434415,Postres,Beiked,24200,4000,28200
2023,2024,21-10-2020 14:50:45.695921,Postres · Desayunos,Sharmus,8900,6100,15000
2024,2025,21-10-2020 14:50:45.857438,Desayunos,Cafetería el Kippe,70000,3200,73200
2025,2026,21-10-2020 14:50:46.068703,Saludable,Puro Verde,15600,5700,21300
2026,2027,21-10-2020 14:50:46.430232,Típica,Carbón & Mondongos,35000,6400,41400
2027,2028,21-10-2020 14:50:46.641808,Desayunos · Típica,Casa Vieja,53900,6000,59900
2028,2029,21-10-2020 14:50:47.003418,Postres · Desayunos,KOKOA & co.,11870,4700,16570
2029,2030,21-10-2020 14:50:47.316065,Sushi,Canoa To Go,24200,5900,30100
2030,2031,21-10-2020 14:50:47.677628,Saludable · Desayunos,Maracuyá,31800,6700,38500
2031,2032,21-10-2020 14:50:47.938975,Saludable · Desayunos,Malú,35000,3700,38700
2032,2033,21-10-2020 14:50:48.050467,Saludable · Típica,Saludable Mrg,31800,5800,37600
2033,2034,21-10-2020 14:50:48.412226,Desayunos · Típica,Peninsula Calentados y Parrilla,7500,3400,10900
2034,2035,21-10-2020 14:50:48.523569,Desayunos · Panadería,Siena Café,27800,3700,31500
2035,2036,21-10-2020 14:50:48.735094,Hamburguesas,Gofi Burger,17800,5100,22900
2036,2037,21-10-2020 14:50:49.046666,Saludable · Desayunos,Guadalupe - Fruteria,37900,5900,43800
2037,2038,21-10-2020 14:50:49.408460,Sushi · Asiática,Arigato,53400,5300,58700
2038,2039,21-10-2020 14:50:49.619889,Desayunos · Típica,Calentao Express,35000,6000,41000
2039,2040,21-10-2020 14:50:49.731095,Pizza · Parrilla,Urban Lunch,23000,4000,27000
2040,2041,21-10-2020 14:50:49.842328,Saludable · Desayunos,Re.al Alimentos Reales,29500,4000,33500
2041,2042,21-10-2020 14:50:50.203877,Típica · Parrilla,La Parilla de David,24200,3100,27300
2042,2043,21-10-2020 14:50:50.315211,Pizza · Italiana,Piatto - Pizza,8900,6600,15500
2043,2044,21-10-2020 14:50:50.476488,Típica,Bendita S,15600,4600,20200
2044,2045,21-10-2020 14:50:50.838139,Desayunos · Sánduches,Garnish,11870,5200,17070
2045,2046,21-10-2020 14:50:51.099651,Parrilla,Antojo a Domicilio,17800,5000,22800
2046,2047,21-10-2020 14:50:51.211150,Saludable · Desayunos,Guadalupe - Fruteria,10700,5900,16600
2047,2048,21-10-2020 14:50:51.322612,Desayunos · Panadería,Limarys,15600,6500,22100
2048,2049,21-10-2020 14:50:51.534042,Típica,Cabrito Santandereano,48750,6600,55350
2049,2050,21-10-2020 14:50:51.795513,Desayunos · Panadería,Ficchi Panadería,12500,3100,15600
2050,2051,21-10-2020 14:50:52.107092,Postres · Desayunos,Jacques Pastelería,24300,5900,30200
2051,2052,21-10-2020 14:50:52.469945,Desayunos · Helados,San Giorgio Gelateria,13600,3100,16700
2052,2053,21-10-2020 14:50:52.681631,Desayunos · Panadería,Decofruta,13600,4700,18300
2053,2054,21-10-2020 14:50:52.792960,Desayunos · Panadería,Ficchi Panadería,70000,3100,73100
2054,2055,21-10-2020 14:50:52.904160,Parrilla,Arroces Maria Paula,24200,6800,31000
2055,2056,21-10-2020 14:50:53.165759,Comida Rápida · Perros Calientes,Similoa - Comida Rapida,23000,3700,26700
2056,2057,21-10-2020 14:50:53.477284,Pollo · Desayunos,Piaf,35000,6500,41500
2057,2058,21-10-2020 14:50:53.738620,Hamburguesas · Alitas,Beer,7500,6600,14100
2058,2059,21-10-2020 14:50:53.950092,Típica,Sabores De Mi Tierra,10700,5400,16100
2059,2060,21-10-2020 14:50:54.061581,Desayunos · Típica,La Parrilla Dorada Polo,48750,6600,55350
2060,2061,21-10-2020 14:50:54.373211,Postres · Desayunos,Vivalight Market.,23000,6500,29500
2061,2062,21-10-2020 14:50:54.734580,Postres · Desayunos,Cosmo Cookies,8900,5900,14800
2062,2063,21-10-2020 14:50:54.845789,Postres · Café,Loló Coffee & Snacks,13000,4600,17600
2063,2064,21-10-2020 14:50:54.957074,Desayunos,Señor Desayuno,12500,6800,19300
2064,2065,21-10-2020 14:50:55.318577,Postres · Desayunos,Maltihelados,29500,6200,35700
2065,2066,21-10-2020 14:50:55.429914,Saludable · Parrilla,The Angels Grill and Drinks,12500,6200,18700
2066,2067,21-10-2020 14:50:55.641584,Desayunos,El Corral - Desayunos,37900,5000,42900
2067,2068,21-10-2020 14:50:55.853116,Pescados y Mariscos,Pescadero Héroes del Mar,13000,6600,19600
2068,2069,21-10-2020 14:50:56.114714,Pizza,pizza andante,48750,4200,52950
2069,2070,21-10-2020 14:50:56.276165,Café · Helados,Sofia heladería y café,35000,5800,40800
2070,2071,21-10-2020 14:50:56.537837,Internacional,Rio Sabores y Experiencias,37900,4100,42000
2071,2072,21-10-2020 14:50:56.849469,Pollo,Heart & Cooking,13000,5000,18000
2072,2073,21-10-2020 14:50:57.211224,Asiática,Thai Station,35000,6000,41000
2073,2074,21-10-2020 14:50:57.574302,Desayunos · Típica,Casa Vieja,31800,6000,37800
2074,2075,21-10-2020 14:50:57.886149,Parrilla,Antojo a Domicilio,8900,5000,13900
2075,2076,21-10-2020 14:50:58.097819,Desayunos · Típica,90 Calentados,13000,3700,16700
2076,2077,21-10-2020 14:50:58.259371,Desayunos · Panadería,Le Pain Quotidien,70000,3900,73900
2077,2078,21-10-2020 14:50:58.621194,Saludable · Desayunos,Libre de Culpa,11870,4000,15870
2078,2079,21-10-2020 14:50:58.882818,Pollo,Señor Fantástico,13000,4700,17700
2079,2080,21-10-2020 14:50:59.244406,Postres · Desayunos,Restaurante Cornelia,24200,5500,29700
2080,2081,21-10-2020 14:50:59.505984,Desayunos · Italiana,Rceta By Rausch,53400,3600,57000
2081,2082,21-10-2020 14:50:59.867612,Desayunos · Sánduches,Danilo Colombia,37900,3300,41200
2082,2083,21-10-2020 14:51:00.129273,Sushi · Asiática,Arigato,24300,5300,29600
2083,2084,21-10-2020 14:51:00.490845,Típica · Parrilla,Typykos,39700,6000,45700
2084,2085,21-10-2020 14:51:00.602343,Desayunos · Café,Matchacha,37900,5900,43800
2085,2086,21-10-2020 14:51:00.863947,Típica,Salsig,18900,5600,24500
2086,2087,21-10-2020 14:51:01.125628,Desayunos · Típica,Cochon,48750,3300,52050
2087,2088,21-10-2020 14:51:01.437249,Mexicana,La leyenda mexican kitchen,15000,3200,18200
2088,2089,21-10-2020 14:51:01.648927,Típica,Bendita S,15000,4600,19600
2089,2090,21-10-2020 14:51:01.960799,Parrilla,Antojo a Domicilio,17800,5000,22800
2090,2091,21-10-2020 14:51:02.322424,Desayunos · Típica,Papadió - Colombianas,13600,5700,19300
2091,2092,21-10-2020 14:51:02.433795,Desayunos · Empanadas,Mis Delicias,10700,3200,13900
2092,2093,21-10-2020 14:51:02.746367,Típica · Parrilla,Typykos,65000,6000,71000
2093,2094,21-10-2020 14:51:02.907920,Típica,Sabores De Mi Tierra,27800,5400,33200
2094,2095,21-10-2020 14:51:03.019437,Desayunos · Helados,San Giorgio Gelateria,34500,3100,37600
2095,2096,21-10-2020 14:51:03.130899,Desayunos,Señor Desayuno,39700,6800,46500
2096,2097,21-10-2020 14:51:03.492704,Parrilla,Carnes la Zarza,53900,4900,58800
2097,2098,21-10-2020 14:51:03.654257,Pizza · Italiana,Pisapore - Pizza,29500,6600,36100
2098,2099,21-10-2020 14:51:03.965912,Sánduches,Submarin,35000,3800,38800
2099,2100,21-10-2020 14:51:04.277623,Desayunos · Sánduches,Garnish,39700,5200,44900
2100,2101,21-10-2020 14:51:04.639246,Desayunos · Panadería,El Pan de Phillippe,17800,4600,22400
2101,2102,21-10-2020 14:51:05.001111,Pescados y Mariscos,Pescadero Héroes del Mar,8900,6600,15500
2102,2103,21-10-2020 14:51:05.162857,Típica,Bandejas Mrg,24300,3800,28100
2103,2104,21-10-2020 14:51:05.474354,Parrilla,Carnes la Zarza,15600,4900,20500
2104,2105,21-10-2020 14:51:05.585858,Desayunos · Panadería,Santa Juana Food Bar,31800,5900,37700
2105,2106,21-10-2020 14:51:05.797384,Saludable,The Good Rice Bowls,18900,3500,22400
2106,2107,21-10-2020 14:51:06.109249,Pollo · Desayunos,Caserito Gourmet,23000,6700,29700
2107,2108,21-10-2020 14:51:06.470943,Desayunos · Café,Moramia,24300,4700,29000
2108,2109,21-10-2020 14:51:06.732550,Sánduches · Pescados y Mariscos,Pacific Comida de Mar,35000,4000,39000
2109,2110,21-10-2020 14:51:06.994184,Sánduches · China,Peru Mix,27800,5900,33700
2110,2111,21-10-2020 14:51:07.305881,Italiana,F*cking Good Pizza,35000,4200,39200
2111,2112,21-10-2020 14:51:07.667568,Típica · Parrilla,Parrilla Farandula Gourmet,48750,5100,53850
2112,2113,21-10-2020 14:51:07.930620,Saludable · Desayunos,Malú,17800,3700,21500
2113,2114,21-10-2020 14:51:08.042211,Crepes,San Crepes,35000,4900,39900
2114,2115,21-10-2020 14:51:08.203955,Saludable · Desayunos,Re.al Alimentos Reales,35000,4000,39000
2115,2116,21-10-2020 14:51:08.315568,Pollo · Sánduches,Pollos Century,12500,3000,15500
2116,2117,21-10-2020 14:51:08.527282,Desayunos · Café,Moramia,12500,4700,17200
2117,2118,21-10-2020 14:51:08.739071,Desayunos · Panadería,Premium Break Bakery,53400,3700,57100
2118,2119,21-10-2020 14:51:08.850539,Típica,Lo Nuestro,65000,3100,68100
2119,2120,21-10-2020 14:51:09.012080,Saludable · Desayunos,Malú,8900,3700,12600
2120,2121,21-10-2020 14:51:09.273690,Hamburguesas · Desayunos,El Inglés Gastro Pub,9000,6600,15600
2121,2122,21-10-2020 14:51:09.535282,Desayunos · Panadería,Decofruta,53900,4700,58600
2122,2123,21-10-2020 14:51:09.847083,Desayunos · Panadería,Le Pain Quotidien,53900,3900,57800
2123,2124,21-10-2020 14:51:10.008633,Desayunos,Desayunos en Bogotá,39700,3400,43100
2124,2125,21-10-2020 14:51:10.170222,Postres · Desayunos,Aury Postres - Comidas & Picadas,11870,4700,16570
2125,2126,21-10-2020 14:51:10.481989,Desayunos,Sr Buñuelo,15000,6400,21400
2126,2127,21-10-2020 14:51:10.693719,Desayunos,Cafetería el Kippe,70000,3200,73200
2127,2128,21-10-2020 14:51:11.055508,Desayunos,Bagel Shop,17800,3200,21000
2128,2129,21-10-2020 14:51:11.317084,Pollo · Sánduches,Pollos Century,15000,3000,18000
2129,2130,21-10-2020 14:51:11.528574,Desayunos · Típica,Casa Vieja,15000,6000,21000
2130,2131,21-10-2020 14:51:11.640093,Desayunos · Típica,La Parrilla Dorada Polo,9000,6600,15600
2131,2132,21-10-2020 14:51:11.951886,Desayunos,Jacinta Arepas de Huevo,13600,4000,17600
2132,2133,21-10-2020 14:51:12.163518,Desayunos,Don Leo,37900,6000,43900
2133,2134,21-10-2020 14:51:12.525423,Internacional,Rio Sabores y Experiencias,17800,4100,21900
2134,2135,21-10-2020 14:51:12.787044,Desayunos · Típica,Criollomania,35000,5200,40200
2135,2136,21-10-2020 14:51:13.149894,Típica,La Olla de Barro,7500,5300,12800
2136,2137,21-10-2020 14:51:13.511772,Pollo · Desayunos,Caserito Gourmet,29500,6700,36200
2137,2138,21-10-2020 14:51:13.823531,Desayunos · Internacional,Camilia,23000,3900,26900
2138,2139,21-10-2020 14:51:13.935085,Pescados y Mariscos,La Gran Cazuela,34500,3200,37700
2139,2140,21-10-2020 14:51:14.246945,Desayunos · Panadería,Santa Juana Food Bar,24200,5900,30100
2140,2141,21-10-2020 14:51:14.558784,Sushi · Desayunos,Maki Roll,13600,4300,17900
2141,2142,21-10-2020 14:51:14.770571,Típica · Parrilla,Typykos,53900,6000,59900
2142,2143,21-10-2020 14:51:15.082510,Desayunos · Típica,Rojo Gourmet,13000,4700,17700
2143,2144,21-10-2020 14:51:15.344164,Pollo · Desayunos,Caserito Gourmet,24300,6700,31000
2144,2145,21-10-2020 14:51:15.555740,Típica · Parrilla,La Ternera Parrilla,23000,5200,28200
2145,2146,21-10-2020 14:51:15.817355,Postres,Beiked,7500,4000,11500
2146,2147,21-10-2020 14:51:16.029027,Hamburguesas,Gofi Burger,24300,5100,29400
2147,2148,21-10-2020 14:51:16.390892,Típica,Juan Chorizo,34500,3900,38400
2148,2149,21-10-2020 14:51:16.502394,Desayunos · Panadería,Choclofee,53400,4700,58100
2149,2150,21-10-2020 14:51:16.714140,Desayunos · Típica,D'Porco - Lechona,11870,6300,18170
2150,2151,21-10-2020 14:51:17.025936,Postres,La Galeta,70000,3000,73000
2151,2152,21-10-2020 14:51:17.187664,Desayunos,Butter,35000,6700,41700
2152,2153,21-10-2020 14:51:17.449484,Parrilla,Rústico Picadería,23000,3800,26800
2153,2154,21-10-2020 14:51:17.811266,Alta Cocina · Italiana,Trattoria de la Plaza,7500,6000,13500
2154,2155,21-10-2020 14:51:17.922884,Saludable · Típica,Sopas Mrg,9000,3100,12100
2155,2156,21-10-2020 14:51:18.034372,Desayunos · Panadería,Limarys,23000,6500,29500
2156,2157,21-10-2020 14:51:18.247084,Sánduches · Pescados y Mariscos,Pacific Comida de Mar,39700,4000,43700
2157,2158,21-10-2020 14:51:18.458897,Típica,El Mondongo y Mucho Mas,23000,5600,28600
2158,2159,21-10-2020 14:51:18.720708,Pollo · Saludable,Tremenda Sal y Dulce,29500,6500,36000
2159,2160,21-10-2020 14:51:19.032466,Parrilla,Carnes la Zarza,15600,4900,20500
2160,2161,21-10-2020 14:51:19.294162,Parrilla,Parrilla Pimentón,9000,3400,12400
2161,2162,21-10-2020 14:51:19.505852,Desayunos,El Corral - Desayunos,70000,5000,75000
2162,2163,21-10-2020 14:51:19.667521,Desayunos · Panadería,El Pan de Phillippe,35000,4600,39600
2163,2164,21-10-2020 14:51:19.779037,Pollo,Oliva Va,48750,5600,54350
2164,2165,21-10-2020 14:51:20.040760,Jugos y Batidos,Pomponio,53400,3600,57000
2165,2166,21-10-2020 14:51:20.352464,Desayunos · Café,Frambas,18900,3400,22300
2166,2167,21-10-2020 14:51:20.514314,Desayunos · Típica,La Parrilla Dorada Polo,37900,6600,44500
2167,2168,21-10-2020 14:51:20.776141,Mexicana,La leyenda mexican kitchen,37900,3200,41100
2168,2169,21-10-2020 14:51:20.987835,Desayunos,Fratelli - Desayunos,45800,4600,50400
2169,2170,21-10-2020 14:51:21.249628,Italiana,Bocatto Di Passo,45800,5000,50800
2170,2171,21-10-2020 14:51:21.611686,Típica · Parrilla,Parrilla Farandula Gourmet,48750,5100,53850
2171,2172,21-10-2020 14:51:21.973743,Italiana,Bocatto Di Passo,65000,5000,70000
2172,2173,21-10-2020 14:51:22.235452,Pescados y Mariscos,Fish Place - Del Mar,23000,5400,28400
2173,2174,21-10-2020 14:51:22.347095,Mexicana,La leyenda mexican kitchen,35000,3200,38200
2174,2175,21-10-2020 14:51:22.708999,Desayunos,Butter,27800,6700,34500
2175,2176,21-10-2020 14:51:22.970685,Helados,Orso To Go,35000,6800,41800
2176,2177,21-10-2020 14:51:23.333702,Postres,Toledo Pastelería,9000,6800,15800
2177,2178,21-10-2020 14:51:23.445468,Saludable · Desayunos,Maracuyá,10700,6700,17400
2178,2179,21-10-2020 14:51:23.657108,Postres · Desayunos,Cosmo Cookies,13600,5900,19500
2179,2180,21-10-2020 14:51:23.768663,Desayunos · Típica,Desayunadero de la 42,13600,5900,19500
2180,2181,21-10-2020 14:51:24.130814,Desayunos · Típica,Desayunadero de la 42,12500,5900,18400
2181,2182,21-10-2020 14:51:24.242534,Alta Cocina · Parrilla,Criterión,39700,6000,45700
2182,2183,21-10-2020 14:51:24.454373,Saludable · Desayunos,Guadalupe - Fruteria,11870,5900,17770
2183,2184,21-10-2020 14:51:24.565990,Saludable · Desayunos,Raices Bienestar Gourmet,37900,6600,44500
2184,2185,21-10-2020 14:51:24.777773,Postres · Helados,Mahé,15000,6000,21000
2185,2186,21-10-2020 14:51:24.939480,Desayunos · Panadería,Choclofee,29500,4700,34200
2186,2187,21-10-2020 14:51:25.301400,Desayunos · Panadería,Choclofee,53900,4700,58600
2187,2188,21-10-2020 14:51:25.413013,Peruana · Internacional,La Chifería,17800,6600,24400
2188,2189,21-10-2020 14:51:25.774960,Desayunos · Internacional,Camilia,53400,3900,57300
2189,2190,21-10-2020 14:51:26.136920,Alta Cocina · Postres,La Pinta,18900,4500,23400
2190,2191,21-10-2020 14:51:26.498908,Desayunos,El Corral - Desayunos,35000,5000,40000
2191,2192,21-10-2020 14:51:26.860908,Típica · Parrilla,La Ternera Parrilla,34500,5200,39700
2192,2193,21-10-2020 14:51:27.022665,Desayunos · Sánduches,Danilo Colombia,31800,3300,35100
2193,2194,21-10-2020 14:51:27.234483,Postres · Desayunos,Sweet Tale,24200,5800,30000
2194,2195,21-10-2020 14:51:27.496210,Italiana,F*cking Good Pizza,39700,4200,43900
2195,2196,21-10-2020 14:51:27.858161,Desayunos · Típica,90 Calentados,23000,3700,26700
2196,2197,21-10-2020 14:51:28.119948,Sushi · Asiática,Arigato,70000,5300,75300
2197,2198,21-10-2020 14:51:28.231604,Desayunos · Panadería,Ficchi Panadería,11870,3100,14970
2198,2199,21-10-2020 14:51:28.394392,Sushi · Desayunos,Maki Roll,65000,4300,69300
2199,2200,21-10-2020 14:51:28.506160,Desayunos,Butter,9000,6700,15700
2200,2201,21-10-2020 14:51:28.667924,Desayunos · Pescados y Mariscos,Gypsy Bistro,15000,4500,19500
2201,2202,21-10-2020 14:51:29.029932,Postres · Café,Celestino Café,45800,5900,51700
2202,2203,21-10-2020 14:51:29.241698,Típica,La Cocina,31800,4600,36400
2203,2204,21-10-2020 14:51:29.353282,Desayunos · Panadería,Choclofee,31800,4700,36500
2204,2205,21-10-2020 14:51:29.665046,Postres · Desayunos,Protein Bakes,17800,5900,23700
2205,2206,21-10-2020 14:51:29.876614,Alta Cocina · Italiana,Trattoria de la Plaza,37900,6000,43900
2206,2207,21-10-2020 14:51:29.988391,Postres · Desayunos,BagBog Bagels,15000,6400,21400
2207,2208,21-10-2020 14:51:30.100232,Postres,La Galeta,15600,3000,18600
2208,2209,21-10-2020 14:51:30.262143,Peruana,Masivo,23000,5800,28800
2209,2210,21-10-2020 14:51:30.373835,Desayunos · Café,Aromacafé el Placer de Compartir,23000,5000,28000
2210,2211,21-10-2020 14:51:30.735787,Postres · Desayunos,Café Quindio,48750,5700,54450
2211,2212,21-10-2020 14:51:31.098071,Desayunos · Típica,Parrilla Farandula Típico,35000,5900,40900
2212,2213,21-10-2020 14:51:31.310173,Parrilla · Internacional,Taperia de la Plaza,17800,5700,23500
2213,2214,21-10-2020 14:51:31.522047,Desayunos · Sánduches,Frutos del Bosque,12500,3500,16000
2214,2215,21-10-2020 14:51:31.783943,Italiana,Bocatto Di Passo,15600,5000,20600
2215,2216,21-10-2020 14:51:32.095852,Saludable · Desayunos,Guadalupe - Fruteria,17800,5900,23700
2216,2217,21-10-2020 14:51:32.257991,Peruana,Masivo,23000,5800,28800
2217,2218,21-10-2020 14:51:32.369768,Hamburguesas,Burger Society,65000,4100,69100
2218,2219,21-10-2020 14:51:32.531643,Desayunos · Panadería,Artesanos,45800,4300,50100
2219,2220,21-10-2020 14:51:32.793730,Desayunos · Pescados y Mariscos,Gypsy Bistro,18900,4500,23400
2220,2221,21-10-2020 14:51:33.055534,Hamburguesas · Alitas,Beer,24200,6600,30800
2221,2222,21-10-2020 14:51:33.367721,Saludable,Ventura Soup y Salad,29500,3800,33300
2222,2223,21-10-2020 14:51:33.530902,Típica · Pescados y Mariscos,La Vitualla,53400,6300,59700
2223,2224,21-10-2020 14:51:33.893530,Pollo · Desayunos,Caserito Gourmet,39700,6700,46400
2224,2225,21-10-2020 14:51:34.105482,Desayunos · Panadería,El Pan de Phillippe,39700,4600,44300
2225,2226,21-10-2020 14:51:34.367553,Perros Calientes,Dog Shop - Rapida,37900,4900,42800
2226,2227,21-10-2020 14:51:34.729741,Desayunos · Típica,Calentao Express,27800,6000,33800
2227,2228,21-10-2020 14:51:34.841471,Postres · Saludable,Ana Rebana,17800,6300,24100
2228,2229,21-10-2020 14:51:35.203540,Postres · Panadería,RIGHT AWAY FOODS,8900,6600,15500
2229,2230,21-10-2020 14:51:35.515637,Típica · Parrilla,Toya,34500,4200,38700
2230,2231,21-10-2020 14:51:35.777731,Saludable · Desayunos,Copacabana Açai Bowls,65000,3000,68000
2231,2232,21-10-2020 14:51:35.939588,Asiática,TeT,37900,5900,43800
2232,2233,21-10-2020 14:51:36.301937,Parrilla,Rústico Picadería,13600,3800,17400
2233,2234,21-10-2020 14:51:36.413660,Postres · Desayunos,Café Quindio,45800,5700,51500
2234,2235,21-10-2020 14:51:36.575332,Saludable,MIMA,70000,3700,73700
2235,2236,21-10-2020 14:51:36.787215,Desayunos · Típica,Fogón Sangileño,23000,5000,28000
2236,2237,21-10-2020 14:51:36.899039,Comida Rápida,Fiesta Digital Andrés,12500,3100,15600
2237,2238,21-10-2020 14:51:37.010864,Pollo · Sánduches,Pollos Century,24300,3000,27300
2238,2239,21-10-2020 14:51:37.372979,Saludable · Desayunos,Bawana - Sandwich,18900,3400,22300
2239,2240,21-10-2020 14:51:37.585035,Desayunos · Mexicana,La Mera Mera - Mexicana,13000,3100,16100
2240,2241,21-10-2020 14:51:37.746905,Postres · Desayunos,La Folie - Postres,9000,3300,12300
2241,2242,21-10-2020 14:51:38.109107,Pollo,Heart & Cooking,24200,5000,29200
2242,2243,21-10-2020 14:51:38.220983,Saludable · Desayunos,Bawana - Sandwich,39700,3400,43100
2243,2244,21-10-2020 14:51:38.383404,Postres · Desayunos,Jacques Pastelería,53900,5900,59800
2244,2245,21-10-2020 14:51:38.495545,Parrilla,Rústico Picadería,34500,3800,38300
2245,2246,21-10-2020 14:51:38.808747,Desayunos · Sánduches,Frutos del Bosque,39700,3500,43200
2246,2247,21-10-2020 14:51:39.071040,Sánduches · Pescados y Mariscos,Pacific Comida de Mar,31800,4000,35800
2247,2248,21-10-2020 14:51:39.433060,Típica · Parrilla,Toya,23000,4200,27200
2248,2249,21-10-2020 14:51:39.745154,Saludable · Parrilla,The Angels Grill and Drinks,15000,6200,21200
2249,2250,21-10-2020 14:51:40.007224,Pollo · Saludable,Yerbabuena,7500,3900,11400
2250,2251,21-10-2020 14:51:40.369424,Típica,El Cucharón - Tipica,39700,4400,44100
2251,2252,21-10-2020 14:51:40.531335,Desayunos · Panadería,Pasteleite,18900,5900,24800
2252,2253,21-10-2020 14:51:40.743395,Desayunos · Pescados y Mariscos,Gypsy Bistro,15000,4500,19500
2253,2254,21-10-2020 14:51:41.055445,Alta Cocina · Postres,La Pinta,11870,4500,16370
2254,2255,21-10-2020 14:51:41.167247,Desayunos · Café,vereda central calle 99,23000,5700,28700
2255,2256,21-10-2020 14:51:41.479300,Saludable,Amor Propio saludable,11870,4000,15870
2256,2257,21-10-2020 14:51:41.591206,Desayunos · Panadería,Decofruta,15600,4700,20300
2257,2258,21-10-2020 14:51:41.703127,Postres · Panadería,RIGHT AWAY FOODS,12500,6600,19100
2258,2259,21-10-2020 14:51:41.965072,Desayunos · Típica,Casa Vieja,13600,6000,19600
2259,2260,21-10-2020 14:51:42.126877,Típica,Sabores De Mi Tierra,37900,5400,43300
2260,2261,21-10-2020 14:51:42.338785,Parrilla · Internacional,Taperia de la Plaza,37900,5700,43600
2261,2262,21-10-2020 14:51:42.650846,Desayunos,Sunny Breakfast Brunch,13600,4300,17900
2262,2263,21-10-2020 14:51:42.912785,Saludable,The Good Rice Bowls,15000,3500,18500
2263,2264,21-10-2020 14:51:43.074609,Pollo · Desayunos,Workzone,29500,3100,32600
2264,2265,21-10-2020 14:51:43.386606,Pescados y Mariscos,Pescadero Héroes del Mar,39700,6600,46300
2265,2266,21-10-2020 14:51:43.748771,Postres · Desayunos,Protein Bakes,23000,5900,28900
2266,2267,21-10-2020 14:51:44.062253,Típica,Sabrosito,13000,4000,17000
2267,2268,21-10-2020 14:51:44.274161,Típica,Cabrito Santandereano,11870,6600,18470
2268,2269,21-10-2020 14:51:44.536445,Saludable,The Good Rice Bowls,48750,3500,52250
2269,2270,21-10-2020 14:51:44.748631,Desayunos · Café,Matchacha,65000,5900,70900
2270,2271,21-10-2020 14:51:44.910658,Parrilla · Café,Figaro Café/ Restaurante Argentino,23000,5800,28800
2271,2272,21-10-2020 14:51:45.072552,Desayunos · Comida Rápida,La Veneca,15600,6300,21900
2272,2273,21-10-2020 14:51:45.435103,Poke,Poke Go,13600,4600,18200
2273,2274,21-10-2020 14:51:45.547163,Saludable · Desayunos,Re.al Alimentos Reales,27800,4000,31800
2274,2275,21-10-2020 14:51:45.709269,Postres · Desayunos,KOKOA & co.,11870,4700,16570
2275,2276,21-10-2020 14:51:46.021690,Peruana,Masivo,18900,5800,24700
2276,2277,21-10-2020 14:51:46.233897,Helados,Buon Gelato,23000,4400,27400
2277,2278,21-10-2020 14:51:46.446007,Jugos y Batidos,Pomponio,24300,3600,27900
2278,2279,21-10-2020 14:51:46.808193,Típica,Cazuelitas 93,35000,3900,38900
2279,2280,21-10-2020 14:51:47.170551,Jugos y Batidos,Pomponio,24300,3600,27900
2280,2281,21-10-2020 14:51:47.532778,Desayunos · Pescados y Mariscos,Luzí­a - Mediterranea,15600,5700,21300
2281,2282,21-10-2020 14:51:47.694808,Pollo · Saludable,Gratina,23000,4200,27200
2282,2283,21-10-2020 14:51:47.906999,Desayunos · Italiana,Rceta By Rausch,15000,3600,18600
2283,2284,21-10-2020 14:51:48.069160,Saludable · Desayunos,Básico y Elemental,45800,5900,51700
2284,2285,21-10-2020 14:51:48.431271,Postres,Beiked,45800,4000,49800
2285,2286,21-10-2020 14:51:48.793527,Desayunos · Panadería,El Pan de Phillippe,37900,4600,42500
2286,2287,21-10-2020 14:51:48.955471,Hamburguesas,Monchis - Hamburguesa,7500,4300,11800
2287,2288,21-10-2020 14:51:49.268747,Saludable,The Good Rice Bowls,53900,3500,57400
2288,2289,21-10-2020 14:51:49.480978,Saludable · Parrilla,The Angels Grill and Drinks,35000,6200,41200
2289,2290,21-10-2020 14:51:49.592924,Helados,Orso To Go,35000,6800,41800
2290,2291,21-10-2020 14:51:49.755019,Café · Helados,Sofia heladería y café,31800,5800,37600
2291,2292,21-10-2020 14:51:49.967246,Saludable · Desayunos,Fresh Co,48750,5600,54350
2292,2293,21-10-2020 14:51:50.079235,Desayunos,Sunny Breakfast Brunch,29500,4300,33800
2293,2294,21-10-2020 14:51:50.441530,Postres · Desayunos,Vivalight Market.,24300,6500,30800
2294,2295,21-10-2020 14:51:50.553287,Desayunos · Típica,Fogón Sangileño,13600,5000,18600
2295,2296,21-10-2020 14:51:50.715283,Hamburguesas,Bendito Cordero,27800,5800,33600
2296,2297,21-10-2020 14:51:51.077348,Pescados y Mariscos,Pescadero Héroes del Mar,34500,6600,41100
2297,2298,21-10-2020 14:51:51.239281,Postres,Levelma,70000,6200,76200
2298,2299,21-10-2020 14:51:51.601686,Típica · Pescados y Mariscos,La Vitualla,23000,6300,29300
2299,2300,21-10-2020 14:51:51.713664,Comida Rápida · Perros Calientes,Similoa - Comida Rapida,27800,3700,31500
2300,2301,21-10-2020 14:51:52.025944,Desayunos · Típica,Papadió - Colombianas,23000,5700,28700
2301,2302,21-10-2020 14:51:52.288080,Pescados y Mariscos,Fish Place - Del Mar,53400,5400,58800
2302,2303,21-10-2020 14:51:52.650484,Desayunos · Panadería,Premium Break Bakery,39700,3700,43400
2303,2304,21-10-2020 14:51:52.762471,Saludable · Desayunos,Bawana - Sandwich,15000,3400,18400
2304,2305,21-10-2020 14:51:52.874564,Desayunos · Árabe,Boniato Sabores Vivos,24200,5300,29500
2305,2306,21-10-2020 14:51:53.236786,Desayunos · Típica,La Frijolada,37900,4500,42400
2306,2307,21-10-2020 14:51:53.548936,Postres · Desayunos,Maltihelado,18900,4500,23400
2307,2308,21-10-2020 14:51:53.761469,Postres · Desayunos,Café Quindio,13000,5700,18700
2308,2309,21-10-2020 14:51:53.973470,Desayunos · Jugos y Batidos,Dont Be Hungry,10700,5600,16300
2309,2310,21-10-2020 14:51:54.185516,Saludable · Desayunos,Copacabana Açai Bowls,9000,3000,12000
2310,2311,21-10-2020 14:51:54.498504,Desayunos,Jacinta Arepas de Huevo,15600,4000,19600
2311,2312,21-10-2020 14:51:54.610558,Parrilla,Carnes la Zarza,17800,4900,22700
2312,2313,21-10-2020 14:51:54.872760,Desayunos · Internacional,Camilia,13000,3900,16900
2313,2314,21-10-2020 14:51:55.134909,Desayunos · Típica,Alce,10700,4900,15600
2314,2315,21-10-2020 14:51:55.497288,Sushi,Umi,12500,5600,18100
2315,2316,21-10-2020 14:51:55.759406,Parrilla,Rústico Picadería,15000,3800,18800
2316,2317,21-10-2020 14:51:55.921456,Desayunos · Típica,Fogón Sangileño,65000,5000,70000
2317,2318,21-10-2020 14:51:56.183401,Desayunos · Comida Rápida,Chocolatto,31800,3400,35200
2318,2319,21-10-2020 14:51:56.395479,Típica · Parrilla,La Ternera Parrilla,53900,5200,59100
2319,2320,21-10-2020 14:51:56.557760,Típica,Bendita S,65000,4600,69600
2320,2321,21-10-2020 14:51:56.770093,Pollo · Desayunos,Workzone,17800,3100,20900
2321,2322,21-10-2020 14:51:57.082635,Mexicana,La leyenda mexican kitchen,24200,3200,27400
2322,2323,21-10-2020 14:51:57.294925,Jugos y Batidos,Pomponio,45800,3600,49400
2323,2324,21-10-2020 14:51:57.457287,Parrilla,Arepaisa de Medellín,8900,5600,14500
2324,2325,21-10-2020 14:51:57.569267,Desayunos,Sr Buñuelo,11870,6400,18270
2325,2326,21-10-2020 14:51:57.781447,Típica,Baondish,35000,5800,40800
2326,2327,21-10-2020 14:51:58.093705,Desayunos · Típica,La Frijolada,53400,4500,57900
2327,2328,21-10-2020 14:51:58.256083,Desayunos · Típica,Rojo Gourmet,39700,4700,44400
2328,2329,21-10-2020 14:51:58.568704,Saludable · Desayunos,Libre de Culpa,39700,4000,43700
2329,2330,21-10-2020 14:51:58.931084,Desayunos,Sr Buñuelo,13600,6400,20000
2330,2331,21-10-2020 14:51:59.093531,Típica,La Cocina,18900,4600,23500
2331,2332,21-10-2020 14:51:59.355622,Saludable · Desayunos,La Estampilla,17800,6000,23800
2332,2333,21-10-2020 14:51:59.569337,Hamburguesas · Panadería,NYC Burgers,53900,6200,60100
2333,2334,21-10-2020 14:51:59.881959,Pizza,Pastas Laurentina,29500,4800,34300
2334,2335,21-10-2020 14:52:00.144199,Desayunos · Café,El Gualilo,53900,6200,60100
2335,2336,21-10-2020 14:52:00.356517,Desayunos · Panadería,Choclofee,39700,4700,44400
2336,2337,21-10-2020 14:52:00.518848,Postres · Desayunos,Aury Postres - Comidas & Picadas,17800,4700,22500
2337,2338,21-10-2020 14:52:00.881640,Desayunos,Sr Buñuelo,15600,6400,22000
2338,2339,21-10-2020 14:52:01.143981,Desayunos,Cafetería el Kippe,10700,3200,13900
2339,2340,21-10-2020 14:52:01.456634,Sánduches · China,Peru Mix,9000,5900,14900
2340,2341,21-10-2020 14:52:01.819515,Saludable · Desayunos,Bawana - Sandwich,24200,3400,27600
2341,2342,21-10-2020 14:52:02.182303,Típica · Pescados y Mariscos,La Vitualla,24200,6300,30500
2342,2343,21-10-2020 14:52:02.494701,Pescados y Mariscos,Pescadero Héroes del Mar,11870,6600,18470
2343,2344,21-10-2020 14:52:02.807061,Hamburguesas · Saludable,Restaurant Inn,70000,6100,76100
2344,2345,21-10-2020 14:52:03.169362,Desayunos,Sr Buñuelo,37900,6400,44300
2345,2346,21-10-2020 14:52:03.381568,Desayunos,Sunny Breakfast Brunch,12500,4300,16800
2346,2347,21-10-2020 14:52:03.593684,Típica,Cazuelitas 93,70000,3900,73900
2347,2348,21-10-2020 14:52:03.806039,Postres,Levelma,53900,6200,60100
2348,2349,21-10-2020 14:52:04.168604,Postres · Desayunos,Vivalight Market.,53900,6500,60400
2349,2350,21-10-2020 14:52:04.280836,Desayunos · Internacional,Camilia,15600,3900,19500
2350,2351,21-10-2020 14:52:04.392975,Alta Cocina · Parrilla,Criterión,37900,6000,43900
2351,2352,21-10-2020 14:52:04.706687,Postres · Desayunos,KOKOA & co.,53900,4700,58600
2352,2353,21-10-2020 14:52:04.969174,Saludable · Desayunos,Raices Bienestar Gourmet,35000,6600,41600
2353,2354,21-10-2020 14:52:05.281568,Pizza,pizza andante,31800,4200,36000
2354,2355,21-10-2020 14:52:05.443777,Saludable · Desayunos,Maracuyá,18900,6700,25600
2355,2356,21-10-2020 14:52:05.555931,Desayunos,El Corral - Desayunos,34500,5000,39500
2356,2357,21-10-2020 14:52:05.718194,Desayunos · Típica,D´Porco,31800,3900,35700
2357,2358,21-10-2020 14:52:05.981387,Desayunos,Cafetería el Kippe,35000,3200,38200
2358,2359,21-10-2020 14:52:06.193651,Típica,Salsig,35000,5600,40600
2359,2360,21-10-2020 14:52:06.505988,Pollo,Chicken House,34500,4200,38700
2360,2361,21-10-2020 14:52:06.818591,Postres · Desayunos,Buñuelos nacho,29500,6600,36100
2361,2362,21-10-2020 14:52:07.030868,Hamburguesas · Pescados y Mariscos,El Velero,24300,6500,30800
2362,2363,21-10-2020 14:52:07.293027,Postres · Desayunos,Café Quindio,10700,5700,16400
2363,2364,21-10-2020 14:52:07.655286,Desayunos,Señor Desayuno,23000,6800,29800
2364,2365,21-10-2020 14:52:08.017706,Postres · Desayunos,Vivalight Market.,24300,6500,30800
2365,2366,21-10-2020 14:52:08.129754,Mexicana,Mexicanachos,45800,3900,49700
2366,2367,21-10-2020 14:52:08.492238,Desayunos · Café,Aromacafé el Placer de Compartir,9000,5000,14000
2367,2368,21-10-2020 14:52:08.754858,Parrilla,Antojo a Domicilio,53900,5000,58900
2368,2369,21-10-2020 14:52:09.067551,Postres,Beiked,12500,4000,16500
2369,2370,21-10-2020 14:52:09.280084,Pollo · Sánduches,Pollos Century,24200,3000,27200
2370,2371,21-10-2020 14:52:09.642827,Típica · Parrilla,La Parilla de David,9000,3100,12100
2371,2372,21-10-2020 14:52:09.806339,Saludable · Desayunos,Guadalupe - Fruteria,34500,5900,40400
2372,2373,21-10-2020 14:52:10.018985,Típica,Bandejas Mrg,23000,3800,26800
2373,2374,21-10-2020 14:52:10.331536,Desayunos,Fratelli - Desayunos,11870,4600,16470
2374,2375,21-10-2020 14:52:10.544253,Típica · Parrilla,Typykos,11870,6000,17870
2375,2376,21-10-2020 14:52:10.906979,Postres · Desayunos,BagBog Bagels,34500,6400,40900
2376,2377,21-10-2020 14:52:11.169741,Helados,Buon Gelato,24300,4400,28700
2377,2378,21-10-2020 14:52:11.383132,Postres · Café,Celestino Café,23000,5900,28900
2378,2379,21-10-2020 14:52:11.595607,Pizza · Italiana,Piatto - Pizza,23000,6600,29600
2379,2380,21-10-2020 14:52:11.958009,Desayunos,Bagel Shop,23000,3200,26200
2380,2381,21-10-2020 14:52:12.070140,Hamburguesas · Alitas,Beer,24200,6600,30800
2381,2382,21-10-2020 14:52:12.432516,Postres · Desayunos,Aury Postres - Comidas & Picadas,35000,4700,39700
2382,2383,21-10-2020 14:52:12.644836,Desayunos · Jugos y Batidos,Kuriwaji,35000,6300,41300
2383,2384,21-10-2020 14:52:12.957259,Desayunos · Sánduches,Frutos del Bosque,8900,3500,12400
2384,2385,21-10-2020 14:52:13.169636,Típica · Pescados y Mariscos,La Vitualla,31800,6300,38100
2385,2386,21-10-2020 14:52:13.331597,Desayunos · Café,Libertario Coffee Roasters,53400,4600,58000
2386,2387,21-10-2020 14:52:13.543982,Pollo · Desayunos,Workzone,11870,3100,14970
2387,2388,21-10-2020 14:52:13.756207,Saludable · Desayunos,Distrito Gourmet,12500,3700,16200
2388,2389,21-10-2020 14:52:13.918343,Saludable,Ventura Soup y Salad,13000,3800,16800
2389,2390,21-10-2020 14:52:14.230762,Desayunos · Italiana,Rceta By Rausch,35000,3600,38600
2390,2391,21-10-2020 14:52:14.543173,Típica · Pescados y Mariscos,Arroces Mrg,27800,4300,32100
2391,2392,21-10-2020 14:52:14.755386,Alta Cocina · Parrilla,Criterión,31800,6000,37800
2392,2393,21-10-2020 14:52:14.868733,Pizza,Pastas Laurentina,24200,4800,29000
2393,2394,21-10-2020 14:52:15.231370,Desayunos · Café,Libertario Coffee Roasters,12500,4600,17100
2394,2395,21-10-2020 14:52:15.493782,Desayunos · Café,Matchacha,37900,5900,43800
2395,2396,21-10-2020 14:52:15.856198,Desayunos · Pescados y Mariscos,Gypsy Bistro,35000,4500,39500
2396,2397,21-10-2020 14:52:16.068528,Pizza · Parrilla,Urban Lunch,70000,4000,74000
2397,2398,21-10-2020 14:52:16.280728,Desayunos · Panadería,Premium Break Bakery,70000,3700,73700
2398,2399,21-10-2020 14:52:16.543035,Típica,Sopitas y Más,24300,4200,28500
2399,2400,21-10-2020 14:52:16.655232,Hamburguesas · Panadería,NYC Burgers,37900,6200,44100
2400,2401,21-10-2020 14:52:16.967734,Pollo · Desayunos,Piaf,23000,6500,29500
2401,2402,21-10-2020 14:52:17.280144,Desayunos · Típica,Parrilla Farandula Típico,35000,5900,40900
2402,2403,21-10-2020 14:52:17.442649,Desayunos · Café,Frambas,9000,3400,12400
2403,2404,21-10-2020 14:52:17.655050,Desayunos · Típica,La Frijolada,27800,4500,32300
2404,2405,21-10-2020 14:52:18.017656,Saludable,Puro Verde,11870,5700,17570
2405,2406,21-10-2020 14:52:18.229808,Desayunos · Café,Norma's Ice Cream Café,35000,6300,41300
2406,2407,21-10-2020 14:52:18.341947,Típica,Sopitas y Más,7500,4200,11700
2407,2408,21-10-2020 14:52:18.504132,Saludable,MIMA,11870,3700,15570
2408,2409,21-10-2020 14:52:18.766579,Saludable · Desayunos,Re.al Alimentos Reales,13600,4000,17600
2409,2410,21-10-2020 14:52:18.928827,Desayunos · Panadería,Artesanos,8900,4300,13200
2410,2411,21-10-2020 14:52:19.241451,Saludable · Desayunos,Libre de Culpa,18900,4000,22900
2411,2412,21-10-2020 14:52:19.403813,Desayunos · Típica,La Frijolada,24300,4500,28800
2412,2413,21-10-2020 14:52:19.566213,Sánduches · China,Peru Mix,13600,5900,19500
2413,2414,21-10-2020 14:52:19.678439,Desayunos · Panadería,Decofruta,8900,4700,13600
2414,2415,21-10-2020 14:52:19.992015,Postres · Desayunos,KOKOA & co.,13000,4700,17700
2415,2416,21-10-2020 14:52:20.154476,Típica,Bandejas Mrg,17800,3800,21600
2416,2417,21-10-2020 14:52:20.516983,Saludable · Desayunos,La Estampilla,24300,6000,30300
2417,2418,21-10-2020 14:52:20.629326,Desayunos · Café,Libertario Coffee Roasters,23000,4600,27600
2418,2419,21-10-2020 14:52:20.891586,Saludable · Desayunos,Libre de Culpa,29500,4000,33500
2419,2420,21-10-2020 14:52:21.054006,Postres · Desayunos,Vivalight Market.,53400,6500,59900
2420,2421,21-10-2020 14:52:21.416450,Típica,Campo Victoria,45800,3000,48800
2421,2422,21-10-2020 14:52:21.578850,Desayunos,Butter,12500,6700,19200
2422,2423,21-10-2020 14:52:21.891231,Poke,Poke Go,13000,4600,17600
2423,2424,21-10-2020 14:52:22.253926,Pescados y Mariscos,La Gran Cazuela,10700,3200,13900
2424,2425,21-10-2020 14:52:22.366216,Parrilla,Arepaisa de Medellín,24200,5600,29800
2425,2426,21-10-2020 14:52:22.628632,Parrilla,Rústico Picadería,13600,3800,17400
2426,2427,21-10-2020 14:52:22.740728,Saludable · Desayunos,Libre de Culpa,17800,4000,21800
2427,2428,21-10-2020 14:52:23.003158,Típica · Parrilla,Parrilla Farandula Gourmet,10700,5100,15800
2428,2429,21-10-2020 14:52:23.165736,Saludable,A2manos,11870,4200,16070
2429,2430,21-10-2020 14:52:23.428137,Internacional,Rio Sabores y Experiencias,24200,4100,28300
2430,2431,21-10-2020 14:52:23.690859,Hamburguesas,Bendito Cordero,70000,5800,75800
2431,2432,21-10-2020 14:52:23.803212,Desayunos · Café,Norma's Ice Cream Café,37900,6300,44200
2432,2433,21-10-2020 14:52:23.915633,Sushi,Umi,11870,5600,17470
2433,2434,21-10-2020 14:52:24.278357,Sushi,Kim Pop,17800,5400,23200
2434,2435,21-10-2020 14:52:24.590917,Parrilla,OAK Ahumado y Brebajes,27800,6000,33800
2435,2436,21-10-2020 14:52:24.953639,Saludable,Puro Verde,34500,5700,40200
2436,2437,21-10-2020 14:52:25.165986,Postres · Desayunos,Aury Postres - Comidas & Picadas,13600,4700,18300
2437,2438,21-10-2020 14:52:25.428483,Pizza,Pastas Laurentina,11870,4800,16670
2438,2439,21-10-2020 14:52:25.590883,Pollo · China,China Tao,48750,3500,52250
2439,2440,21-10-2020 14:52:25.903573,Pollo · Desayunos,Candelina,35000,5300,40300
2440,2441,21-10-2020 14:52:26.166076,Desayunos,El Corral - Desayunos,15600,5000,20600
2441,2442,21-10-2020 14:52:26.428577,Desayunos · Italiana,Rceta By Rausch,35000,3600,38600
2442,2443,21-10-2020 14:52:26.791210,Hamburguesas · Desayunos,El Inglés Gastro Pub,53900,6600,60500
2443,2444,21-10-2020 14:52:26.953622,Típica · Parrilla,Typykos,35000,6000,41000
2444,2445,21-10-2020 14:52:27.166149,Asiática,Thai Station,34500,6000,40500
2445,2446,21-10-2020 14:52:27.429076,Parrilla,Carnes la Zarza,7500,4900,12400
2446,2447,21-10-2020 14:52:27.741737,Típica · Parrilla,El Santandereano,37900,5200,43100
2447,2448,21-10-2020 14:52:28.104351,Sánduches · China,Peru Mix,13600,5900,19500
2448,2449,21-10-2020 14:52:28.467105,Italiana,F*cking Good Pizza,17800,4200,22000
2449,2450,21-10-2020 14:52:28.629540,Típica,Cabrito Santandereano,29500,6600,36100
2450,2451,21-10-2020 14:52:28.741789,Saludable · Jugos y Batidos,Berdes Drinks & Salads,27800,3500,31300
2451,2452,21-10-2020 14:52:28.954141,Helados,Orso To Go,24200,6800,31000
2452,2453,21-10-2020 14:52:29.316741,Parrilla,Rústico Picadería,10700,3800,14500
2453,2454,21-10-2020 14:52:29.529253,Comida Rápida · Perros Calientes,Similoa - Comida Rapida,11870,3700,15570
2454,2455,21-10-2020 14:52:29.741646,Típica,Bendita S,31800,4600,36400
2455,2456,21-10-2020 14:52:30.104054,Típica,Bandejas Mrg,48750,3800,52550
2456,2457,21-10-2020 14:52:30.417697,Saludable · Desayunos,Distrito Gourmet,35000,3700,38700
2457,2458,21-10-2020 14:52:30.580035,Sushi · Asiática,Arigato,13600,5300,18900
2458,2459,21-10-2020 14:52:30.842644,Desayunos · Típica,Criollomania,7500,5200,12700
2459,2460,21-10-2020 14:52:31.205266,Pollo · Desayunos,Candelina,15000,5300,20300
2460,2461,21-10-2020 14:52:31.417554,Desayunos · Típica,Peninsula Calentados y Parrilla,24300,3400,27700
2461,2462,21-10-2020 14:52:31.680262,Peruana,Masivo,13600,5800,19400
2462,2463,21-10-2020 14:52:31.942801,Saludable · Típica,Saludable Mrg,65000,5800,70800
2463,2464,21-10-2020 14:52:32.155339,Sushi,Umi,29500,5600,35100
2464,2465,21-10-2020 14:52:32.518030,Típica,La Herencia,12500,5900,18400
2465,2466,21-10-2020 14:52:32.830590,Saludable · Parrilla,The Angels Grill and Drinks,18900,6200,25100
2466,2467,21-10-2020 14:52:33.092953,Hamburguesas,Bendito Cordero,35000,5800,40800
2467,2468,21-10-2020 14:52:33.205414,Postres,Beiked,10700,4000,14700
2468,2469,21-10-2020 14:52:33.567931,Desayunos,El Corral - Desayunos,11870,5000,16870
2469,2470,21-10-2020 14:52:33.930566,Crepes,San Crepes,18900,4900,23800
2470,2471,21-10-2020 14:52:34.042945,Desayunos · Típica,Cochon,29500,3300,32800
2471,2472,21-10-2020 14:52:34.355512,Típica,Cazuelitas 93,7500,3900,11400
2472,2473,21-10-2020 14:52:34.718155,Parrilla,Restaurante Bar Mi Ranchito,15000,5200,20200
2473,2474,21-10-2020 14:52:34.980612,Desayunos · Parrilla,Mi Patria,9000,4600,13600
2474,2475,21-10-2020 14:52:35.193222,Café · Helados,Sofia heladería y café,37900,5800,43700
2475,2476,21-10-2020 14:52:35.405917,Postres · Desayunos,Restaurante Cornelia,18900,5500,24400
2476,2477,21-10-2020 14:52:35.719812,Desayunos · Café,Frambas,8900,3400,12300
2477,2478,21-10-2020 14:52:35.982432,Hamburguesas · Saludable,Restaurant Inn,65000,6100,71100
2478,2479,21-10-2020 14:52:36.345063,Pollo,Oliva Va,11870,5600,17470
2479,2480,21-10-2020 14:52:36.657625,Desayunos,Sunny Breakfast Brunch,7500,4300,11800
2480,2481,21-10-2020 14:52:36.869912,Pollo · Sánduches,Pollos Century,17800,3000,20800
2481,2482,21-10-2020 14:52:37.182516,Parrilla,Restaurante Bar Mi Ranchito,15000,5200,20200
2482,2483,21-10-2020 14:52:37.395067,Desayunos · Típica,Fogón Sangileño,35000,5000,40000
2483,2484,21-10-2020 14:52:37.557693,Mexicana,La leyenda mexican kitchen,15600,3200,18800
2484,2485,21-10-2020 14:52:37.770241,Postres,La Tertulia,65000,3400,68400
2485,2486,21-10-2020 14:52:37.932647,Desayunos · Sánduches,Frutos del Bosque,24300,3500,27800
2486,2487,21-10-2020 14:52:38.245414,Sushi,Canoa To Go,27800,5900,33700
2487,2488,21-10-2020 14:52:38.507832,Desayunos · Típica,La Frijolada,23000,4500,27500
2488,2489,21-10-2020 14:52:38.820569,Parrilla,OAK Ahumado y Brebajes,23000,6000,29000
2489,2490,21-10-2020 14:52:39.133294,Hamburguesas · Saludable,Restaurant Inn,10700,6100,16800
2490,2491,21-10-2020 14:52:39.495989,Desayunos · Típica,La Parrilla Dorada Polo,31800,6600,38400
2491,2492,21-10-2020 14:52:39.708513,Típica,Bandejas Mrg,9000,3800,12800
2492,2493,21-10-2020 14:52:39.870963,Pollo · Pescados y Mariscos,Bang Bang Rice,8900,3400,12300
2493,2494,21-10-2020 14:52:40.133633,Saludable · Desayunos,Copacabana Açai Bowls,35000,3000,38000
2494,2495,21-10-2020 14:52:40.296043,Sushi,Canoa To Go,48750,5900,54650
2495,2496,21-10-2020 14:52:40.658949,Desayunos,Señor Desayuno,23000,6800,29800
2496,2497,21-10-2020 14:52:40.872886,Desayunos,La Frijolada Desayunos,13600,4400,18000
2497,2498,21-10-2020 14:52:41.035537,Internacional,Rio Sabores y Experiencias,24200,4100,28300
2498,2499,21-10-2020 14:52:41.348412,Saludable · Típica,Saludable Mrg,12500,5800,18300
2499,2500,21-10-2020 14:52:41.561054,Desayunos · Típica,Peninsula Calentados y Parrilla,53900,3400,57300
2500,2501,21-10-2020 14:52:41.673574,Saludable · Parrilla,Box,35000,3700,38700
2501,2502,21-10-2020 14:52:41.986523,Desayunos · Típica,Alce,11870,4900,16770
2502,2503,21-10-2020 14:52:42.099227,Parrilla,Beraca Parrilla Bbq,11870,5600,17470
2503,2504,21-10-2020 14:52:42.462191,Pollo · Sánduches,Pollos Century,8900,3000,11900
2504,2505,21-10-2020 14:52:42.574749,Típica · Parrilla,Mi Ranchito Parrilla,7500,4400,11900
2505,2506,21-10-2020 14:52:42.787446,Pollo · Desayunos,Piaf,10700,6500,17200
2506,2507,21-10-2020 14:52:42.899929,Café · Helados,Sofia heladería y café,34500,5800,40300
2507,2508,21-10-2020 14:52:43.162602,Desayunos · Panadería,Premium Break Bakery,12500,3700,16200
2508,2509,21-10-2020 14:52:43.475338,Postres,Beiked,53900,4000,57900
2509,2510,21-10-2020 14:52:43.738007,Postres · Helados,Mahé,53900,6000,59900
2510,2511,21-10-2020 14:52:43.900479,Desayunos · Mexicana,La Mera Mera - Mexicana,10700,3100,13800
2511,2512,21-10-2020 14:52:44.113119,Postres,La Galeta,65000,3000,68000
2512,2513,21-10-2020 14:52:44.275706,Italiana,F*cking Good Pizza,34500,4200,38700
2513,2514,21-10-2020 14:52:44.538329,Parrilla,Restaurante Bar Mi Ranchito,29500,5200,34700
2514,2515,21-10-2020 14:52:44.650961,Típica,La Olla de Barro,13000,5300,18300
2515,2516,21-10-2020 14:52:44.863511,Típica,Salsig,18900,5600,24500
2516,2517,21-10-2020 14:52:45.226320,Desayunos · Panadería,Pasteleite,12500,5900,18400
2517,2518,21-10-2020 14:52:45.539108,Postres · Desayunos,Maltihelado,37900,4500,42400
2518,2519,21-10-2020 14:52:45.851925,Desayunos · Panadería,Ficchi Panadería,53900,3100,57000
2519,2520,21-10-2020 14:52:46.114779,Desayunos · Internacional,Camilia,13000,3900,16900
2520,2521,21-10-2020 14:52:46.227429,Desayunos · Empanadas,Mis Delicias,12500,3200,15700
2521,2522,21-10-2020 14:52:46.540284,Alta Cocina · Parrilla,Criterión,65000,6000,71000
2522,2523,21-10-2020 14:52:46.853179,Parrilla,El Tambor,17800,6800,24600
2523,2524,21-10-2020 14:52:47.066028,Postres · Saludable,Ana Rebana,13000,6300,19300
2524,2525,21-10-2020 14:52:47.278731,Típica,La Olla de Barro,34500,5300,39800
2525,2526,21-10-2020 14:52:47.441373,Pollo · Saludable,Gratina,9000,4200,13200
2526,2527,21-10-2020 14:52:47.804317,Típica · Parrilla,El Santandereano,45800,5200,51000
2527,2528,21-10-2020 14:52:48.117444,Desayunos · Panadería,Le Pain Quotidien,11870,3900,15770
2528,2529,21-10-2020 14:52:48.430144,Pescados y Mariscos,Pescadero Héroes del Mar,12500,6600,19100
2529,2530,21-10-2020 14:52:48.792904,Típica,Campo Victoria,35000,3000,38000
2530,2531,21-10-2020 14:52:49.105680,Saludable · Desayunos,La Cesta,31800,4700,36500
2531,2532,21-10-2020 14:52:49.218428,Desayunos · Panadería,Juliana Restaurante,13000,6100,19100
2532,2533,21-10-2020 14:52:49.431243,Saludable · Desayunos,Básico y elemental,23000,5000,28000
2533,2534,21-10-2020 14:52:49.744050,Saludable · Desayunos,Raices Bienestar Gourmet,23000,6600,29600
2534,2535,21-10-2020 14:52:49.906688,Desayunos · Pescados y Mariscos,Gypsy Bistro,24200,4500,28700
2535,2536,21-10-2020 14:52:50.019165,Asiática,Thai Station,13000,6000,19000
2536,2537,21-10-2020 14:52:50.382324,Saludable · Desayunos,La Cesta,48750,4700,53450
2537,2538,21-10-2020 14:52:50.745254,Parrilla,OAK Ahumado y Brebajes,17800,6000,23800
2538,2539,21-10-2020 14:52:50.857788,Típica · Parrilla,Typykos,24200,6000,30200
2539,2540,21-10-2020 14:52:51.020401,Postres · Desayunos,BagBog Bagels,12500,6400,18900
2540,2541,21-10-2020 14:52:51.384635,Típica,Campo Victoria,70000,3000,73000
2541,2542,21-10-2020 14:52:51.747641,Mexicana,Hidalgo Taquería,39700,4900,44600
2542,2543,21-10-2020 14:52:51.960379,Hamburguesas · Saludable,Restaurant Inn,15000,6100,21100
2543,2544,21-10-2020 14:52:52.173012,Típica · Pescados y Mariscos,Arroces Mrg,48750,4300,53050
2544,2545,21-10-2020 14:52:52.285489,Típica,Baondish,35000,5800,40800
2545,2546,21-10-2020 14:52:52.548135,Internacional,La Esquina con Sabor Parrilla,39700,3000,42700
2546,2547,21-10-2020 14:52:52.711133,Saludable,Hanai - Bowls Saludables,27800,5900,33700
2547,2548,21-10-2020 14:52:53.023989,Hamburguesas,Gofi Burger,10700,5100,15800
2548,2549,21-10-2020 14:52:53.186856,Pescados y Mariscos,Fish Place - Del Mar,15600,5400,21000
2549,2550,21-10-2020 14:52:53.299466,Italiana,Bocatto Di Passo,7500,5000,12500
2550,2551,21-10-2020 14:52:53.512086,Saludable · Desayunos,Malú,29500,3700,33200
2551,2552,21-10-2020 14:52:53.724880,Saludable,MIMA,15600,3700,19300
2552,2553,21-10-2020 14:52:53.837411,Parrilla,Antojo a Domicilio,24200,5000,29200
2553,2554,21-10-2020 14:52:54.200355,Desayunos · Típica,Rojo Gourmet,29500,4700,34200
2554,2555,21-10-2020 14:52:54.463188,Desayunos · Típica,Desayunadero de la 42,7500,5900,13400
2555,2556,21-10-2020 14:52:54.575794,Hamburguesas · Alitas,Beer,39700,6600,46300
2556,2557,21-10-2020 14:52:54.888769,Saludable,Hanai - Bowls Saludables,48750,5900,54650
2557,2558,21-10-2020 14:52:55.201651,Desayunos · Típica,La Frijolada,15000,4500,19500
2558,2559,21-10-2020 14:52:55.464362,Sushi · Asiática,Arigato,29500,5300,34800
2559,2560,21-10-2020 14:52:55.777266,Desayunos · Panadería,Siena Café,37900,3700,41600
2560,2561,21-10-2020 14:52:56.089954,Parrilla,Arepaisa de Medellín,53900,5600,59500
2561,2562,21-10-2020 14:52:56.202588,Peruana,Masivo,70000,5800,75800
2562,2563,21-10-2020 14:52:56.315263,Postres · Desayunos,BagBog Bagels,10700,6400,17100
2563,2564,21-10-2020 14:52:56.630304,Postres · Desayunos,Cosmo Cookies,34500,5900,40400
2564,2565,21-10-2020 14:52:56.793240,Desayunos · Típica,Alce,29500,4900,34400
2565,2566,21-10-2020 14:52:57.055940,Parrilla · Café,Gaira Café,70000,4400,74400
2566,2567,21-10-2020 14:52:57.218842,Hamburguesas,Gofi Burger,39700,5100,44800
2567,2568,21-10-2020 14:52:57.531801,Desayunos,Cafetería el Kippe,34500,3200,37700
2568,2569,21-10-2020 14:52:57.794652,Desayunos · Café,Libertario Coffee Roasters,10700,4600,15300
2569,2570,21-10-2020 14:52:58.007305,Hamburguesas · Alitas,Beer,17800,6600,24400
2570,2571,21-10-2020 14:52:58.120115,Pollo · Saludable,Gratina,11870,4200,16070
2571,2572,21-10-2020 14:52:58.232967,Desayunos · Panadería,Limarys,24200,6500,30700
2572,2573,21-10-2020 14:52:58.445819,Comida Rápida · Perros Calientes,Similoa - Comida Rapida,48750,3700,52450
2573,2574,21-10-2020 14:52:58.608507,Desayunos · Café,Aromacafé el Placer de Compartir,24200,5000,29200
2574,2575,21-10-2020 14:52:58.871659,Desayunos · Típica,Alce,37900,4900,42800
2575,2576,21-10-2020 14:52:59.084530,Típica,Bendita S,15600,4600,20200
2576,2577,21-10-2020 14:52:59.247395,Desayunos · Empanadas,Empanadas Doraditas.com,23000,3000,26000
2577,2578,21-10-2020 14:52:59.460523,Desayunos · Típica,Peninsula Calentados y Parrilla,13600,3400,17000
2578,2579,21-10-2020 14:52:59.773550,Hamburguesas,Burger Society,13600,4100,17700
2579,2580,21-10-2020 14:53:00.136537,Típica · Parrilla,La Parilla de David,37900,3100,41000
2580,2581,21-10-2020 14:53:00.449664,Postres · Desayunos,Aury Postres - Comidas & Picadas,53900,4700,58600
2581,2582,21-10-2020 14:53:00.762600,Postres,Toledo Pastelería,34500,6800,41300
2582,2583,21-10-2020 14:53:00.875492,Desayunos · Típica,Cochon,35000,3300,38300
2583,2584,21-10-2020 14:53:01.238456,Desayunos · Café,vereda central calle 99,23000,5700,28700
2584,2585,21-10-2020 14:53:01.351345,Parrilla,Restaurante Bar Mi Ranchito,18900,5200,24100
2585,2586,21-10-2020 14:53:01.715781,Saludable,Ventura Soup y Salad,23000,3800,26800
2586,2587,21-10-2020 14:53:01.878947,Desayunos · Helados,San Giorgio Gelateria,12500,3100,15600
2587,2588,21-10-2020 14:53:02.091964,Desayunos,Archies Desayunos,35000,3100,38100
2588,2589,21-10-2020 14:53:02.455301,Típica,Sopitas y Más,53900,4200,58100
2589,2590,21-10-2020 14:53:02.618425,Pollo · Desayunos,Piaf,11870,6500,18370
2590,2591,21-10-2020 14:53:02.881507,Desayunos,Desayunos en Bogotá,53400,3400,56800
2591,2592,21-10-2020 14:53:03.044187,Postres · Desayunos,Aury Postres - Comidas & Picadas,15600,4700,20300
2592,2593,21-10-2020 14:53:03.307012,Desayunos · Panadería,Santa Juana Food Bar,70000,5900,75900
2593,2594,21-10-2020 14:53:03.670073,Desayunos · Panadería,Limarys,34500,6500,41000
2594,2595,21-10-2020 14:53:03.982996,Sushi,Sushi Reel,13000,4700,17700
2595,2596,21-10-2020 14:53:04.196022,Parrilla,Arroces Maria Paula,13600,6800,20400
2596,2597,21-10-2020 14:53:04.358818,Desayunos,Sr Buñuelo,35000,6400,41400
2597,2598,21-10-2020 14:53:04.471554,Desayunos · Típica,90 Calentados,24200,3700,27900
2598,2599,21-10-2020 14:53:04.734734,Desayunos · Típica,D'Porco - Lechona,13000,6300,19300
2599,2600,21-10-2020 14:53:05.097962,Peruana,Uma Cantina Peruana,53400,3200,56600
2600,2601,21-10-2020 14:53:05.411176,Comida Rápida · Perros Calientes,Similoa - Comida Rapida,34500,3700,38200
2601,2602,21-10-2020 14:53:05.624159,Internacional,Rio Sabores y Experiencias,53400,4100,57500
2602,2603,21-10-2020 14:53:05.787267,Desayunos · Típica,D´Porco,7500,3900,11400
2603,2604,21-10-2020 14:53:06.000221,Alta Cocina · Italiana,Trattoria de la Plaza,24200,6000,30200
2604,2605,21-10-2020 14:53:06.363208,Crepes,San Crepes,39700,4900,44600
2605,2606,21-10-2020 14:53:06.526156,Desayunos · Café,Aromacafé el Placer de Compartir,31800,5000,36800
2606,2607,21-10-2020 14:53:06.890242,Hamburguesas,Gofi Burger,18900,5100,24000
2607,2608,21-10-2020 14:53:07.203416,Saludable · Desayunos,Maracuyá,10700,6700,17400
2608,2609,21-10-2020 14:53:07.416439,Saludable · Desayunos,La Cesta,24200,4700,28900
2609,2610,21-10-2020 14:53:07.779525,Parrilla,El Tambor,34500,6800,41300
2610,2611,21-10-2020 14:53:08.142876,Café · Helados,Sofia heladería y café,48750,5800,54550
2611,2612,21-10-2020 14:53:08.456174,Típica,Sopitas y Más,11870,4200,16070
2612,2613,21-10-2020 14:53:08.819119,Desayunos · Típica,D´Porco,27800,3900,31700
2613,2614,21-10-2020 14:53:09.132136,Típica · Parrilla,El Portal de la Antigua,65000,5600,70600
2614,2615,21-10-2020 14:53:09.445450,Típica,El Mondongo y Mucho Mas,18900,5600,24500
2615,2616,21-10-2020 14:53:09.758487,Típica,El Mondongo y Mucho Mas,24300,5600,29900
2616,2617,21-10-2020 14:53:10.021457,Postres · Desayunos,Jacques Pastelería,45800,5900,51700
2617,2618,21-10-2020 14:53:10.234271,Típica · Pescados y Mariscos,Arroces Mrg,48750,4300,53050
2618,2619,21-10-2020 14:53:10.397099,Saludable · Desayunos,Bon Eat - Saludable,37900,4800,42700
2619,2620,21-10-2020 14:53:10.760273,Parrilla,Arroces Maria Paula,35000,6800,41800
2620,2621,21-10-2020 14:53:10.923132,Postres · Desayunos,Maria Luisa - Postres,11870,4300,16170
2621,2622,21-10-2020 14:53:11.286176,Hamburguesas · Pescados y Mariscos,El Velero,18900,6500,25400
2622,2623,21-10-2020 14:53:11.499094,Típica · Pescados y Mariscos,La Vitualla,29500,6300,35800
2623,2624,21-10-2020 14:53:11.612074,Típica · Parrilla,Typykos,45800,6000,51800
2624,2625,21-10-2020 14:53:11.825070,Desayunos,Bagel Shop,48750,3200,51950
2625,2626,21-10-2020 14:53:11.939100,Desayunos · Típica,D´Porco,23000,3900,26900
2626,2627,21-10-2020 14:53:12.052186,Típica,Salsig,65000,5600,70600
2627,2628,21-10-2020 14:53:12.415126,Desayunos · Sánduches,Garnish,15000,5200,20200
2628,2629,21-10-2020 14:53:12.778574,Desayunos,Jacinta Arepas de Huevo,34500,4000,38500
2629,2630,21-10-2020 14:53:12.891452,Pollo,Heart & Cooking,34500,5000,39500
2630,2631,21-10-2020 14:53:13.054462,Pollo · Típica,Auyama,35000,3900,38900
2631,2632,21-10-2020 14:53:13.267430,Desayunos · Típica,Peninsula Calentados y Parrilla,53900,3400,57300
2632,2633,21-10-2020 14:53:13.630781,Desayunos · Panadería,Ficchi Panadería,15000,3100,18100
2633,2634,21-10-2020 14:53:13.793666,Pescados y Mariscos,Pescadero Héroes del Mar,65000,6600,71600
2634,2635,21-10-2020 14:53:13.956338,Desayunos,Desayunos en Bogotá,11870,3400,15270
2635,2636,21-10-2020 14:53:14.119442,Pollo,Chicken House,31800,4200,36000
2636,2637,21-10-2020 14:53:14.232357,Saludable · Desayunos,La Estampilla,12500,6000,18500
2637,2638,21-10-2020 14:53:14.445563,Desayunos,Jacinta Arepas de Huevo,13000,4000,17000
2638,2639,21-10-2020 14:53:14.708556,Saludable,A2manos,31800,4200,36000
2639,2640,21-10-2020 14:53:14.821392,Sushi,Kim Pop,27800,5400,33200
2640,2641,21-10-2020 14:53:15.084343,Saludable · Desayunos,La Estampilla,9000,6000,15000
2641,2642,21-10-2020 14:53:15.397440,Postres · Desayunos,Vivalight Market.,15000,6500,21500
2642,2643,21-10-2020 14:53:15.510193,Desayunos · Panadería,Choclofee,35000,4700,39700
2643,2644,21-10-2020 14:53:15.773168,Helados,Orso To Go,8900,6800,15700
2644,2645,21-10-2020 14:53:16.085991,Desayunos · Café,Matchacha,37900,5900,43800
2645,2646,21-10-2020 14:53:16.399073,Hamburguesas · Panadería,NYC Burgers,39700,6200,45900
2646,2647,21-10-2020 14:53:16.762268,Típica · Parrilla,Toya,35000,4200,39200
2647,2648,21-10-2020 14:53:17.125494,Parrilla,OAK Ahumado y Brebajes,35000,6000,41000
2648,2649,21-10-2020 14:53:17.488407,Postres · Saludable,Ana Rebana,65000,6300,71300
2649,2650,21-10-2020 14:53:17.651330,Parrilla,Restaurante Bar Mi Ranchito,37900,5200,43100
2650,2651,21-10-2020 14:53:17.764201,Desayunos · Pescados y Mariscos,Luzí­a - Mediterranea,31800,5700,37500
2651,2652,21-10-2020 14:53:18.027222,Sánduches · China,Peru Mix,8900,5900,14800
2652,2653,21-10-2020 14:53:18.340217,Hamburguesas · Desayunos,El Inglés Gastro Pub,34500,6600,41100
2653,2654,21-10-2020 14:53:18.703280,Pollo,Oliva Va,24300,5600,29900
2654,2655,21-10-2020 14:53:19.016380,Sushi · Asiática,Tu Sushi,11870,6400,18270
2655,2656,21-10-2020 14:53:19.379734,Desayunos · Típica,Alce,11870,4900,16770
2656,2657,21-10-2020 14:53:19.693054,Postres · Panadería,RIGHT AWAY FOODS,9000,6600,15600
2657,2658,21-10-2020 14:53:19.956064,Típica · Pescados y Mariscos,La Vitualla,12500,6300,18800
2658,2659,21-10-2020 14:53:20.119014,Pollo · Saludable,Yerbabuena,13600,3900,17500
2659,2660,21-10-2020 14:53:20.282107,Postres,La Tertulia,18900,3400,22300
2660,2661,21-10-2020 14:53:20.445044,Desayunos · Típica,La Frijolada,8900,4500,13400
2661,2662,21-10-2020 14:53:20.758189,Postres · Desayunos,Café Quindio,13600,5700,19300
2662,2663,21-10-2020 14:53:20.921176,Pollo · China,China Tao,8900,3500,12400
2663,2664,21-10-2020 14:53:21.234119,Hamburguesas · Desayunos,El Inglés Gastro Pub,53400,6600,60000
2664,2665,21-10-2020 14:53:21.597430,Típica · Parrilla,Typykos,35000,6000,41000
2665,2666,21-10-2020 14:53:21.710298,Típica,La Olla de Barro,8900,5300,14200
2666,2667,21-10-2020 14:53:22.073545,Desayunos · Típica,Casa Vieja,10700,6000,16700
2667,2668,21-10-2020 14:53:22.337675,Desayunos · Típica,D´Porco,10700,3900,14600
2668,2669,21-10-2020 14:53:22.550822,Desayunos · Panadería,Juliana Restaurante,24300,6100,30400
2669,2670,21-10-2020 14:53:22.713798,Saludable · Típica,Saludable Mrg,35000,5800,40800
2670,2671,21-10-2020 14:53:22.876753,Italiana,F*cking Good Pizza,13600,4200,17800
2671,2672,21-10-2020 14:53:22.989754,Pescados y Mariscos,Pescadero Héroes del Mar,37900,6600,44500
2672,2673,21-10-2020 14:53:23.152667,Saludable,Puro Verde,15600,5700,21300
2673,2674,21-10-2020 14:53:23.365557,Postres · Desayunos,Sweet Tale,70000,5800,75800
2674,2675,21-10-2020 14:53:23.578504,Comida Rápida,Fiesta Digital Andrés,53400,3100,56500
2675,2676,21-10-2020 14:53:23.941757,Saludable · Parrilla,Box,10700,3700,14400
2676,2677,21-10-2020 14:53:24.254908,Pizza · Italiana,Piatto - Pizza,39700,6600,46300
2677,2678,21-10-2020 14:53:24.367831,Postres,Beiked,31800,4000,35800
2678,2679,21-10-2020 14:53:24.580890,Postres,La Tertulia,7500,3400,10900
2679,2680,21-10-2020 14:53:24.793776,Típica,La Herencia,53400,5900,59300
2680,2681,21-10-2020 14:53:25.006736,Postres · Saludable,Ana Rebana,70000,6300,76300
2681,2682,21-10-2020 14:53:25.119728,Típica,Sopitas y Más,17800,4200,22000
2682,2683,21-10-2020 14:53:25.282834,Desayunos · Típica,Casa Vieja,35000,6000,41000
2683,2684,21-10-2020 14:53:25.596118,Pollo · Desayunos,Piaf,53400,6500,59900
2684,2685,21-10-2020 14:53:25.809261,Saludable · Desayunos,Maracuyá,37900,6700,44600
2685,2686,21-10-2020 14:53:26.172368,Típica,El Mondongo y Mucho Mas,45800,5600,51400
2686,2687,21-10-2020 14:53:26.335381,Internacional,La Esquina con Sabor Parrilla,17800,3000,20800
2687,2688,21-10-2020 14:53:26.498354,Pollo,Señor Fantástico,45800,4700,50500
2688,2689,21-10-2020 14:53:26.661569,Desayunos · Panadería,Decofruta,70000,4700,74700
2689,2690,21-10-2020 14:53:26.774445,Pollo · Desayunos,Abasto,23000,3600,26600
2690,2691,21-10-2020 14:53:26.887476,Desayunos · Sánduches,Danilo Colombia,9000,3300,12300
2691,2692,21-10-2020 14:53:27.250595,Parrilla,Coquitas,23000,5600,28600
2692,2693,21-10-2020 14:53:27.615051,Postres · Desayunos,Sweet Tale,24300,5800,30100
2693,2694,21-10-2020 14:53:27.728109,Parrilla,OAK Ahumado y Brebajes,45800,6000,51800
2694,2695,21-10-2020 14:53:27.840996,Postres · Desayunos,Café Quindio,37900,5700,43600
2695,2696,21-10-2020 14:53:28.204235,Peruana,Uma Cantina Peruana,34500,3200,37700
2696,2697,21-10-2020 14:53:28.567441,Sushi,Umi,13600,5600,19200
2697,2698,21-10-2020 14:53:28.680388,Saludable · Desayunos,La Estampilla,31800,6000,37800
2698,2699,21-10-2020 14:53:28.893572,Desayunos · Típica,Casa Vieja,17800,6000,23800
2699,2700,21-10-2020 14:53:29.156510,Pizza,Pizza Andante,27800,6300,34100
2700,2701,21-10-2020 14:53:29.319600,Desayunos · Panadería,Limarys,24200,6500,30700
2701,2702,21-10-2020 14:53:29.682985,Saludable · Desayunos,Maracuyá,39700,6700,46400
2702,2703,21-10-2020 14:53:29.846183,Saludable · Desayunos,Re.al Alimentos Reales,34500,4000,38500
2703,2704,21-10-2020 14:53:30.059371,Desayunos,Sunny Breakfast Brunch,53400,4300,57700
2704,2705,21-10-2020 14:53:30.222549,Saludable · Parrilla,Box,8900,3700,12600
2705,2706,21-10-2020 14:53:30.585923,Típica,Carbón & Mondongos,24300,6400,30700
2706,2707,21-10-2020 14:53:30.699088,Desayunos · Típica,Alce,9000,4900,13900
2707,2708,21-10-2020 14:53:30.812235,Pizza,18 Scalini,65000,4300,69300
2708,2709,21-10-2020 14:53:31.125559,Postres,Beiked,35000,4000,39000
2709,2710,21-10-2020 14:53:31.288615,Pollo · Saludable,Tremenda Sal y Dulce,8900,6500,15400
2710,2711,21-10-2020 14:53:31.451666,Alta Cocina · Italiana,Trattoria de la Plaza,24300,6000,30300
2711,2712,21-10-2020 14:53:31.614806,Sánduches · Pescados y Mariscos,Pacific Comida de Mar,23000,4000,27000
2712,2713,21-10-2020 14:53:31.928056,Parrilla,El Tambor,70000,6800,76800
2713,2714,21-10-2020 14:53:32.041299,Saludable · Parrilla,The Angels Grill and Drinks,15600,6200,21800
2714,2715,21-10-2020 14:53:32.354517,Peruana,Uma Cantina Peruana,13600,3200,16800
2715,2716,21-10-2020 14:53:32.467611,Pollo · Desayunos,Workzone,18900,3100,22000
2716,2717,21-10-2020 14:53:32.632109,Desayunos · Pescados y Mariscos,Gypsy Bistro,24300,4500,28800
2717,2718,21-10-2020 14:53:32.945669,Saludable · Desayunos,Libre de Culpa,23000,4000,27000
2718,2719,21-10-2020 14:53:33.209199,Pollo · Saludable,Gratina,9000,4200,13200
2719,2720,21-10-2020 14:53:33.572600,Sushi,Kim Pop,45800,5400,51200
2720,2721,21-10-2020 14:53:33.835748,Desayunos,Sunny Breakfast Brunch,53400,4300,57700
2721,2722,21-10-2020 14:53:33.949030,Desayunos,La Frijolada Desayunos,34500,4400,38900
2722,2723,21-10-2020 14:53:34.262356,Típica,Sabrosito,37900,4000,41900
2723,2724,21-10-2020 14:53:34.425412,Pollo · Desayunos,Candelina,39700,5300,45000
2724,2725,21-10-2020 14:53:34.538659,Alta Cocina · Parrilla,Criterión,65000,6000,71000
2725,2726,21-10-2020 14:53:34.751946,Postres,Beiked,39700,4000,43700
2726,2727,21-10-2020 14:53:35.115393,Desayunos · Panadería,Ficchi Panadería,29500,3100,32600
2727,2728,21-10-2020 14:53:35.278701,Peruana,Uma Cantina Peruana,29500,3200,32700
2728,2729,21-10-2020 14:53:35.592061,Típica,Sabores De Mi Tierra,34500,5400,39900
2729,2730,21-10-2020 14:53:35.905435,Parrilla,Restaurante Bar Mi Ranchito,31800,5200,37000
2730,2731,21-10-2020 14:53:36.018357,Comida Rápida,Fiesta Digital Andrés,48750,3100,51850
2731,2732,21-10-2020 14:53:36.231684,Parrilla · Internacional,Taperia de la Plaza,70000,5700,75700
2732,2733,21-10-2020 14:53:36.344783,Desayunos,Fratelli - Desayunos,65000,4600,69600
2733,2734,21-10-2020 14:53:36.508025,Mexicana,La leyenda mexican kitchen,29500,3200,32700
2734,2735,21-10-2020 14:53:36.771579,Pollo · Desayunos,Abasto,70000,3600,73600
2735,2736,21-10-2020 14:53:36.934825,Típica · Pescados y Mariscos,Arroces Mrg,13000,4300,17300
2736,2737,21-10-2020 14:53:37.047905,Desayunos · Parrilla,Mi Patria,53400,4600,58000
2737,2738,21-10-2020 14:53:37.411223,Pizza,18 Scalini,12500,4300,16800
2738,2739,21-10-2020 14:53:37.624578,Desayunos · Panadería,Choclofee,7500,4700,12200
2739,2740,21-10-2020 14:53:37.788842,Típica,La Olla de Barro,23000,5300,28300
2740,2741,21-10-2020 14:53:38.052197,Hamburguesas · Desayunos,El Inglés Gastro Pub,37900,6600,44500
2741,2742,21-10-2020 14:53:38.365511,Saludable · Desayunos,Copacabana Açai Bowls,11870,3000,14870
2742,2743,21-10-2020 14:53:38.578559,Típica,Sabrosito,8900,4000,12900
2743,2744,21-10-2020 14:53:38.691674,Típica,La Olla de Barro,18900,5300,24200
2744,2745,21-10-2020 14:53:38.804802,Desayunos · Sánduches,Danilo Colombia,35000,3300,38300
2745,2746,21-10-2020 14:53:38.917819,Saludable · Típica,Sopas Mrg,18900,3100,22000
2746,2747,21-10-2020 14:53:39.030844,Internacional,Rio Sabores y Experiencias,10700,4100,14800
2747,2748,21-10-2020 14:53:39.294172,Italiana,F*cking Good Pizza,53900,4200,58100
2748,2749,21-10-2020 14:53:39.657712,Parrilla,Restaurante Bar Mi Ranchito,13600,5200,18800
2749,2750,21-10-2020 14:53:39.970988,Desayunos · Italiana,Rceta By Rausch,7500,3600,11100
2750,2751,21-10-2020 14:53:40.084058,Pollo · Sánduches,Pollos Century,35000,3000,38000
2751,2752,21-10-2020 14:53:40.297486,Pizza,pizza andante,23000,4200,27200
2752,2753,21-10-2020 14:53:40.610996,Postres · Desayunos,Amelie Helados,48750,6400,55150
2753,2754,21-10-2020 14:53:40.874306,Desayunos,Butter,31800,6700,38500
2754,2755,21-10-2020 14:53:41.237677,Desayunos · Típica,Calentao Express,48750,6000,54750
2755,2756,21-10-2020 14:53:41.400787,Parrilla,Arroces Maria Paula,53900,6800,60700
2756,2757,21-10-2020 14:53:41.764181,Desayunos · Panadería,Santa Juana Food Bar,34500,5900,40400
2757,2758,21-10-2020 14:53:42.027436,Desayunos · Típica,Criollomania,37900,5200,43100
2758,2759,21-10-2020 14:53:42.140558,Desayunos · Árabe,Boniato Sabores Vivos,15000,5300,20300
2759,2760,21-10-2020 14:53:42.403863,Típica,Cazuelitas 93,70000,3900,73900
2760,2761,21-10-2020 14:53:42.717357,Saludable · Jugos y Batidos,Berdes Drinks & Salads,53900,3500,57400
2761,2762,21-10-2020 14:53:43.081860,Típica,Bandejas Mrg,7500,3800,11300
2762,2763,21-10-2020 14:53:43.245180,Hamburguesas · Desayunos,El Inglés Gastro Pub,48750,6600,55350
2763,2764,21-10-2020 14:53:43.358365,Saludable · Parrilla,The Angels Grill and Drinks,23000,6200,29200
2764,2765,21-10-2020 14:53:43.471651,Típica,Carbón & Mondongos,10700,6400,17100
2765,2766,21-10-2020 14:53:43.635100,Desayunos · Típica,D´Porco,24300,3900,28200
2766,2767,21-10-2020 14:53:43.849208,Postres,La Tertulia,37900,3400,41300
2767,2768,21-10-2020 14:53:43.962542,Postres · Desayunos,La Folie - Postres,15000,3300,18300
2768,2769,21-10-2020 14:53:44.325975,Desayunos · Típica,Casa Vieja,10700,6000,16700
2769,2770,21-10-2020 14:53:44.489062,Pizza,pizza andante,8900,4200,13100
2770,2771,21-10-2020 14:53:44.852438,Típica · Parrilla,La Parilla de David,34500,3100,37600
2771,2772,21-10-2020 14:53:44.965637,Crepes,La Chabatta,31800,5900,37700
2772,2773,21-10-2020 14:53:45.178876,Saludable,Puro Verde,39700,5700,45400
2773,2774,21-10-2020 14:53:45.492249,Postres · Desayunos,La Folie - Postres,45800,3300,49100
2774,2775,21-10-2020 14:53:45.805629,Pizza,18 Scalini,23000,4300,27300
2775,2776,21-10-2020 14:53:45.918660,Saludable · Típica,Sopas Mrg,12500,3100,15600
2776,2777,21-10-2020 14:53:46.031851,Desayunos · Jugos y Batidos,Kuriwaji,48750,6300,55050
2777,2778,21-10-2020 14:53:46.295235,Hamburguesas,Burger Society,9000,4100,13100
2778,2779,21-10-2020 14:53:46.608694,Peruana,Uma Cantina Peruana,15000,3200,18200
2779,2780,21-10-2020 14:53:46.922187,Típica,Sopitas y Más,29500,4200,33700
2780,2781,21-10-2020 14:53:47.235702,Típica,Sabores De Mi Tierra,15600,5400,21000
2781,2782,21-10-2020 14:53:47.599459,Postres · Desayunos,Jacques Pastelería,10700,5900,16600
2782,2783,21-10-2020 14:53:47.762844,Desayunos · Panadería,Limarys,11870,6500,18370
2783,2784,21-10-2020 14:53:47.875958,Parrilla,Campocina,70000,4600,74600
2784,2785,21-10-2020 14:53:48.140431,Jugos y Batidos,Pomponio,13000,3600,16600
2785,2786,21-10-2020 14:53:48.504118,Pescados y Mariscos,La Gran Cazuela,35000,3200,38200
2786,2787,21-10-2020 14:53:48.767478,Postres · Desayunos,La Folie - Postres,15000,3300,18300
2787,2788,21-10-2020 14:53:48.930701,Hamburguesas,Bendito Cordero,12500,5800,18300
2788,2789,21-10-2020 14:53:49.194046,Desayunos,Desayunos en Bogotá,7500,3400,10900
2789,2790,21-10-2020 14:53:49.307293,Desayunos,Sr Buñuelo,65000,6400,71400
2790,2791,21-10-2020 14:53:49.620785,Típica · Parrilla,La Ternera Parrilla,23000,5200,28200
2791,2792,21-10-2020 14:53:49.984334,Desayunos · Parrilla,Mi Patria,27800,4600,32400
2792,2793,21-10-2020 14:53:50.197908,Parrilla,Rústico Picadería,23000,3800,26800
2793,2794,21-10-2020 14:53:50.561637,Sushi,Canoa To Go,31800,5900,37700
2794,2795,21-10-2020 14:53:50.674870,Saludable · Desayunos,La Estampilla,18900,6000,24900
2795,2796,21-10-2020 14:53:50.988357,Desayunos,Archies Desayunos,13000,3100,16100
2796,2797,21-10-2020 14:53:51.151869,Desayunos · Internacional,Camilia,9000,3900,12900
2797,2798,21-10-2020 14:53:51.465345,Pizza · Italiana,Piatto - Pizza,17800,6600,24400
2798,2799,21-10-2020 14:53:51.828683,Crepes,La Chabatta,35000,5900,40900
2799,2800,21-10-2020 14:53:52.142169,Sushi,Canoa To Go,45800,5900,51700
2800,2801,21-10-2020 14:53:52.355646,Parrilla,Parrilla Pimentón,13600,3400,17000
2801,2802,21-10-2020 14:53:52.619113,Postres · Desayunos,Aury Postres - Comidas & Picadas,53900,4700,58600
2802,2803,21-10-2020 14:53:52.982780,Desayunos · Empanadas,Mis Delicias,15600,3200,18800
2803,2804,21-10-2020 14:53:53.297322,Pescados y Mariscos,Pescadero Héroes del Mar,23000,6600,29600
2804,2805,21-10-2020 14:53:53.460993,Pollo,Heart & Cooking,35000,5000,40000
2805,2806,21-10-2020 14:53:53.674463,Parrilla · Café,Figaro Café/ Restaurante Argentino,11870,5800,17670
2806,2807,21-10-2020 14:53:53.937882,Desayunos · Jugos y Batidos,Dont Be Hungry,17800,5600,23400
2807,2808,21-10-2020 14:53:54.101553,Pollo · Saludable,Yerbabuena,53400,3900,57300
2808,2809,21-10-2020 14:53:54.314901,Desayunos · Típica,90 Calentados,31800,3700,35500
2809,2810,21-10-2020 14:53:54.678390,Saludable · Desayunos,Básico y Elemental,11870,5900,17770
2810,2811,21-10-2020 14:53:54.991925,Desayunos · Panadería,El Pan de Phillippe,15600,4600,20200
2811,2812,21-10-2020 14:53:55.305470,Desayunos · Típica,Peninsula Calentados y Parrilla,8900,3400,12300
2812,2813,21-10-2020 14:53:55.568831,Pescados y Mariscos,Fish Place - Del Mar,70000,5400,75400
2813,2814,21-10-2020 14:53:55.782086,Desayunos · Típica,90 Calentados,48750,3700,52450
2814,2815,21-10-2020 14:53:55.945594,Postres · Desayunos,Protein Bakes,18900,5900,24800
2815,2816,21-10-2020 14:53:56.258947,Postres · Café,Loló Coffee & Snacks,37900,4600,42500
2816,2817,21-10-2020 14:53:56.472395,Desayunos · Típica,Alce,15000,4900,19900
2817,2818,21-10-2020 14:53:56.585622,Parrilla,OAK Ahumado y Brebajes,13000,6000,19000
2818,2819,21-10-2020 14:53:56.849033,Típica,Sabores De Mi Tierra,12500,5400,17900
2819,2820,21-10-2020 14:53:57.062406,Pollo · Pescados y Mariscos,Bang Bang Rice,70000,3400,73400
2820,2821,21-10-2020 14:53:57.376056,Desayunos,Don Leo,53900,6000,59900
2821,2822,21-10-2020 14:53:57.740091,Pollo · Desayunos,Piaf,7500,6500,14000
2822,2823,21-10-2020 14:53:58.053913,Desayunos · Típica,Rojo Gourmet,39700,4700,44400
2823,2824,21-10-2020 14:53:58.167415,Sushi,Umi,35000,5600,40600
2824,2825,21-10-2020 14:53:58.431965,Hamburguesas · Saludable,Restaurant Inn,35000,6100,41100
2825,2826,21-10-2020 14:53:58.745685,Sánduches · China,Peru Mix,31800,5900,37700
2826,2827,21-10-2020 14:53:59.009576,Desayunos · Jugos y Batidos,Dont Be Hungry,8900,5600,14500
2827,2828,21-10-2020 14:53:59.223891,Pescados y Mariscos,Pescadero Héroes del Mar,53900,6600,60500
2828,2829,21-10-2020 14:53:59.387940,Saludable,MIMA,17800,3700,21500
2829,2830,21-10-2020 14:53:59.702258,Desayunos · Panadería,Limarys,35000,6500,41500
2830,2831,21-10-2020 14:53:59.866325,Desayunos · Panadería,Decofruta,70000,4700,74700
2831,2832,21-10-2020 14:53:59.980376,Sushi · Desayunos,Maki Roll,23000,4300,27300
2832,2833,21-10-2020 14:54:00.144370,Saludable,Ventura Soup y Salad,12500,3800,16300
2833,2834,21-10-2020 14:54:00.408667,Desayunos · Panadería,Santa Juana Food Bar,27800,5900,33700
2834,2835,21-10-2020 14:54:00.623078,Desayunos · Empanadas,Empanadas Doraditas.com,65000,3000,68000
2835,2836,21-10-2020 14:54:00.736685,Desayunos · Empanadas,Mis Delicias,24300,3200,27500
2836,2837,21-10-2020 14:54:00.850908,Desayunos · Típica,90 Calentados,8900,3700,12600
2837,2838,21-10-2020 14:54:00.964333,Desayunos · Típica,Casa Vieja,13000,6000,19000
2838,2839,21-10-2020 14:54:01.278884,Crepes,San Crepes,45800,4900,50700
2839,2840,21-10-2020 14:54:01.592428,Desayunos · Panadería,Limarys,37900,6500,44400
2840,2841,21-10-2020 14:54:01.807017,Desayunos · Helados,San Giorgio Gelateria,15000,3100,18100
2841,2842,21-10-2020 14:54:02.170865,Pizza,Pizza Andante,17800,6300,24100
2842,2843,21-10-2020 14:54:02.335023,Postres,Toledo Pastelería,24200,6800,31000
2843,2844,21-10-2020 14:54:02.648555,Desayunos,Desayunos en Bogotá,15600,3400,19000
2844,2845,21-10-2020 14:54:02.812774,Típica,Bendita S,23000,4600,27600
2845,2846,21-10-2020 14:54:03.126486,Saludable · Parrilla,Box,45800,3700,49500
2846,2847,21-10-2020 14:54:03.492041,China,China Food Col,17800,3600,21400
2847,2848,21-10-2020 14:54:03.755692,Desayunos · Panadería,Limarys,23000,6500,29500
2848,2849,21-10-2020 14:54:04.019168,Pollo · Desayunos,Workzone,10700,3100,13800
2849,2850,21-10-2020 14:54:04.232784,Desayunos · Panadería,Artesanos,11870,4300,16170
2850,2851,21-10-2020 14:54:04.496408,Internacional,La Esquina con Sabor Parrilla,13600,3000,16600
2851,2852,21-10-2020 14:54:04.609826,Desayunos · Panadería,Choclofee,12500,4700,17200
2852,2853,21-10-2020 14:54:04.823334,Parrilla,Carnes la Zarza,23000,4900,27900
2853,2854,21-10-2020 14:54:04.936709,Desayunos,Bagel Shop,53900,3200,57100
2854,2855,21-10-2020 14:54:05.300507,Jugos y Batidos,Pomponio,12500,3600,16100
2855,2856,21-10-2020 14:54:05.513926,Desayunos · Italiana,Rceta By Rausch,35000,3600,38600
2856,2857,21-10-2020 14:54:05.727660,Pollo · Típica,Auyama,9000,3900,12900
2857,2858,21-10-2020 14:54:05.841053,Saludable · Desayunos,Raices Bienestar Gourmet,31800,6600,38400
2858,2859,21-10-2020 14:54:06.154496,Saludable · Desayunos,Básico y Elemental,48750,5900,54650
2859,2860,21-10-2020 14:54:06.267861,Postres · Desayunos,Aury Postres - Comidas & Picadas,24300,4700,29000
2860,2861,21-10-2020 14:54:06.431430,Típica,Campo Victoria,45800,3000,48800
2861,2862,21-10-2020 14:54:06.745028,Desayunos · Típica,Parrilla Farandula Típico,29500,5900,35400
2862,2863,21-10-2020 14:54:07.008537,Típica,Cazuelitas 93,27800,3900,31700
2863,2864,21-10-2020 14:54:07.222159,Sushi,Umi,37900,5600,43500
2864,2865,21-10-2020 14:54:07.435684,Parrilla,OAK Ahumado y Brebajes,7500,6000,13500
2865,2866,21-10-2020 14:54:07.549182,Postres,Levelma,27800,6200,34000
2866,2867,21-10-2020 14:54:07.812650,Parrilla,Parrilla Pimentón,34500,3400,37900
2867,2868,21-10-2020 14:54:08.076314,Típica · Parrilla,Parrilla Farandula Gourmet,9000,5100,14100
2868,2869,21-10-2020 14:54:08.440149,Desayunos · Típica,Casa Vieja,24300,6000,30300
2869,2870,21-10-2020 14:54:08.705345,Pizza · Italiana,Piatto - Pizza,23000,6600,29600
2870,2871,21-10-2020 14:54:08.868931,Parrilla,Parrilla Pimentón,17800,3400,21200
2871,2872,21-10-2020 14:54:09.132609,Sushi · Desayunos,Maki Roll,53900,4300,58200
2872,2873,21-10-2020 14:54:09.296165,Italiana,Bocatto Di Passo,48750,5000,53750
2873,2874,21-10-2020 14:54:09.409615,Desayunos · Típica,Calentao Express,39700,6000,45700
2874,2875,21-10-2020 14:54:09.572978,Típica,Carbón & Mondongos,8900,6400,15300
2875,2876,21-10-2020 14:54:09.786574,Postres · Desayunos,Jacques Pastelería,15000,5900,20900
2876,2877,21-10-2020 14:54:10.050241,Desayunos · Internacional,Camilia,65000,3900,68900
2877,2878,21-10-2020 14:54:10.214122,Desayunos · Café,vereda central calle 99,13000,5700,18700
2878,2879,21-10-2020 14:54:10.477702,Típica · Parrilla,Mi Ranchito Parrilla,9000,4400,13400
2879,2880,21-10-2020 14:54:10.741443,Parrilla,El Tambor,9000,6800,15800
2880,2881,21-10-2020 14:54:11.055141,Desayunos · Típica,Criollomania,7500,5200,12700
2881,2882,21-10-2020 14:54:11.318701,Típica,Cazuelitas 93,24200,3900,28100
2882,2883,21-10-2020 14:54:11.482256,Sushi · Asiática,Arigato,7500,5300,12800
2883,2884,21-10-2020 14:54:11.846039,Mexicana,La leyenda mexican kitchen,15000,3200,18200
2884,2885,21-10-2020 14:54:11.959640,Poke,Poke Go,11870,4600,16470
2885,2886,21-10-2020 14:54:12.273392,Típica · Parrilla,Toya,37900,4200,42100
2886,2887,21-10-2020 14:54:12.637058,Pescados y Mariscos,La Gran Cazuela,15000,3200,18200
2887,2888,21-10-2020 14:54:12.800626,Saludable · Desayunos,Agua Dulce,45800,3700,49500
2888,2889,21-10-2020 14:54:12.964004,Saludable,Amor Propio saludable,37900,4000,41900
2889,2890,21-10-2020 14:54:13.277704,Pollo · Desayunos,Candelina,53900,5300,59200
2890,2891,21-10-2020 14:54:13.591420,Desayunos · Pescados y Mariscos,Luzí­a - Mediterranea,29500,5700,35200
2891,2892,21-10-2020 14:54:13.956334,Típica,El Mondongo y Mucho Mas,17800,5600,23400
2892,2893,21-10-2020 14:54:14.120005,Sushi,Sushi Reel,35000,4700,39700
2893,2894,21-10-2020 14:54:14.233527,Poke,Poke Go,12500,4600,17100
2894,2895,21-10-2020 14:54:14.447168,Desayunos,Desayunos en Bogotá,48750,3400,52150
2895,2896,21-10-2020 14:54:14.560637,Alta Cocina · Postres,La Pinta,37900,4500,42400
2896,2897,21-10-2020 14:54:14.874367,Pollo · Pescados y Mariscos,Bang Bang Rice,39700,3400,43100
2897,2898,21-10-2020 14:54:15.088009,Desayunos · Café,vereda central calle 99,7500,5700,13200
2898,2899,21-10-2020 14:54:15.201674,Desayunos · Empanadas,Empanadas Doraditas.com,10700,3000,13700
2899,2900,21-10-2020 14:54:15.315114,Saludable · Desayunos,Re.al Alimentos Reales,48750,4000,52750
2900,2901,21-10-2020 14:54:15.578801,Desayunos · Empanadas,Mis Delicias,23000,3200,26200
2901,2902,21-10-2020 14:54:15.842567,Postres · Desayunos,Gelateria Da Favola,53900,6500,60400
2902,2903,21-10-2020 14:54:16.056223,Sushi,Kim Pop,8900,5400,14300
2903,2904,21-10-2020 14:54:16.319836,Pollo · Típica,Auyama,39700,3900,43600
2904,2905,21-10-2020 14:54:16.683663,Hamburguesas,Gofi Burger,9000,5100,14100
2905,2906,21-10-2020 14:54:16.997460,Típica,La Herencia,35000,5900,40900
2906,2907,21-10-2020 14:54:17.311211,Comida Rápida · Perros Calientes,Similoa - Comida Rapida,39700,3700,43400
2907,2908,21-10-2020 14:54:17.424741,Saludable · Desayunos,Básico y elemental,24300,5000,29300
2908,2909,21-10-2020 14:54:17.738639,Desayunos · Panadería,Choclofee,24300,4700,29000
2909,2910,21-10-2020 14:54:18.002422,Pollo,Oliva Va,37900,5600,43500
2910,2911,21-10-2020 14:54:18.166185,Desayunos · Café,Norma's Ice Cream Café,70000,6300,76300
2911,2912,21-10-2020 14:54:18.379917,Postres · Desayunos,Café Quindio,13000,5700,18700
2912,2913,21-10-2020 14:54:18.744027,Parrilla,El Tambor,24300,6800,31100
2913,2914,21-10-2020 14:54:19.058934,Postres · Desayunos,Maria Luisa - Postres,35000,4300,39300
2914,2915,21-10-2020 14:54:19.172643,Postres,La Tertulia,70000,3400,73400
2915,2916,21-10-2020 14:54:19.486436,Pizza,pizza andante,23000,4200,27200
2916,2917,21-10-2020 14:54:19.650279,Típica,La Olla de Barro,23000,5300,28300
2917,2918,21-10-2020 14:54:19.813970,Pizza · Italiana,Pisapore - Pizza,65000,6600,71600
2918,2919,21-10-2020 14:54:20.027665,Típica · Parrilla,La Ternera Parrilla,15600,5200,20800
2919,2920,21-10-2020 14:54:20.291533,Alta Cocina · Postres,La Pinta,11870,4500,16370
2920,2921,21-10-2020 14:54:20.455266,Pollo · Desayunos,Candelina,7500,5300,12800
2921,2922,21-10-2020 14:54:20.718986,Saludable,Hanai - Bowls Saludables,13600,5900,19500
2922,2923,21-10-2020 14:54:21.082909,Típica,Bendita S,35000,4600,39600
2923,2924,21-10-2020 14:54:21.296670,Postres · Desayunos,Sweet Tale,12500,5800,18300
2924,2925,21-10-2020 14:54:21.660607,Parrilla,OAK Ahumado y Brebajes,15600,6000,21600
2925,2926,21-10-2020 14:54:21.974506,Saludable · Desayunos,Copacabana Açai Bowls,31800,3000,34800
2926,2927,21-10-2020 14:54:22.338438,Parrilla · Café,Gaira Café,11870,4400,16270
2927,2928,21-10-2020 14:54:22.552438,Típica · Parrilla,El Santandereano,24300,5200,29500
2928,2929,21-10-2020 14:54:22.716145,Hamburguesas · Pescados y Mariscos,El Velero,70000,6500,76500
2929,2930,21-10-2020 14:54:22.829691,Típica · Parrilla,La Ternera Parrilla,13600,5200,18800
2930,2931,21-10-2020 14:54:22.943117,Saludable · Desayunos,La Estampilla,35000,6000,41000
2931,2932,21-10-2020 14:54:23.056779,Hamburguesas,Monchis - Hamburguesa,48750,4300,53050
2932,2933,21-10-2020 14:54:23.320635,Peruana · Internacional,La Chifería,23000,6600,29600
2933,2934,21-10-2020 14:54:23.684578,Postres · Desayunos,Sweet Tale,9000,5800,14800
2934,2935,21-10-2020 14:54:23.848355,Crepes,La Chabatta,35000,5900,40900
2935,2936,21-10-2020 14:54:24.163287,Típica,La Herencia,10700,5900,16600
2936,2937,21-10-2020 14:54:24.326996,Parrilla · Café,Gaira Café,10700,4400,15100
2937,2938,21-10-2020 14:54:24.590707,Saludable · Desayunos,Básico y Elemental,9000,5900,14900
2938,2939,21-10-2020 14:54:24.954566,Típica · Parrilla,El Portal de la Antigua,10700,5600,16300
2939,2940,21-10-2020 14:54:25.218600,Desayunos · Café,Libertario Coffee Roasters,15600,4600,20200
2940,2941,21-10-2020 14:54:25.482432,Parrilla,Rústico Picadería,24200,3800,28000
2941,2942,21-10-2020 14:54:25.796334,Desayunos · Café,Aromacafé el Placer de Compartir,10700,5000,15700
2942,2943,21-10-2020 14:54:26.110232,Desayunos · Panadería,Le Pain Quotidien,53400,3900,57300
2943,2944,21-10-2020 14:54:26.374055,Desayunos · Típica,Papadió - Colombianas,23000,5700,28700
2944,2945,21-10-2020 14:54:26.638083,Postres · Desayunos,KOKOA & co.,10700,4700,15400
2945,2946,21-10-2020 14:54:27.001951,Peruana · Internacional,La Chifería,7500,6600,14100
2946,2947,21-10-2020 14:54:27.365849,Desayunos,Jacinta Arepas de Huevo,15000,4000,19000
2947,2948,21-10-2020 14:54:27.479568,Saludable · Típica,Sopas Mrg,23000,3100,26100
2948,2949,21-10-2020 14:54:27.843635,Postres,La Tertulia,37900,3400,41300
2949,2950,21-10-2020 14:54:28.057692,Desayunos · Típica,Rojo Gourmet,34500,4700,39200
2950,2951,21-10-2020 14:54:28.371636,Desayunos · Jugos y Batidos,Dont Be Hungry,10700,5600,16300
2951,2952,21-10-2020 14:54:28.685776,Postres · Desayunos,BagBog Bagels,15600,6400,22000
2952,2953,21-10-2020 14:54:29.049910,Típica,Campo Victoria,35000,3000,38000
2953,2954,21-10-2020 14:54:29.164666,Desayunos,El Corral - Desayunos,27800,5000,32800
2954,2955,21-10-2020 14:54:29.328465,Postres,La Tertulia,23000,3400,26400
2955,2956,21-10-2020 14:54:29.442184,Saludable · Desayunos,Maracuyá,53400,6700,60100
2956,2957,21-10-2020 14:54:29.806294,Pollo · Saludable,Gratina,7500,4200,11700
2957,2958,21-10-2020 14:54:30.020001,Postres · Helados,Mahé,23000,6000,29000
2958,2959,21-10-2020 14:54:30.183818,Desayunos · Panadería,Artesanos,18900,4300,23200
2959,2960,21-10-2020 14:54:30.497696,Café · Helados,Sofia heladería y café,23000,5800,28800
2960,2961,21-10-2020 14:54:30.761563,Desayunos · Típica,Desayunadero de la 42,11870,5900,17770
2961,2962,21-10-2020 14:54:31.125571,Hamburguesas,Burger Society,8900,4100,13000
2962,2963,21-10-2020 14:54:31.389539,Típica · Parrilla,El Santandereano,7500,5200,12700
2963,2964,21-10-2020 14:54:31.653534,Saludable · Desayunos,La Estampilla,24200,6000,30200
2964,2965,21-10-2020 14:54:31.767574,Alta Cocina · Parrilla,Criterión,53900,6000,59900
2965,2966,21-10-2020 14:54:32.131799,Helados,Orso To Go,53400,6800,60200
2966,2967,21-10-2020 14:54:32.445819,Desayunos · Típica,Peninsula Calentados y Parrilla,27800,3400,31200
2967,2968,21-10-2020 14:54:32.759835,Alta Cocina · Postres,La Pinta,18900,4500,23400
2968,2969,21-10-2020 14:54:32.973573,Típica,Lo Nuestro,15600,3100,18700
2969,2970,21-10-2020 14:54:33.187426,Desayunos · Café,Aromacafé el Placer de Compartir,9000,5000,14000
2970,2971,21-10-2020 14:54:33.501470,Postres · Desayunos,Maltihelados,7500,6200,13700
2971,2972,21-10-2020 14:54:33.665352,Postres · Desayunos,La Folie - Postres,53400,3300,56700
2972,2973,21-10-2020 14:54:33.778947,Parrilla,OAK Ahumado y Brebajes,8900,6000,14900
2973,2974,21-10-2020 14:54:33.892586,Saludable,A2manos,15000,4200,19200
2974,2975,21-10-2020 14:54:34.056267,Hamburguesas,Gofi Burger,9000,5100,14100
2975,2976,21-10-2020 14:54:34.421544,Desayunos,Bagel Shop,12500,3200,15700
2976,2977,21-10-2020 14:54:34.685506,Mexicana,La leyenda mexican kitchen,65000,3200,68200
2977,2978,21-10-2020 14:54:34.899456,Pollo · Saludable,Gratina,13600,4200,17800
2978,2979,21-10-2020 14:54:35.113488,Típica,La Olla de Barro,18900,5300,24200
2979,2980,21-10-2020 14:54:35.377525,Desayunos · Típica,90 Calentados,8900,3700,12600
2980,2981,21-10-2020 14:54:35.541557,Postres · Café,Celestino Café,35000,5900,40900
2981,2982,21-10-2020 14:54:35.805508,Pollo · Saludable,Yerbabuena,10700,3900,14600
2982,2983,21-10-2020 14:54:36.019394,Sánduches · Pescados y Mariscos,Pacific Comida de Mar,7500,4000,11500
2983,2984,21-10-2020 14:54:36.183108,Helados,Buon Gelato,34500,4400,38900
2984,2985,21-10-2020 14:54:36.447082,Café · Helados,Sofia heladería y café,8900,5800,14700
2985,2986,21-10-2020 14:54:36.610901,Sushi,Umi,7500,5600,13100
2986,2987,21-10-2020 14:54:36.824875,Postres · Desayunos,Amelie Helados,27800,6400,34200
2987,2988,21-10-2020 14:54:37.138877,Pollo,Heart & Cooking,17800,5000,22800
2988,2989,21-10-2020 14:54:37.452954,Postres · Desayunos,Maltihelado,8900,4500,13400
2989,2990,21-10-2020 14:54:37.667239,Parrilla,Parrilla Pimentón,48750,3400,52150
2990,2991,21-10-2020 14:54:37.931186,Pollo · Saludable,Gratina,31800,4200,36000
2991,2992,21-10-2020 14:54:38.245263,Típica,La Herencia,23000,5900,28900
2992,2993,21-10-2020 14:54:38.408944,Saludable · Desayunos,Básico y Elemental,18900,5900,24800
2993,2994,21-10-2020 14:54:38.723033,Saludable · Desayunos,Distrito Gourmet,8900,3700,12600
2994,2995,21-10-2020 14:54:39.037328,Asiática,Thai Station,53900,6000,59900
2995,2996,21-10-2020 14:54:39.151037,Postres · Desayunos,Café Quindio,24300,5700,30000
2996,2997,21-10-2020 14:54:39.364994,Desayunos · Café,vereda central calle 99,29500,5700,35200
2997,2998,21-10-2020 14:54:39.579903,Desayunos · Típica,Peninsula Calentados y Parrilla,12500,3400,15900
2998,2999,21-10-2020 14:54:39.893963,Desayunos · Panadería,Le Pain Quotidien,65000,3900,68900
2999,3000,21-10-2020 14:54:40.258317,Perros Calientes,Dog Shop - Rapida,37900,4900,42800
3000,3001,21-10-2020 14:54:40.422505,Saludable · Desayunos,Libre de Culpa,8900,4000,12900
3001,3002,21-10-2020 14:54:40.536297,Desayunos,La Frijolada Desayunos,17800,4400,22200
3002,3003,21-10-2020 14:54:40.700344,Postres,La Galeta,9000,3000,12000
3003,3004,21-10-2020 14:54:41.014441,Saludable · Jugos y Batidos,Berdes Drinks & Salads,35000,3500,38500
3004,3005,21-10-2020 14:54:41.378653,Saludable · Desayunos,Distrito Gourmet,23000,3700,26700
3005,3006,21-10-2020 14:54:41.692880,Pizza · Italiana,Pisapore - Pizza,13000,6600,19600
3006,3007,21-10-2020 14:54:41.806708,Italiana,Bocatto Di Passo,7500,5000,12500
3007,3008,21-10-2020 14:54:41.970640,Hamburguesas · Saludable,Restaurant Inn,24300,6100,30400
3008,3009,21-10-2020 14:54:42.334721,Desayunos · Panadería,Limarys,8900,6500,15400
3009,3010,21-10-2020 14:54:42.498928,Desayunos · Parrilla,Mi Patria,53400,4600,58000
3010,3011,21-10-2020 14:54:42.612859,Desayunos · Típica,D'Porco - Lechona,35000,6300,41300
3011,3012,21-10-2020 14:54:42.927140,Asiática,Thai Station,27800,6000,33800
3012,3013,21-10-2020 14:54:43.291261,Saludable · Desayunos,Malú,18900,3700,22600
3013,3014,21-10-2020 14:54:43.605770,Desayunos · Empanadas,Empanadas Doraditas.com,35000,3000,38000
3014,3015,21-10-2020 14:54:43.869957,Desayunos · Café,Frambas,10700,3400,14100
3015,3016,21-10-2020 14:54:43.983744,Desayunos · Panadería,Decofruta,45800,4700,50500
3016,3017,21-10-2020 14:54:44.197847,Mexicana,Cantina La 15,45800,4300,50100
3017,3018,21-10-2020 14:54:44.412025,Pollo · Típica,Auyama,17800,3900,21700
3018,3019,21-10-2020 14:54:44.576026,Pizza · Parrilla,Urban Lunch,7500,4000,11500
3019,3020,21-10-2020 14:54:44.741078,Desayunos · Típica,Desayunadero de la 42,15000,5900,20900
3020,3021,21-10-2020 14:54:44.855431,Parrilla · Internacional,Taperia de la Plaza,34500,5700,40200
3021,3022,21-10-2020 14:54:45.119642,Desayunos · Típica,Cochon,53400,3300,56700
3022,3023,21-10-2020 14:54:45.383716,Parrilla,El Tambor,8900,6800,15700
3023,3024,21-10-2020 14:54:45.697852,Desayunos · Típica,La Parrilla Dorada Polo,23000,6600,29600
3024,3025,21-10-2020 14:54:46.062104,Saludable · Desayunos,Re.al Alimentos Reales,65000,4000,69000
3025,3026,21-10-2020 14:54:46.376067,Poke,Poke Go,24300,4600,28900
3026,3027,21-10-2020 14:54:46.640617,Desayunos · Sánduches,Frutos del Bosque,12500,3500,16000
3027,3028,21-10-2020 14:54:47.005203,Saludable · Desayunos,La Cesta,31800,4700,36500
3028,3029,21-10-2020 14:54:47.169201,Desayunos · Típica,La Frijolada,27800,4500,32300
3029,3030,21-10-2020 14:54:47.332843,Parrilla · Café,Figaro Café/ Restaurante Argentino,8900,5800,14700
3030,3031,21-10-2020 14:54:47.696977,Típica,Cazuelitas 93,34500,3900,38400
3031,3032,21-10-2020 14:54:48.011100,Desayunos · Típica,Fogón Sangileño,35000,5000,40000
3032,3033,21-10-2020 14:54:48.124967,Desayunos,Bagel Shop,35000,3200,38200
3033,3034,21-10-2020 14:54:48.489108,Panadería,Boul,15000,3100,18100
3034,3035,21-10-2020 14:54:48.853583,Desayunos · Panadería,Siena Café,37900,3700,41600
3035,3036,21-10-2020 14:54:49.217818,Saludable · Desayunos,Agua Dulce,24300,3700,28000
3036,3037,21-10-2020 14:54:49.531911,Parrilla · Café,Gaira Café,34500,4400,38900
3037,3038,21-10-2020 14:54:49.797106,Desayunos · Panadería,Juliana Restaurante,23000,6100,29100
3038,3039,21-10-2020 14:54:50.161505,Postres,Beiked,13000,4000,17000
3039,3040,21-10-2020 14:54:50.375560,Desayunos · Típica,Cochon,12500,3300,15800
3040,3041,21-10-2020 14:54:50.689884,Pizza,Pastas Laurentina,12500,4800,17300
3041,3042,21-10-2020 14:54:50.904274,Postres · Desayunos,Sharmus,13600,6100,19700
3042,3043,21-10-2020 14:54:51.118580,Postres · Desayunos,Restaurante Cornelia,29500,5500,35000
3043,3044,21-10-2020 14:54:51.482830,Pollo · China,China Tao,13000,3500,16500
3044,3045,21-10-2020 14:54:51.596623,Desayunos · Pescados y Mariscos,Luzí­a - Mediterranea,34500,5700,40200
3045,3046,21-10-2020 14:54:51.910788,Postres · Helados,Mahé,53900,6000,59900
3046,3047,21-10-2020 14:54:52.124800,Helados,Buon Gelato,13600,4400,18000
3047,3048,21-10-2020 14:54:52.438942,Parrilla,OAK Ahumado y Brebajes,53900,6000,59900
3048,3049,21-10-2020 14:54:52.553450,Panadería,Boul,53900,3100,57000
3049,3050,21-10-2020 14:54:52.817673,Postres · Helados,Mahé,23000,6000,29000
3050,3051,21-10-2020 14:54:52.981512,Desayunos,Señor Desayuno,34500,6800,41300
3051,3052,21-10-2020 14:54:53.295624,Desayunos · Típica,Casa Vieja,13000,6000,19000
3052,3053,21-10-2020 14:54:53.509917,Desayunos,Sr Buñuelo,13600,6400,20000
3053,3054,21-10-2020 14:54:53.874191,Postres · Café,Celestino Café,10700,5900,16600
3054,3055,21-10-2020 14:54:53.988184,Típica,El Mondongo y Mucho Mas,11870,5600,17470
3055,3056,21-10-2020 14:54:54.353066,Pollo · Pescados y Mariscos,Bang Bang Rice,39700,3400,43100
3056,3057,21-10-2020 14:54:54.717364,Desayunos,Cafetería el Kippe,34500,3200,37700
3057,3058,21-10-2020 14:54:55.032815,Desayunos,La Frijolada Desayunos,35000,4400,39400
3058,3059,21-10-2020 14:54:55.347648,Desayunos · Pescados y Mariscos,Gypsy Bistro,13000,4500,17500
3059,3060,21-10-2020 14:54:55.661879,Típica,Cazuelitas 93,39700,3900,43600
3060,3061,21-10-2020 14:54:55.775807,Pollo · Saludable,Yerbabuena,48750,3900,52650
3061,3062,21-10-2020 14:54:56.089841,Postres · Desayunos,Protein Bakes,9000,5900,14900
3062,3063,21-10-2020 14:54:56.353805,Desayunos · Café,vereda central calle 99,17800,5700,23500
3063,3064,21-10-2020 14:54:56.517821,Italiana,Bocatto Di Passo,12500,5000,17500
3064,3065,21-10-2020 14:54:56.781869,Desayunos · Café,Frambas,24200,3400,27600
3065,3066,21-10-2020 14:54:57.096141,Saludable · Típica,Sopas Mrg,23000,3100,26100
3066,3067,21-10-2020 14:54:57.260245,Pizza · Italiana,Piatto - Pizza,13000,6600,19600
3067,3068,21-10-2020 14:54:57.424365,Pollo · Saludable,Tremenda Sal y Dulce,27800,6500,34300
3068,3069,21-10-2020 14:54:57.788531,Desayunos · Café,Libertario Coffee Roasters,9000,4600,13600
3069,3070,21-10-2020 14:54:57.952501,Desayunos,Archies Desayunos,17800,3100,20900
3070,3071,21-10-2020 14:54:58.216720,Desayunos · Jugos y Batidos,Kuriwaji,70000,6300,76300
3071,3072,21-10-2020 14:54:58.380924,Típica,La Cocina,8900,4600,13500
3072,3073,21-10-2020 14:54:58.545445,Desayunos · Empanadas,Mis Delicias,15000,3200,18200
3073,3074,21-10-2020 14:54:58.809659,Hamburguesas · Saludable,Restaurant Inn,45800,6100,51900
3074,3075,21-10-2020 14:54:59.123956,Desayunos · Típica,La Frijolada,34500,4500,39000
3075,3076,21-10-2020 14:54:59.388181,Desayunos · Panadería,El Pan de Phillippe,39700,4600,44300
3076,3077,21-10-2020 14:54:59.502246,Hamburguesas,Gofi Burger,31800,5100,36900
3077,3078,21-10-2020 14:54:59.716405,Saludable · Parrilla,Box,24200,3700,27900
3078,3079,21-10-2020 14:54:59.930846,Pollo · Pescados y Mariscos,Bang Bang Rice,17800,3400,21200
3079,3080,21-10-2020 14:55:00.146113,Mexicana,Hidalgo Taquería,24300,4900,29200
3080,3081,21-10-2020 14:55:00.260176,Desayunos,El Fogón Castellano,53400,3200,56600
3081,3082,21-10-2020 14:55:00.574313,Típica,La Cocina,17800,4600,22400
3082,3083,21-10-2020 14:55:00.788305,Desayunos · Típica,Papadió - Colombianas,11870,5700,17570
3083,3084,21-10-2020 14:55:01.002403,Típica · Parrilla,La Ternera Parrilla,9000,5200,14200
3084,3085,21-10-2020 14:55:01.366737,Panadería,Boul,24200,3100,27300
3085,3086,21-10-2020 14:55:01.680970,Postres · Desayunos,Amelie Helados,31800,6400,38200
3086,3087,21-10-2020 14:55:01.794961,Típica,Bandejas Mrg,45800,3800,49600
3087,3088,21-10-2020 14:55:01.909003,Desayunos · Panadería,Le Pain Quotidien,7500,3900,11400
3088,3089,21-10-2020 14:55:02.123181,Postres · Desayunos,KOKOA & co.,70000,4700,74700
3089,3090,21-10-2020 14:55:02.387418,Desayunos · Jugos y Batidos,Dont Be Hungry,53400,5600,59000
3090,3091,21-10-2020 14:55:02.501595,Asiática,Thai Station,9000,6000,15000
3091,3092,21-10-2020 14:55:02.715787,Desayunos · Típica,D'Porco - Lechona,15600,6300,21900
3092,3093,21-10-2020 14:55:02.879834,Desayunos · Árabe,Boniato Sabores Vivos,39700,5300,45000
3093,3094,21-10-2020 14:55:03.244201,Parrilla · Café,Figaro Café/ Restaurante Argentino,9000,5800,14800
3094,3095,21-10-2020 14:55:03.558705,Parrilla,Coquitas,15000,5600,20600
3095,3096,21-10-2020 14:55:03.823104,Desayunos · Típica,Parrilla Farandula Típico,18900,5900,24800
3096,3097,21-10-2020 14:55:04.037339,Sánduches · Pescados y Mariscos,Pacific Comida de Mar,39700,4000,43700
3097,3098,21-10-2020 14:55:04.301489,Desayunos · Pescados y Mariscos,Luzí­a - Mediterranea,53900,5700,59600
3098,3099,21-10-2020 14:55:04.565532,Pollo · Saludable,Tremenda Sal y Dulce,24300,6500,30800
3099,3100,21-10-2020 14:55:04.779641,Postres · Helados,Mahé,34500,6000,40500
3100,3101,21-10-2020 14:55:04.993878,Desayunos · Típica,La Frijolada,23000,4500,27500
3101,3102,21-10-2020 14:55:05.209251,Desayunos · Panadería,Juliana Restaurante,8900,6100,15000
3102,3103,21-10-2020 14:55:05.523793,Saludable · Desayunos,Guadalupe - Fruteria,34500,5900,40400
3103,3104,21-10-2020 14:55:05.738064,Pollo · China,China Tao,10700,3500,14200
3104,3105,21-10-2020 14:55:05.952143,Parrilla,Rústico Picadería,53900,3800,57700
3105,3106,21-10-2020 14:55:06.216690,Desayunos,Bagel Shop,18900,3200,22100
3106,3107,21-10-2020 14:55:06.381167,Desayunos · Típica,Criollomania,15000,5200,20200
3107,3108,21-10-2020 14:55:06.595471,Alta Cocina · Parrilla,Criterión,24200,6000,30200
3108,3109,21-10-2020 14:55:06.809854,Pollo · Sánduches,Pollos Century,31800,3000,34800
3109,3110,21-10-2020 14:55:07.074060,Saludable · Desayunos,Bon Eat - Saludable,15600,4800,20400
3110,3111,21-10-2020 14:55:07.288229,Desayunos · Café,Matchacha,12500,5900,18400
3111,3112,21-10-2020 14:55:07.502401,Saludable · Desayunos,Guadalupe - Fruteria,17800,5900,23700
3112,3113,21-10-2020 14:55:07.666566,Desayunos · Panadería,Limarys,18900,6500,25400
3113,3114,21-10-2020 14:55:08.030841,Saludable · Desayunos,Raices Bienestar Gourmet,11870,6600,18470
3114,3115,21-10-2020 14:55:08.395287,Sushi · Desayunos,Maki Roll,31800,4300,36100
3115,3116,21-10-2020 14:55:08.559411,Desayunos · Típica,90 Calentados,8900,3700,12600
3116,3117,21-10-2020 14:55:08.873739,Postres · Desayunos,Sharmus,17800,6100,23900
3117,3118,21-10-2020 14:55:09.088003,Típica · Parrilla,Toya,35000,4200,39200
3118,3119,21-10-2020 14:55:09.202140,Pollo,Señor Fantástico,70000,4700,74700
3119,3120,21-10-2020 14:55:09.466489,Pollo,Oliva Va,37900,5600,43500
3120,3121,21-10-2020 14:55:09.730818,Saludable · Jugos y Batidos,Berdes Drinks & Salads,11870,3500,15370
3121,3122,21-10-2020 14:55:09.995075,Sushi,Canoa To Go,13600,5900,19500
3122,3123,21-10-2020 14:55:10.310804,Pescados y Mariscos,Fish Place - Del Mar,31800,5400,37200
3123,3124,21-10-2020 14:55:10.625311,Postres · Desayunos,Protein Bakes,23000,5900,28900
3124,3125,21-10-2020 14:55:10.939639,Parrilla,Beraca Parrilla Bbq,24300,5600,29900
3125,3126,21-10-2020 14:55:11.253983,Jugos y Batidos,Pomponio,53900,3600,57500
3126,3127,21-10-2020 14:55:11.468343,Saludable · Desayunos,Fresh Co,18900,5600,24500
3127,3128,21-10-2020 14:55:11.632499,Desayunos · Típica,Alce,24300,4900,29200
3128,3129,21-10-2020 14:55:11.946843,Desayunos · Café,El Gualilo,31800,6200,38000
3129,3130,21-10-2020 14:55:12.111177,Típica,Baondish,11870,5800,17670
3130,3131,21-10-2020 14:55:12.375442,Desayunos,La Frijolada Desayunos,24300,4400,28700
3131,3132,21-10-2020 14:55:12.590068,Desayunos · Sánduches,Garnish,23000,5200,28200
3132,3133,21-10-2020 14:55:12.704353,Parrilla,Parrilla Pimentón,18900,3400,22300
3133,3134,21-10-2020 14:55:12.918575,Desayunos,Cafetería el Kippe,53900,3200,57100
3134,3135,21-10-2020 14:55:13.282963,Saludable · Típica,Saludable Mrg,29500,5800,35300
3135,3136,21-10-2020 14:55:13.497232,Poke,Poke Go,10700,4600,15300
3136,3137,21-10-2020 14:55:13.661427,Desayunos · Panadería,Decofruta,15000,4700,19700
3137,3138,21-10-2020 14:55:13.775500,Desayunos · Café,vereda central calle 99,35000,5700,40700
3138,3139,21-10-2020 14:55:14.140144,Desayunos · Panadería,Santa Juana Food Bar,24300,5900,30200
3139,3140,21-10-2020 14:55:14.454665,Hamburguesas,Monchis - Hamburguesa,29500,4300,33800
3140,3141,21-10-2020 14:55:14.568922,Desayunos · Típica,Criollomania,17800,5200,23000
3141,3142,21-10-2020 14:55:14.833414,Típica,Bandejas Mrg,37900,3800,41700
3142,3143,21-10-2020 14:55:15.097862,Postres,Levelma,29500,6200,35700
3143,3144,21-10-2020 14:55:15.262203,Típica,El Mondongo y Mucho Mas,23000,5600,28600
3144,3145,21-10-2020 14:55:15.376358,Saludable,Amor Propio saludable,15000,4000,19000
3145,3146,21-10-2020 14:55:15.591091,Típica · Parrilla,La Ternera Parrilla,12500,5200,17700
3146,3147,21-10-2020 14:55:15.955590,Postres · Café,Loló Coffee & Snacks,10700,4600,15300
3147,3148,21-10-2020 14:55:16.070157,Típica,Sopitas y Más,39700,4200,43900
3148,3149,21-10-2020 14:55:16.234484,Típica,Cazuelitas 93,24300,3900,28200
3149,3150,21-10-2020 14:55:16.548835,Saludable,Ventura Soup y Salad,23000,3800,26800
3150,3151,21-10-2020 14:55:16.863227,Desayunos · Típica,Casa Vieja,34500,6000,40500
3151,3152,21-10-2020 14:55:17.077636,Postres · Desayunos,Vivalight Market.,13000,6500,19500
3152,3153,21-10-2020 14:55:17.292071,Típica,La Cocina,23000,4600,27600
3153,3154,21-10-2020 14:55:17.506549,Hamburguesas · Pescados y Mariscos,El Velero,7500,6500,14000
3154,3155,21-10-2020 14:55:17.871078,Típica · Parrilla,La Ternera Parrilla,34500,5200,39700
3155,3156,21-10-2020 14:55:18.085403,Saludable · Desayunos,Malú,11870,3700,15570
3156,3157,21-10-2020 14:55:18.249617,Saludable · Desayunos,Re.al Alimentos Reales,27800,4000,31800
3157,3158,21-10-2020 14:55:18.513986,Saludable · Desayunos,Básico y Elemental,24300,5900,30200
3158,3159,21-10-2020 14:55:18.828491,Desayunos · Panadería,El Pan de Phillippe,15600,4600,20200
3159,3160,21-10-2020 14:55:19.042835,Postres · Desayunos,Sweet Tale,35000,5800,40800
3160,3161,21-10-2020 14:55:19.157097,Sushi,Umi,34500,5600,40100
3161,3162,21-10-2020 14:55:19.471459,Panadería,Boul,13600,3100,16700
3162,3163,21-10-2020 14:55:19.785959,Típica,Bandejas Mrg,34500,3800,38300
3163,3164,21-10-2020 14:55:20.100471,Parrilla · Internacional,Taperia de la Plaza,9000,5700,14700
3164,3165,21-10-2020 14:55:20.314788,Postres · Desayunos,Aury Postres - Comidas & Picadas,11870,4700,16570
3165,3166,21-10-2020 14:55:20.580380,Saludable,Ventura Soup y Salad,31800,3800,35600
3166,3167,21-10-2020 14:55:20.694999,Hamburguesas,Monchis - Hamburguesa,53900,4300,58200
3167,3168,21-10-2020 14:55:20.909401,Pizza · Parrilla,Urban Lunch,35000,4000,39000
3168,3169,21-10-2020 14:55:21.073608,Saludable · Desayunos,Raices Bienestar Gourmet,39700,6600,46300
3169,3170,21-10-2020 14:55:21.438043,Típica,Cabrito Santandereano,48750,6600,55350
3170,3171,21-10-2020 14:55:21.702668,Desayunos · Panadería,Siena Café,24200,3700,27900
3171,3172,21-10-2020 14:55:21.816870,Desayunos · Café,Matchacha,53900,5900,59800
3172,3173,21-10-2020 14:55:22.181485,Saludable · Parrilla,The Angels Grill and Drinks,24300,6200,30500
3173,3174,21-10-2020 14:55:22.345651,Pollo · Desayunos,Caserito Gourmet,23000,6700,29700
3174,3175,21-10-2020 14:55:22.509742,Desayunos · Jugos y Batidos,Kuriwaji,31800,6300,38100
3175,3176,21-10-2020 14:55:22.724340,Poke,Poke Go,12500,4600,17100
3176,3177,21-10-2020 14:55:23.088843,Hamburguesas,Burger Society,13000,4100,17100
3177,3178,21-10-2020 14:55:23.453429,Sushi · Desayunos,Maki Roll,70000,4300,74300
3178,3179,21-10-2020 14:55:23.767978,Postres,Toledo Pastelería,23000,6800,29800
3179,3180,21-10-2020 14:55:23.882389,Parrilla · Café,Gaira Café,12500,4400,16900
3180,3181,21-10-2020 14:55:24.147017,Peruana,Uma Cantina Peruana,17800,3200,21000
3181,3182,21-10-2020 14:55:24.511536,Postres · Desayunos,Vivalight Market.,34500,6500,41000
3182,3183,21-10-2020 14:55:24.726098,Típica · Pescados y Mariscos,Arroces Mrg,12500,4300,16800
3183,3184,21-10-2020 14:55:25.090643,Postres · Café,Loló Coffee & Snacks,15000,4600,19600
3184,3185,21-10-2020 14:55:25.455399,Parrilla,Rústico Picadería,12500,3800,16300
3185,3186,21-10-2020 14:55:25.670978,Saludable,The Good Rice Bowls,37900,3500,41400
3186,3187,21-10-2020 14:55:26.035500,Saludable · Desayunos,Bawana - Sandwich,8900,3400,12300
3187,3188,21-10-2020 14:55:26.199988,Desayunos · Típica,Cochon,37900,3300,41200
3188,3189,21-10-2020 14:55:26.464601,Desayunos · Comida Rápida,La Veneca,34500,6300,40800
3189,3190,21-10-2020 14:55:26.779237,Pollo · Desayunos,Workzone,15600,3100,18700
3190,3191,21-10-2020 14:55:26.893745,Parrilla,Antojo a Domicilio,15000,5000,20000
3191,3192,21-10-2020 14:55:27.258260,Postres · Saludable,Ana Rebana,15600,6300,21900
3192,3193,21-10-2020 14:55:27.372664,Pescados y Mariscos,Pescadero Héroes del Mar,15600,6600,22200
3193,3194,21-10-2020 14:55:27.637072,Parrilla,Arepaisa de Medellín,17800,5600,23400
3194,3195,21-10-2020 14:55:27.801478,Helados,Orso To Go,17800,6800,24600
3195,3196,21-10-2020 14:55:28.015750,Saludable · Desayunos,Libre de Culpa,35000,4000,39000
3196,3197,21-10-2020 14:55:28.180149,Comida Rápida · Perros Calientes,Similoa - Comida Rapida,70000,3700,73700
3197,3198,21-10-2020 14:55:28.494642,Parrilla,Rústico Picadería,53900,3800,57700
3198,3199,21-10-2020 14:55:28.659138,Hamburguesas · Panadería,NYC Burgers,13000,6200,19200
3199,3200,21-10-2020 14:55:28.773588,Saludable · Desayunos,Agua Dulce,15000,3700,18700
3200,3201,21-10-2020 14:55:28.938010,Sushi,Sushi Reel,7500,4700,12200
3201,3202,21-10-2020 14:55:29.102898,Pollo · Saludable,Yerbabuena,45800,3900,49700
3202,3203,21-10-2020 14:55:29.467673,Desayunos · Panadería,Limarys,23000,6500,29500
3203,3204,21-10-2020 14:55:29.632129,Típica · Parrilla,La Parilla de David,18900,3100,22000
3204,3205,21-10-2020 14:55:29.946790,Pollo · Sánduches,Pollos Century,48750,3000,51750
3205,3206,21-10-2020 14:55:30.261595,Pescados y Mariscos,Pescadero Héroes del Mar,48750,6600,55350
3206,3207,21-10-2020 14:55:30.375940,Hamburguesas · Pescados y Mariscos,El Velero,31800,6500,38300
3207,3208,21-10-2020 14:55:30.641072,Postres · Desayunos,Protein Bakes,27800,5900,33700
3208,3209,21-10-2020 14:55:30.756444,Postres,La Tertulia,12500,3400,15900
3209,3210,21-10-2020 14:55:30.870779,Saludable · Desayunos,Fresh Co,12500,5600,18100
3210,3211,21-10-2020 14:55:31.135373,Pollo · Desayunos,Abasto,45800,3600,49400
3211,3212,21-10-2020 14:55:31.450050,Pollo · Desayunos,Abasto,13600,3600,17200
3212,3213,21-10-2020 14:55:31.564479,Desayunos · Café,Aromacafé el Placer de Compartir,70000,5000,75000
3213,3214,21-10-2020 14:55:31.879127,Parrilla · Café,Gaira Café,45800,4400,50200
3214,3215,21-10-2020 14:55:32.093665,Pollo · Pescados y Mariscos,Bang Bang Rice,31800,3400,35200
3215,3216,21-10-2020 14:55:32.358210,Saludable · Desayunos,Copacabana Açai Bowls,35000,3000,38000
3216,3217,21-10-2020 14:55:32.672929,Comida Rápida,Fiesta Digital Andrés,13000,3100,16100
3217,3218,21-10-2020 14:55:33.037700,Pollo · Desayunos,Workzone,7500,3100,10600
3218,3219,21-10-2020 14:55:33.202197,Saludable · Desayunos,Básico y elemental,48750,5000,53750
3219,3220,21-10-2020 14:55:33.566963,Postres,La Galeta,35000,3000,38000
3220,3221,21-10-2020 14:55:33.731483,Postres · Desayunos,Restaurante Cornelia,15600,5500,21100
3221,3222,21-10-2020 14:55:33.995940,Desayunos · Panadería,Siena Café,48750,3700,52450
3222,3223,21-10-2020 14:55:34.260471,Postres · Desayunos,BagBog Bagels,70000,6400,76400
3223,3224,21-10-2020 14:55:34.525206,Sánduches · Pescados y Mariscos,Pacific Comida de Mar,23000,4000,27000
3224,3225,21-10-2020 14:55:34.689599,Desayunos · Típica,D´Porco,35000,3900,38900
3225,3226,21-10-2020 14:55:35.054422,Desayunos,Sunny Breakfast Brunch,18900,4300,23200
3226,3227,21-10-2020 14:55:35.319200,Desayunos · Café,Libertario Coffee Roasters,11870,4600,16470
3227,3228,21-10-2020 14:55:35.483761,Parrilla,Rústico Picadería,17800,3800,21600
3228,3229,21-10-2020 14:55:35.698384,Comida Rápida · Perros Calientes,Similoa - Comida Rapida,23000,3700,26700
3229,3230,21-10-2020 14:55:35.914175,Desayunos · Típica,Desayunadero de la 42,37900,5900,43800
3230,3231,21-10-2020 14:55:36.078638,Sánduches · China,Peru Mix,39700,5900,45600
3231,3232,21-10-2020 14:55:36.343305,Desayunos · Jugos y Batidos,Dont Be Hungry,23000,5600,28600
3232,3233,21-10-2020 14:55:36.607788,Internacional,Rio Sabores y Experiencias,53400,4100,57500
3233,3234,21-10-2020 14:55:36.822449,Helados,Buon Gelato,24200,4400,28600
3234,3235,21-10-2020 14:55:37.086980,Peruana,Uma Cantina Peruana,8900,3200,12100
3235,3236,21-10-2020 14:55:37.201562,Típica · Parrilla,Typykos,27800,6000,33800
3236,3237,21-10-2020 14:55:37.366099,Típica · Parrilla,El Portal de la Antigua,24300,5600,29900
3237,3238,21-10-2020 14:55:37.580568,Desayunos · Sánduches,Danilo Colombia,37900,3300,41200
3238,3239,21-10-2020 14:55:37.895298,Desayunos · Jugos y Batidos,Frutiwow,53400,4100,57500
3239,3240,21-10-2020 14:55:38.009770,Pollo,Heart & Cooking,48750,5000,53750
3240,3241,21-10-2020 14:55:38.374468,Pizza,Pizza Andante,9000,6300,15300
3241,3242,21-10-2020 14:55:38.489217,Desayunos · Panadería,Pasteleite,8900,5900,14800
3242,3243,21-10-2020 14:55:38.653773,Sushi · Desayunos,Maki Roll,27800,4300,32100
3243,3244,21-10-2020 14:55:38.818182,Mexicana,Hidalgo Taquería,53900,4900,58800
3244,3245,21-10-2020 14:55:39.133044,Pizza,Pizza Andante,27800,6300,34100
3245,3246,21-10-2020 14:55:39.397750,Saludable · Jugos y Batidos,Berdes Drinks & Salads,15000,3500,18500
3246,3247,21-10-2020 14:55:39.712377,Desayunos,El Corral - Desayunos,17800,5000,22800
3247,3248,21-10-2020 14:55:39.926971,Mexicana,La leyenda mexican kitchen,18900,3200,22100
3248,3249,21-10-2020 14:55:40.041443,Sánduches · China,Peru Mix,9000,5900,14900
3249,3250,21-10-2020 14:55:40.155805,Postres · Desayunos,Cosmo Cookies,24200,5900,30100
3250,3251,21-10-2020 14:55:40.370527,Típica · Pescados y Mariscos,Arroces Mrg,39700,4300,44000
3251,3252,21-10-2020 14:55:40.535013,Saludable,Hanai - Bowls Saludables,45800,5900,51700
3252,3253,21-10-2020 14:55:40.749583,Parrilla,Coquitas,10700,5600,16300
3253,3254,21-10-2020 14:55:40.965021,Típica,El Mondongo y Mucho Mas,10700,5600,16300
3254,3255,21-10-2020 14:55:41.329743,Saludable,Amor Propio saludable,70000,4000,74000
3255,3256,21-10-2020 14:55:41.594244,Desayunos · Panadería,Choclofee,17800,4700,22500
3256,3257,21-10-2020 14:55:41.808938,Parrilla · Café,Gaira Café,45800,4400,50200
3257,3258,21-10-2020 14:55:42.073534,Postres,Toledo Pastelería,15000,6800,21800
3258,3259,21-10-2020 14:55:42.438103,Pollo · Típica,Auyama,8900,3900,12800
3259,3260,21-10-2020 14:55:42.702934,Sushi · Asiática,Tu Sushi,37900,6400,44300
3260,3261,21-10-2020 14:55:42.917537,Asiática,TeT,37900,5900,43800
3261,3262,21-10-2020 14:55:43.132049,Pollo · Desayunos,Workzone,39700,3100,42800
3262,3263,21-10-2020 14:55:43.496835,Desayunos,Butter,18900,6700,25600
3263,3264,21-10-2020 14:55:43.661415,Típica,La Herencia,13000,5900,18900
3264,3265,21-10-2020 14:55:43.875810,Peruana · Internacional,La Chifería,45800,6600,52400
3265,3266,21-10-2020 14:55:44.140706,Crepes,San Crepes,48750,4900,53650
3266,3267,21-10-2020 14:55:44.308638,Típica,Sopitas y Más,70000,4200,74200
3267,3268,21-10-2020 14:55:44.573286,Pescados y Mariscos,Fish Place - Del Mar,7500,5400,12900
3268,3269,21-10-2020 14:55:44.887950,Saludable · Desayunos,Básico y Elemental,45800,5900,51700
3269,3270,21-10-2020 14:55:45.002477,Saludable,Ventura Soup y Salad,34500,3800,38300
3270,3271,21-10-2020 14:55:45.167213,Pescados y Mariscos,Pescadero Héroes del Mar,24200,6600,30800
3271,3272,21-10-2020 14:55:45.431997,Postres · Helados,Mahé,27800,6000,33800
3272,3273,21-10-2020 14:55:45.646763,Pescados y Mariscos,Pescadero Héroes del Mar,24200,6600,30800
3273,3274,21-10-2020 14:55:45.861503,Postres · Desayunos,Protein Bakes,24200,5900,30100
3274,3275,21-10-2020 14:55:46.226285,Desayunos · Típica,Alce,8900,4900,13800
3275,3276,21-10-2020 14:55:46.441263,Saludable · Desayunos,Malú,11870,3700,15570
3276,3277,21-10-2020 14:55:46.706135,Internacional,La Esquina con Sabor Parrilla,8900,3000,11900
3277,3278,21-10-2020 14:55:47.071030,Desayunos · Típica,Casa Vieja,12500,6000,18500
3278,3279,21-10-2020 14:55:47.385927,Desayunos · Café,Norma's Ice Cream Café,7500,6300,13800
3279,3280,21-10-2020 14:55:47.750897,Saludable,The Good Rice Bowls,34500,3500,38000
3280,3281,21-10-2020 14:55:48.115849,Desayunos · Pescados y Mariscos,Luzí­a - Mediterranea,8900,5700,14600
3281,3282,21-10-2020 14:55:48.380708,Saludable · Desayunos,La Estampilla,15600,6000,21600
3282,3283,21-10-2020 14:55:48.545461,Desayunos · Típica,Criollomania,48750,5200,53950
3283,3284,21-10-2020 14:55:48.659850,Desayunos,El Fogón Castellano,35000,3200,38200
3284,3285,21-10-2020 14:55:48.924590,Típica,Campo Victoria,45800,3000,48800
3285,3286,21-10-2020 14:55:49.289487,Pollo,Chicken House,9000,4200,13200
3286,3287,21-10-2020 14:55:49.454257,Parrilla,Campocina,24200,4600,28800
3287,3288,21-10-2020 14:55:49.819206,Desayunos · Café,Aromacafé el Placer de Compartir,65000,5000,70000
3288,3289,21-10-2020 14:55:49.933805,Típica · Parrilla,Toya,29500,4200,33700
3289,3290,21-10-2020 14:55:50.248759,Desayunos,El Fogón Castellano,10700,3200,13900
3290,3291,21-10-2020 14:55:50.614618,Desayunos,Sunny Breakfast Brunch,53400,4300,57700
3291,3292,21-10-2020 14:55:50.780535,Desayunos · Jugos y Batidos,Kuriwaji,35000,6300,41300
3292,3293,21-10-2020 14:55:50.896224,Saludable · Desayunos,Bawana - Sandwich,12500,3400,15900
3293,3294,21-10-2020 14:55:51.162123,Desayunos · Típica,Casa Vieja,15000,6000,21000
3294,3295,21-10-2020 14:55:51.529259,Pollo · Desayunos,Workzone,65000,3100,68100
3295,3296,21-10-2020 14:55:51.895425,Saludable · Desayunos,Básico y elemental,8900,5000,13900
3296,3297,21-10-2020 14:55:52.061170,Postres · Desayunos,Vivalight Market.,15000,6500,21500
3297,3298,21-10-2020 14:55:52.226945,Sánduches · Pescados y Mariscos,Pacific Comida de Mar,37900,4000,41900
3298,3299,21-10-2020 14:55:52.342737,Postres · Desayunos,Jacques Pastelería,15600,5900,21500
3299,3300,21-10-2020 14:55:52.458524,Saludable · Desayunos,Guadalupe - Fruteria,7500,5900,13400
3300,3301,21-10-2020 14:55:52.824383,Típica,Sopitas y Más,11870,4200,16070
3301,3302,21-10-2020 14:55:52.940087,Postres,Beiked,45800,4000,49800
3302,3303,21-10-2020 14:55:53.256434,Desayunos · Jugos y Batidos,Dont Be Hungry,35000,5600,40600
3303,3304,21-10-2020 14:55:53.521826,Pescados y Mariscos,Fish Place - Del Mar,23000,5400,28400
3304,3305,21-10-2020 14:55:53.887851,Hamburguesas · Desayunos,El Inglés Gastro Pub,12500,6600,19100
3305,3306,21-10-2020 14:55:54.052782,Postres,La Tertulia,24200,3400,27600
3306,3307,21-10-2020 14:55:54.168638,Crepes,La Chabatta,53900,5900,59800
3307,3308,21-10-2020 14:55:54.483904,Desayunos · Panadería,El Pan de Phillippe,31800,4600,36400
3308,3309,21-10-2020 14:55:54.699871,Desayunos,El Fogón Castellano,17800,3200,21000
3309,3310,21-10-2020 14:55:54.865192,Desayunos · Jugos y Batidos,Dont Be Hungry,29500,5600,35100
3310,3311,21-10-2020 14:55:55.181381,Desayunos · Típica,Peninsula Calentados y Parrilla,45800,3400,49200
3311,3312,21-10-2020 14:55:55.296381,Saludable,Amor Propio saludable,7500,4000,11500
3312,3313,21-10-2020 14:55:55.612284,Sánduches · Pescados y Mariscos,Pacific Comida de Mar,10700,4000,14700
3313,3314,21-10-2020 14:55:55.877495,Postres · Desayunos,Aury Postres - Comidas & Picadas,70000,4700,74700
3314,3315,21-10-2020 14:55:56.093371,Desayunos · Jugos y Batidos,Kuriwaji,8900,6300,15200
3315,3316,21-10-2020 14:55:56.458663,Comida Rápida,Fiesta Digital Andrés,10700,3100,13800
3316,3317,21-10-2020 14:55:56.774736,Típica,Cazuelitas 93,45800,3900,49700
3317,3318,21-10-2020 14:55:56.939820,Desayunos · Jugos y Batidos,Kuriwaji,45800,6300,52100
3318,3319,21-10-2020 14:55:57.054765,Poke,Poke Go,29500,4600,34100
3319,3320,21-10-2020 14:55:57.319872,Peruana · Internacional,La Chifería,12500,6600,19100
3320,3321,21-10-2020 14:55:57.584924,Postres,Levelma,34500,6200,40700
3321,3322,21-10-2020 14:55:57.699880,Parrilla,Rústico Picadería,15600,3800,19400
3322,3323,21-10-2020 14:55:57.814861,Desayunos · Típica,Criollomania,9000,5200,14200
3323,3324,21-10-2020 14:55:58.079832,Saludable · Desayunos,Bawana - Sandwich,24200,3400,27600
3324,3325,21-10-2020 14:55:58.295036,Postres · Desayunos,Maltihelados,53900,6200,60100
3325,3326,21-10-2020 14:55:58.660343,Típica,Juan Chorizo,34500,3900,38400
3326,3327,21-10-2020 14:55:58.925438,Postres · Saludable,Ana Rebana,23000,6300,29300
3327,3328,21-10-2020 14:55:59.140467,Desayunos · Café,El Gualilo,29500,6200,35700
3328,3329,21-10-2020 14:55:59.305469,Desayunos · Típica,Casa Vieja,48750,6000,54750
3329,3330,21-10-2020 14:55:59.420161,Típica · Parrilla,Typykos,37900,6000,43900
3330,3331,21-10-2020 14:55:59.585328,Desayunos · Italiana,Rceta By Rausch,35000,3600,38600
3331,3332,21-10-2020 14:55:59.900616,Parrilla,Antojo a Domicilio,18900,5000,23900
3332,3333,21-10-2020 14:56:00.115702,Sushi · Asiática,Tu Sushi,15600,6400,22000
3333,3334,21-10-2020 14:56:00.280928,Desayunos,Cafetería el Kippe,23000,3200,26200
3334,3335,21-10-2020 14:56:00.596094,Desayunos · Café,El Gualilo,7500,6200,13700
3335,3336,21-10-2020 14:56:00.711171,Desayunos,Archies Desayunos,53900,3100,57000
3336,3337,21-10-2020 14:56:00.876091,Típica,Lo Nuestro,23000,3100,26100
3337,3338,21-10-2020 14:56:01.241233,Saludable,Puro Verde,39700,5700,45400
3338,3339,21-10-2020 14:56:01.506327,Comida Rápida,Fiesta Digital Andrés,17800,3100,20900
3339,3340,21-10-2020 14:56:01.621424,Panadería,Boul,13000,3100,16100
3340,3341,21-10-2020 14:56:01.937908,Típica,Sabores De Mi Tierra,17800,5400,23200
3341,3342,21-10-2020 14:56:02.203275,Postres · Desayunos,BagBog Bagels,70000,6400,76400
3342,3343,21-10-2020 14:56:02.319419,Desayunos · Sánduches,Frutos del Bosque,70000,3500,73500
3343,3344,21-10-2020 14:56:02.685025,Postres · Desayunos,Jacques Pastelería,11870,5900,17770
3344,3345,21-10-2020 14:56:03.000468,Hamburguesas · Pescados y Mariscos,El Velero,29500,6500,36000
3345,3346,21-10-2020 14:56:03.365907,Pollo · Desayunos,Workzone,11870,3100,14970
3346,3347,21-10-2020 14:56:03.480991,Comida Rápida · Perros Calientes,Similoa - Comida Rapida,48750,3700,52450
3347,3348,21-10-2020 14:56:03.846223,Desayunos,El Fogón Castellano,65000,3200,68200
3348,3349,21-10-2020 14:56:04.011574,Sushi · Asiática,Arigato,31800,5300,37100
3349,3350,21-10-2020 14:56:04.276691,Desayunos,Cafetería el Kippe,13000,3200,16200
3350,3351,21-10-2020 14:56:04.491905,Pollo,Heart & Cooking,13600,5000,18600
3351,3352,21-10-2020 14:56:04.857271,Parrilla,El Tambor,15600,6800,22400
3352,3353,21-10-2020 14:56:05.122791,Hamburguesas,Gofi Burger,53900,5100,59000
3353,3354,21-10-2020 14:56:05.288026,Hamburguesas · Pescados y Mariscos,El Velero,17800,6500,24300
3354,3355,21-10-2020 14:56:05.503171,Hamburguesas · Desayunos,El Inglés Gastro Pub,45800,6600,52400
3355,3356,21-10-2020 14:56:05.768317,Asiática,TeT,9000,5900,14900
3356,3357,21-10-2020 14:56:05.983298,Desayunos · Jugos y Batidos,Dont Be Hungry,24300,5600,29900
3357,3358,21-10-2020 14:56:06.198627,Saludable · Desayunos,La Estampilla,23000,6000,29000
3358,3359,21-10-2020 14:56:06.414219,Desayunos · Panadería,Artesanos,11870,4300,16170
3359,3360,21-10-2020 14:56:06.629508,Sushi,Sushi Reel,7500,4700,12200
3360,3361,21-10-2020 14:56:06.995957,Típica,Sabores De Mi Tierra,34500,5400,39900
3361,3362,21-10-2020 14:56:07.311426,Sushi · Desayunos,Maki Roll,17800,4300,22100
3362,3363,21-10-2020 14:56:07.426809,Típica · Parrilla,Toya,39700,4200,43900
3363,3364,21-10-2020 14:56:07.692134,Típica · Parrilla,La Parilla de David,45800,3100,48900
3364,3365,21-10-2020 14:56:07.857310,Desayunos · Panadería,Limarys,24200,6500,30700
3365,3366,21-10-2020 14:56:08.172564,Saludable · Desayunos,Raices Bienestar Gourmet,35000,6600,41600
3366,3367,21-10-2020 14:56:08.487934,Típica,Bendita S,11870,4600,16470
3367,3368,21-10-2020 14:56:08.853240,Saludable,Hanai - Bowls Saludables,23000,5900,28900
3368,3369,21-10-2020 14:56:09.218992,Desayunos,Don Leo,13000,6000,19000
3369,3370,21-10-2020 14:56:09.484262,Perros Calientes,Dog Shop - Rapida,70000,4900,74900
3370,3371,21-10-2020 14:56:09.799589,Postres · Saludable,Ana Rebana,13600,6300,19900
3371,3372,21-10-2020 14:56:10.115095,Desayunos · Típica,Alce,39700,4900,44600
3372,3373,21-10-2020 14:56:10.330265,Desayunos · Panadería,Siena Café,10700,3700,14400
3373,3374,21-10-2020 14:56:10.645774,Desayunos · Pescados y Mariscos,Luzí­a - Mediterranea,13600,5700,19300
3374,3375,21-10-2020 14:56:10.860877,Desayunos · Café,Libertario Coffee Roasters,35000,4600,39600
3375,3376,21-10-2020 14:56:11.226099,Típica,La Cocina,29500,4600,34100
3376,3377,21-10-2020 14:56:11.591531,Desayunos,Archies Desayunos,7500,3100,10600
3377,3378,21-10-2020 14:56:11.806904,Desayunos · Café,Matchacha,8900,5900,14800
3378,3379,21-10-2020 14:56:11.921968,Panadería,Boul,29500,3100,32600
3379,3380,21-10-2020 14:56:12.088171,Parrilla,Coquitas,37900,5600,43500
3380,3381,21-10-2020 14:56:12.353560,Postres · Desayunos,Maltihelados,23000,6200,29200
3381,3382,21-10-2020 14:56:12.518584,Desayunos · Jugos y Batidos,Frutiwow,13000,4100,17100
3382,3383,21-10-2020 14:56:12.633816,Desayunos · Panadería,Le Pain Quotidien,13000,3900,16900
3383,3384,21-10-2020 14:56:12.749012,Desayunos,Bagel Shop,18900,3200,22100
3384,3385,21-10-2020 14:56:12.964405,Postres,Beiked,48750,4000,52750
3385,3386,21-10-2020 14:56:13.129699,Típica,Campo Victoria,35000,3000,38000
3386,3387,21-10-2020 14:56:13.495158,Desayunos · Helados,San Giorgio Gelateria,23000,3100,26100
3387,3388,21-10-2020 14:56:13.811285,Desayunos · Típica,D´Porco,10700,3900,14600
3388,3389,21-10-2020 14:56:13.926468,Típica · Parrilla,La Ternera Parrilla,23000,5200,28200
3389,3390,21-10-2020 14:56:14.041613,Pollo,Oliva Va,18900,5600,24500
3390,3391,21-10-2020 14:56:14.206825,Desayunos · Café,vereda central calle 99,17800,5700,23500
3391,3392,21-10-2020 14:56:14.321980,Comida Rápida · Perros Calientes,Similoa - Comida Rapida,12500,3700,16200
3392,3393,21-10-2020 14:56:14.637510,Postres · Desayunos,Protein Bakes,10700,5900,16600
3393,3394,21-10-2020 14:56:15.002915,Desayunos · Jugos y Batidos,Kuriwaji,48750,6300,55050
3394,3395,21-10-2020 14:56:15.118240,Desayunos,Bagel Shop,15000,3200,18200
3395,3396,21-10-2020 14:56:15.233606,Saludable · Desayunos,La Estampilla,27800,6000,33800
3396,3397,21-10-2020 14:56:15.448946,Saludable · Desayunos,Maracuyá,15000,6700,21700
3397,3398,21-10-2020 14:56:15.714417,Italiana,F*cking Good Pizza,53400,4200,57600
3398,3399,21-10-2020 14:56:16.029742,Típica · Pescados y Mariscos,La Vitualla,17800,6300,24100
3399,3400,21-10-2020 14:56:16.145063,Desayunos · Típica,La Parrilla Dorada Polo,48750,6600,55350
3400,3401,21-10-2020 14:56:16.510537,Pizza,18 Scalini,15000,4300,19300
3401,3402,21-10-2020 14:56:16.675978,Postres · Desayunos,Restaurante Cornelia,8900,5500,14400
3402,3403,21-10-2020 14:56:16.991395,Postres · Café,Loló Coffee & Snacks,7500,4600,12100
3403,3404,21-10-2020 14:56:17.157899,Postres · Desayunos,BagBog Bagels,13600,6400,20000
3404,3405,21-10-2020 14:56:17.523398,Pollo · Desayunos,Workzone,27800,3100,30900
3405,3406,21-10-2020 14:56:17.839007,Desayunos · Típica,Criollomania,11870,5200,17070
3406,3407,21-10-2020 14:56:18.104378,Desayunos · Típica,Criollomania,13000,5200,18200
3407,3408,21-10-2020 14:56:18.269765,Sushi,Umi,24300,5600,29900
3408,3409,21-10-2020 14:56:18.434966,Internacional,La Esquina con Sabor Parrilla,24200,3000,27200
3409,3410,21-10-2020 14:56:18.550205,Peruana · Internacional,La Chifería,31800,6600,38400
3410,3411,21-10-2020 14:56:18.865628,Pollo · Desayunos,Abasto,34500,3600,38100
3411,3412,21-10-2020 14:56:19.180939,Pizza,18 Scalini,31800,4300,36100
3412,3413,21-10-2020 14:56:19.496200,Desayunos · Panadería,Artesanos,8900,4300,13200
3413,3414,21-10-2020 14:56:19.661668,Sánduches · China,Peru Mix,70000,5900,75900
3414,3415,21-10-2020 14:56:19.826887,Pescados y Mariscos,Pescadero Héroes del Mar,24300,6600,30900
3415,3416,21-10-2020 14:56:20.042264,Típica · Parrilla,La Parilla de David,10700,3100,13800
3416,3417,21-10-2020 14:56:20.407805,Pescados y Mariscos,Pescadero Héroes del Mar,23000,6600,29600
3417,3418,21-10-2020 14:56:20.673209,Mexicana,Cantina La 15,53900,4300,58200
3418,3419,21-10-2020 14:56:20.888360,Desayunos · Jugos y Batidos,Frutiwow,10700,4100,14800
3419,3420,21-10-2020 14:56:21.203929,Pescados y Mariscos,La Gran Cazuela,48750,3200,51950
3420,3421,21-10-2020 14:56:21.519489,Saludable,Hanai - Bowls Saludables,23000,5900,28900
3421,3422,21-10-2020 14:56:21.684887,Parrilla,Arepaisa de Medellín,23000,5600,28600
3422,3423,21-10-2020 14:56:22.050599,Parrilla · Café,Figaro Café/ Restaurante Argentino,11870,5800,17670
3423,3424,21-10-2020 14:56:22.217108,Típica · Pescados y Mariscos,La Vitualla,15000,6300,21300
3424,3425,21-10-2020 14:56:22.432541,Parrilla,Arroces Maria Paula,24200,6800,31000
3425,3426,21-10-2020 14:56:22.798102,Parrilla,Campocina,24200,4600,28800
3426,3427,21-10-2020 14:56:23.013482,Pollo · Saludable,Yerbabuena,15000,3900,18900
3427,3428,21-10-2020 14:56:23.328976,Pizza · Italiana,Pisapore - Pizza,23000,6600,29600
3428,3429,21-10-2020 14:56:23.644436,Postres · Desayunos,Restaurante Cornelia,35000,5500,40500
3429,3430,21-10-2020 14:56:23.909915,Desayunos · Panadería,Artesanos,13000,4300,17300
3430,3431,21-10-2020 14:56:24.075306,Desayunos,Bagel Shop,29500,3200,32700
3431,3432,21-10-2020 14:56:24.190694,Panadería,Boul,13000,3100,16100
3432,3433,21-10-2020 14:56:24.406120,Desayunos · Pescados y Mariscos,Gypsy Bistro,23000,4500,27500
3433,3434,21-10-2020 14:56:24.771758,Asiática,TeT,34500,5900,40400
3434,3435,21-10-2020 14:56:24.937224,Desayunos · Panadería,Limarys,13000,6500,19500
3435,3436,21-10-2020 14:56:25.252712,Desayunos · Comida Rápida,Chocolatto,65000,3400,68400
3436,3437,21-10-2020 14:56:25.518142,Parrilla,Arepaisa de Medellín,31800,5600,37400
3437,3438,21-10-2020 14:56:25.833764,Hamburguesas · Desayunos,El Inglés Gastro Pub,17800,6600,24400
3438,3439,21-10-2020 14:56:26.149231,Desayunos · Panadería,Limarys,23000,6500,29500
3439,3440,21-10-2020 14:56:26.514982,Pollo · Típica,Auyama,17800,3900,21700
3440,3441,21-10-2020 14:56:26.730463,Típica · Parrilla,Typykos,12500,6000,18500
3441,3442,21-10-2020 14:56:26.896051,Saludable · Típica,Sopas Mrg,15600,3100,18700
3442,3443,21-10-2020 14:56:27.111594,Peruana,Uma Cantina Peruana,15600,3200,18800
3443,3444,21-10-2020 14:56:27.228265,Mexicana,Mexicanachos,13600,3900,17500
3444,3445,21-10-2020 14:56:27.493885,Postres · Saludable,Ana Rebana,23000,6300,29300
3445,3446,21-10-2020 14:56:27.659396,Postres · Desayunos,Cosmo Cookies,18900,5900,24800
3446,3447,21-10-2020 14:56:27.924933,Peruana,Masivo,15000,5800,20800
3447,3448,21-10-2020 14:56:28.290576,Desayunos · Típica,Papadió - Colombianas,15000,5700,20700
3448,3449,21-10-2020 14:56:28.405994,Desayunos · Parrilla,Mi Patria,39700,4600,44300
3449,3450,21-10-2020 14:56:28.571472,Postres,Toledo Pastelería,31800,6800,38600
3450,3451,21-10-2020 14:56:28.787097,Pollo · Típica,Auyama,10700,3900,14600
3451,3452,21-10-2020 14:56:29.103029,Desayunos · Típica,Alce,23000,4900,27900
3452,3453,21-10-2020 14:56:29.368838,Hamburguesas · Saludable,Restaurant Inn,17800,6100,23900
3453,3454,21-10-2020 14:56:29.634351,Saludable,The Good Rice Bowls,35000,3500,38500
3454,3455,21-10-2020 14:56:29.899961,Parrilla,Arroces Maria Paula,13000,6800,19800
3455,3456,21-10-2020 14:56:30.265717,Alta Cocina · Parrilla,Criterión,27800,6000,33800
3456,3457,21-10-2020 14:56:30.431169,Desayunos · Café,Frambas,17800,3400,21200
3457,3458,21-10-2020 14:56:30.796731,Postres · Desayunos,Buñuelos nacho,65000,6600,71600
3458,3459,21-10-2020 14:56:31.112590,Pollo · Desayunos,Candelina,13600,5300,18900
3459,3460,21-10-2020 14:56:31.278026,Desayunos · Jugos y Batidos,Dont Be Hungry,9000,5600,14600
3460,3461,21-10-2020 14:56:31.543566,Desayunos · Panadería,Choclofee,27800,4700,32500
3461,3462,21-10-2020 14:56:31.759127,Parrilla · Café,Gaira Café,8900,4400,13300
3462,3463,21-10-2020 14:56:31.874433,Desayunos · Café,Matchacha,35000,5900,40900
3463,3464,21-10-2020 14:56:31.989578,Típica · Parrilla,Parrilla Farandula Gourmet,11870,5100,16970
3464,3465,21-10-2020 14:56:32.154698,Postres · Panadería,RIGHT AWAY FOODS,13600,6600,20200
3465,3466,21-10-2020 14:56:32.271023,Pizza · Italiana,Pisapore - Pizza,13000,6600,19600
3466,3467,21-10-2020 14:56:32.636736,Pollo · Desayunos,Caserito Gourmet,70000,6700,76700
3467,3468,21-10-2020 14:56:32.852604,Desayunos · Árabe,Boniato Sabores Vivos,7500,5300,12800
3468,3469,21-10-2020 14:56:33.218673,Desayunos · Típica,Alce,24300,4900,29200
3469,3470,21-10-2020 14:56:33.434323,Postres,La Galeta,17800,3000,20800
3470,3471,21-10-2020 14:56:33.800046,Saludable,The Good Rice Bowls,24300,3500,27800
3471,3472,21-10-2020 14:56:34.165805,Saludable · Parrilla,Box,53900,3700,57600
3472,3473,21-10-2020 14:56:34.281179,Hamburguesas,Monchis - Hamburguesa,35000,4300,39300
3473,3474,21-10-2020 14:56:34.496511,Postres · Desayunos,Jacques Pastelería,34500,5900,40400
3474,3475,21-10-2020 14:56:34.862301,Pollo · Saludable,Gratina,39700,4200,43900
3475,3476,21-10-2020 14:56:35.027704,Hamburguesas,Monchis - Hamburguesa,35000,4300,39300
3476,3477,21-10-2020 14:56:35.393300,Postres · Desayunos,Restaurante Cornelia,48750,5500,54250
3477,3478,21-10-2020 14:56:35.658876,Desayunos · Panadería,Decofruta,35000,4700,39700
3478,3479,21-10-2020 14:56:35.824223,Desayunos · Sánduches,Garnish,37900,5200,43100
3479,3480,21-10-2020 14:56:36.139954,Típica,Cazuelitas 93,9000,3900,12900
3480,3481,21-10-2020 14:56:36.305549,Hamburguesas,Bendito Cordero,29500,5800,35300
3481,3482,21-10-2020 14:56:36.570991,Pollo · Saludable,Gratina,15000,4200,19200
3482,3483,21-10-2020 14:56:36.836474,Sushi,Kim Pop,24200,5400,29600
3483,3484,21-10-2020 14:56:37.152192,Desayunos · Típica,La Frijolada,35000,4500,39500
3484,3485,21-10-2020 14:56:37.418795,Comida Rápida · Perros Calientes,Similoa - Comida Rapida,34500,3700,38200
3485,3486,21-10-2020 14:56:37.584310,Desayunos · Café,El Gualilo,37900,6200,44100
3486,3487,21-10-2020 14:56:37.899897,Postres · Café,Celestino Café,29500,5900,35400
3487,3488,21-10-2020 14:56:38.065585,Postres · Desayunos,Maltihelados,70000,6200,76200
3488,3489,21-10-2020 14:56:38.331073,Postres,Toledo Pastelería,8900,6800,15700
3489,3490,21-10-2020 14:56:38.596790,Típica,El Cucharón - Tipica,65000,4400,69400
3490,3491,21-10-2020 14:56:38.912718,Parrilla,OAK Ahumado y Brebajes,31800,6000,37800
3491,3492,21-10-2020 14:56:39.078421,Desayunos,Jacinta Arepas de Huevo,7500,4000,11500
3492,3493,21-10-2020 14:56:39.344284,Saludable · Desayunos,Agua Dulce,27800,3700,31500
3493,3494,21-10-2020 14:56:39.559916,Desayunos · Comida Rápida,Chocolatto,27800,3400,31200
3494,3495,21-10-2020 14:56:39.875673,Pollo,Heart & Cooking,23000,5000,28000
3495,3496,21-10-2020 14:56:40.091273,Saludable,Puro Verde,18900,5700,24600
3496,3497,21-10-2020 14:56:40.407562,Postres · Desayunos,Vivalight Market.,23000,6500,29500
3497,3498,21-10-2020 14:56:40.673583,Mexicana,Cantina La 15,53400,4300,57700
3498,3499,21-10-2020 14:56:41.039216,Postres · Desayunos,Buñuelos nacho,17800,6600,24400
3499,3500,21-10-2020 14:56:41.305021,Saludable,Amor Propio saludable,31800,4000,35800
3500,3501,21-10-2020 14:56:41.570644,Desayunos · Panadería,El Pan de Phillippe,48750,4600,53350
3501,3502,21-10-2020 14:56:41.736316,Hamburguesas,Monchis - Hamburguesa,39700,4300,44000
3502,3503,21-10-2020 14:56:42.002195,Desayunos,Don Leo,11870,6000,17870
3503,3504,21-10-2020 14:56:42.217876,Postres · Desayunos,Buñuelos nacho,29500,6600,36100
3504,3505,21-10-2020 14:56:42.484863,Desayunos,Fratelli - Desayunos,10700,4600,15300
3505,3506,21-10-2020 14:56:42.650858,Parrilla,Parrilla Pimentón,13000,3400,16400
3506,3507,21-10-2020 14:56:42.816464,Típica,La Cocina,35000,4600,39600
3507,3508,21-10-2020 14:56:43.132533,Típica · Parrilla,Typykos,15000,6000,21000
3508,3509,21-10-2020 14:56:43.248216,Típica,Juan Chorizo,53900,3900,57800
3509,3510,21-10-2020 14:56:43.514036,Pizza,pizza andante,35000,4200,39200
3510,3511,21-10-2020 14:56:43.829757,Desayunos · Típica,90 Calentados,12500,3700,16200
3511,3512,21-10-2020 14:56:44.095333,Pizza · Parrilla,Urban Lunch,39700,4000,43700
3512,3513,21-10-2020 14:56:44.360951,Parrilla,Carnes la Zarza,27800,4900,32700
3513,3514,21-10-2020 14:56:44.676588,Desayunos · Mexicana,La Mera Mera - Mexicana,13000,3100,16100
3514,3515,21-10-2020 14:56:44.992248,Desayunos,Bagel Shop,29500,3200,32700
3515,3516,21-10-2020 14:56:45.307945,Pollo · China,China Tao,35000,3500,38500
3516,3517,21-10-2020 14:56:45.423506,Pollo · Desayunos,Abasto,24300,3600,27900
3517,3518,21-10-2020 14:56:45.689317,Desayunos · Típica,La Parrilla Dorada Polo,45800,6600,52400
3518,3519,21-10-2020 14:56:46.055030,Pescados y Mariscos,Fish Place - Del Mar,35000,5400,40400
3519,3520,21-10-2020 14:56:46.320767,Desayunos · Pescados y Mariscos,Luzí­a - Mediterranea,24300,5700,30000
3520,3521,21-10-2020 14:56:46.486519,Pollo · China,China Tao,13600,3500,17100
3521,3522,21-10-2020 14:56:46.602338,Postres · Panadería,RIGHT AWAY FOODS,15600,6600,22200
3522,3523,21-10-2020 14:56:46.868241,Desayunos · Panadería,Limarys,11870,6500,18370
3523,3524,21-10-2020 14:56:47.033831,Desayunos,Don Leo,37900,6000,43900
3524,3525,21-10-2020 14:56:47.349582,Desayunos,Sr Buñuelo,34500,6400,40900
3525,3526,21-10-2020 14:56:47.666383,Saludable · Desayunos,Maracuyá,45800,6700,52500
3526,3527,21-10-2020 14:56:47.832017,Postres · Desayunos,Aury Postres - Comidas & Picadas,15000,4700,19700
3527,3528,21-10-2020 14:56:48.197839,Desayunos · Helados,San Giorgio Gelateria,35000,3100,38100
3528,3529,21-10-2020 14:56:48.413682,Típica,Cazuelitas 93,53900,3900,57800
3529,3530,21-10-2020 14:56:48.579290,Postres · Desayunos,BagBog Bagels,31800,6400,38200
3530,3531,21-10-2020 14:56:48.895224,Saludable · Jugos y Batidos,Berdes Drinks & Salads,18900,3500,22400
3531,3532,21-10-2020 14:56:49.010822,Desayunos · Panadería,Limarys,18900,6500,25400
3532,3533,21-10-2020 14:56:49.326680,Desayunos · Comida Rápida,La Veneca,45800,6300,52100
3533,3534,21-10-2020 14:56:49.592440,Desayunos · Café,vereda central calle 99,24300,5700,30000
3534,3535,21-10-2020 14:56:49.708277,Típica,Baondish,13600,5800,19400
3535,3536,21-10-2020 14:56:50.024166,Desayunos,Don Leo,15600,6000,21600
3536,3537,21-10-2020 14:56:50.239801,Sánduches · China,Peru Mix,70000,5900,75900
3537,3538,21-10-2020 14:56:50.455584,Desayunos · Sánduches,Garnish,23000,5200,28200
3538,3539,21-10-2020 14:56:50.771301,Pollo · China,China Tao,31800,3500,35300
3539,3540,21-10-2020 14:56:51.137386,Saludable · Desayunos,Libre de Culpa,10700,4000,14700
3540,3541,21-10-2020 14:56:51.253023,Parrilla,Beraca Parrilla Bbq,23000,5600,28600
3541,3542,21-10-2020 14:56:51.368775,Desayunos · Jugos y Batidos,Dont Be Hungry,15600,5600,21200
3542,3543,21-10-2020 14:56:51.484239,Pollo · Saludable,Gratina,65000,4200,69200
3543,3544,21-10-2020 14:56:51.650164,Hamburguesas · Pescados y Mariscos,El Velero,39700,6500,46200
3544,3545,21-10-2020 14:56:51.865717,Típica · Parrilla,La Parilla de David,15000,3100,18100
3545,3546,21-10-2020 14:56:52.081462,Desayunos · Panadería,Choclofee,70000,4700,74700
3546,3547,21-10-2020 14:56:52.246986,Alta Cocina · Postres,La Pinta,24200,4500,28700
3547,3548,21-10-2020 14:56:52.412788,Sánduches,Submarin,15000,3800,18800
3548,3549,21-10-2020 14:56:52.729554,Postres · Desayunos,Vivalight Market.,10700,6500,17200
3549,3550,21-10-2020 14:56:52.945468,Postres · Desayunos,Aury Postres - Comidas & Picadas,53900,4700,58600
3550,3551,21-10-2020 14:56:53.261322,Saludable · Jugos y Batidos,Berdes Drinks & Salads,53400,3500,56900
3551,3552,21-10-2020 14:56:53.377602,Postres · Desayunos,Amelie Helados,35000,6400,41400
3552,3553,21-10-2020 14:56:53.593383,Típica · Parrilla,La Ternera Parrilla,39700,5200,44900
3553,3554,21-10-2020 14:56:53.959376,Típica,Bendita S,15600,4600,20200
3554,3555,21-10-2020 14:56:54.175038,Pizza,18 Scalini,39700,4300,44000
3555,3556,21-10-2020 14:56:54.290755,Desayunos · Pescados y Mariscos,Luzí­a - Mediterranea,11870,5700,17570
3556,3557,21-10-2020 14:56:54.556286,Desayunos · Jugos y Batidos,Kuriwaji,23000,6300,29300
3557,3558,21-10-2020 14:56:54.772067,Desayunos,Cafetería el Kippe,15600,3200,18800
3558,3559,21-10-2020 14:56:54.987668,Desayunos · Café,Frambas,39700,3400,43100
3559,3560,21-10-2020 14:56:55.103328,Asiática,TeT,53900,5900,59800
3560,3561,21-10-2020 14:56:55.219176,Típica,Bandejas Mrg,39700,3800,43500
3561,3562,21-10-2020 14:56:55.435357,Postres · Café,Loló Coffee & Snacks,13600,4600,18200
3562,3563,21-10-2020 14:56:55.651040,Pollo,Oliva Va,15000,5600,20600
3563,3564,21-10-2020 14:56:55.967020,Desayunos · Café,Aromacafé el Placer de Compartir,7500,5000,12500
3564,3565,21-10-2020 14:56:56.182520,Parrilla · Internacional,Taperia de la Plaza,7500,5700,13200
3565,3566,21-10-2020 14:56:56.348417,Parrilla,Beraca Parrilla Bbq,65000,5600,70600
3566,3567,21-10-2020 14:56:56.614133,Saludable · Desayunos,La Cesta,29500,4700,34200
3567,3568,21-10-2020 14:56:56.930201,Desayunos · Típica,Parrilla Farandula Típico,23000,5900,28900
3568,3569,21-10-2020 14:56:57.195903,Sánduches · China,Peru Mix,13600,5900,19500
3569,3570,21-10-2020 14:56:57.562057,Parrilla,OAK Ahumado y Brebajes,35000,6000,41000
3570,3571,21-10-2020 14:56:57.828978,Hamburguesas,Burger Society,11870,4100,15970
3571,3572,21-10-2020 14:56:57.944921,Sánduches · Pescados y Mariscos,Pacific Comida de Mar,48750,4000,52750
3572,3573,21-10-2020 14:56:58.060423,Hamburguesas · Alitas,Beer,37900,6600,44500
3573,3574,21-10-2020 14:56:58.276235,Hamburguesas · Panadería,NYC Burgers,13600,6200,19800
3574,3575,21-10-2020 14:56:58.542209,Saludable · Jugos y Batidos,Berdes Drinks & Salads,29500,3500,33000
3575,3576,21-10-2020 14:56:58.908210,Saludable,Amor Propio saludable,23000,4000,27000
3576,3577,21-10-2020 14:56:59.023748,Helados,Buon Gelato,11870,4400,16270
3577,3578,21-10-2020 14:56:59.389775,Típica,La Cocina,8900,4600,13500
3578,3579,21-10-2020 14:56:59.555286,Desayunos · Café,Libertario Coffee Roasters,10700,4600,15300
3579,3580,21-10-2020 14:56:59.821400,Postres · Desayunos,Vivalight Market.,9000,6500,15500
3580,3581,21-10-2020 14:57:00.086992,Postres · Desayunos,BagBog Bagels,35000,6400,41400
3581,3582,21-10-2020 14:57:00.202802,Desayunos · Helados,San Giorgio Gelateria,12500,3100,15600
3582,3583,21-10-2020 14:57:00.468437,Pollo · Saludable,Yerbabuena,70000,3900,73900
3583,3584,21-10-2020 14:57:00.784687,Postres,Beiked,10700,4000,14700
3584,3585,21-10-2020 14:57:00.900389,Parrilla · Café,Gaira Café,35000,4400,39400
3585,3586,21-10-2020 14:57:01.266531,Pollo · Desayunos,Caserito Gourmet,8900,6700,15600
3586,3587,21-10-2020 14:57:01.632382,Sushi,Umi,70000,5600,75600
3587,3588,21-10-2020 14:57:01.848334,Típica,El Cucharón - Tipica,13600,4400,18000
3588,3589,21-10-2020 14:57:02.114115,Pollo · China,China Tao,53900,3500,57400
3589,3590,21-10-2020 14:57:02.380342,Poke,Poke Go,8900,4600,13500
3590,3591,21-10-2020 14:57:02.596522,Desayunos · Panadería,Choclofee,24200,4700,28900
3591,3592,21-10-2020 14:57:02.712484,Desayunos · Panadería,Limarys,39700,6500,46200
3592,3593,21-10-2020 14:57:02.879307,Pollo,Señor Fantástico,34500,4700,39200
3593,3594,21-10-2020 14:57:02.995248,Comida Rápida,Fiesta Digital Andrés,35000,3100,38100
3594,3595,21-10-2020 14:57:03.310882,Pollo · Desayunos,Caserito Gourmet,31800,6700,38500
3595,3596,21-10-2020 14:57:03.627069,Hamburguesas · Saludable,Restaurant Inn,35000,6100,41100
3596,3597,21-10-2020 14:57:03.742821,Desayunos,El Fogón Castellano,31800,3200,35000
3597,3598,21-10-2020 14:57:04.009026,Saludable,Hanai - Bowls Saludables,37900,5900,43800
3598,3599,21-10-2020 14:57:04.324927,Postres · Desayunos,Jacques Pastelería,8900,5900,14800
3599,3600,21-10-2020 14:57:04.540822,Desayunos · Café,El Gualilo,35000,6200,41200
3600,3601,21-10-2020 14:57:04.656375,Helados,Orso To Go,35000,6800,41800
3601,3602,21-10-2020 14:57:04.972571,Postres · Café,Celestino Café,15600,5900,21500
3602,3603,21-10-2020 14:57:05.138245,Típica,La Olla de Barro,27800,5300,33100
3603,3604,21-10-2020 14:57:05.254116,Desayunos · Café,El Gualilo,31800,6200,38000
3604,3605,21-10-2020 14:57:05.519882,Saludable,Ventura Soup y Salad,8900,3800,12700
3605,3606,21-10-2020 14:57:05.635786,Típica · Pescados y Mariscos,Arroces Mrg,11870,4300,16170
3606,3607,21-10-2020 14:57:06.001723,Postres · Desayunos,Sharmus,53400,6100,59500
3607,3608,21-10-2020 14:57:06.317872,Desayunos · Típica,Rojo Gourmet,15000,4700,19700
3608,3609,21-10-2020 14:57:06.433804,Alta Cocina · Italiana,Trattoria de la Plaza,27800,6000,33800
3609,3610,21-10-2020 14:57:06.700124,Saludable · Desayunos,Maracuyá,39700,6700,46400
3610,3611,21-10-2020 14:57:06.865912,China,China Food Col,23000,3600,26600
3611,3612,21-10-2020 14:57:07.081902,Café · Helados,Sofia heladería y café,29500,5800,35300
3612,3613,21-10-2020 14:57:07.247493,Pescados y Mariscos,Fish Place - Del Mar,48750,5400,54150
3613,3614,21-10-2020 14:57:07.414111,Desayunos · Café,Moramia,11870,4700,16570
3614,3615,21-10-2020 14:57:07.530279,Alta Cocina · Postres,La Pinta,27800,4500,32300
3615,3616,21-10-2020 14:57:07.846717,Típica,Carbón & Mondongos,23000,6400,29400
3616,3617,21-10-2020 14:57:08.113545,Italiana,F*cking Good Pizza,35000,4200,39200
3617,3618,21-10-2020 14:57:08.229820,Pizza,pizza andante,45800,4200,50000
3618,3619,21-10-2020 14:57:08.445802,Hamburguesas · Pescados y Mariscos,El Velero,27800,6500,34300
3619,3620,21-10-2020 14:57:08.712074,Desayunos · Típica,90 Calentados,13600,3700,17300
3620,3621,21-10-2020 14:57:08.928009,Saludable · Desayunos,Distrito Gourmet,7500,3700,11200
3621,3622,21-10-2020 14:57:09.094222,Desayunos · Café,Libertario Coffee Roasters,12500,4600,17100
3622,3623,21-10-2020 14:57:09.360291,Desayunos · Panadería,Choclofee,35000,4700,39700
3623,3624,21-10-2020 14:57:09.526459,Desayunos · Panadería,Siena Café,27800,3700,31500
3624,3625,21-10-2020 14:57:09.642389,Sushi,Sushi Reel,53900,4700,58600
3625,3626,21-10-2020 14:57:09.858576,Desayunos · Típica,90 Calentados,9000,3700,12700
3626,3627,21-10-2020 14:57:10.124634,Saludable · Desayunos,Fresh Co,29500,5600,35100
3627,3628,21-10-2020 14:57:10.491124,Desayunos · Café,Moramia,11870,4700,16570
3628,3629,21-10-2020 14:57:10.757099,Pollo,Señor Fantástico,37900,4700,42600
3629,3630,21-10-2020 14:57:11.023467,Sushi · Asiática,Tu Sushi,13600,6400,20000
3630,3631,21-10-2020 14:57:11.389675,Postres · Desayunos,Gelateria Da Favola,35000,6500,41500
3631,3632,21-10-2020 14:57:11.555809,Postres · Desayunos,Vivalight Market.,15600,6500,22100
3632,3633,21-10-2020 14:57:11.771805,Pizza,pizza andante,12500,4200,16700
3633,3634,21-10-2020 14:57:12.038135,Típica · Pescados y Mariscos,Arroces Mrg,34500,4300,38800
3634,3635,21-10-2020 14:57:12.204070,Saludable · Desayunos,Agua Dulce,15600,3700,19300
3635,3636,21-10-2020 14:57:12.370391,Desayunos · Típica,D´Porco,45800,3900,49700
3636,3637,21-10-2020 14:57:12.486285,Desayunos · Café,Matchacha,65000,5900,70900
3637,3638,21-10-2020 14:57:12.752553,Mexicana,Cantina La 15,35000,4300,39300
3638,3639,21-10-2020 14:57:12.868348,Pizza,pizza andante,13000,4200,17200
3639,3640,21-10-2020 14:57:13.084482,Saludable · Parrilla,Box,24300,3700,28000
3640,3641,21-10-2020 14:57:13.251589,Postres,Toledo Pastelería,23000,6800,29800
3641,3642,21-10-2020 14:57:13.468278,Jugos y Batidos,Pomponio,23000,3600,26600
3642,3643,21-10-2020 14:57:13.734330,Postres · Panadería,RIGHT AWAY FOODS,35000,6600,41600
3643,3644,21-10-2020 14:57:13.900564,Poke,Poke Go,29500,4600,34100
3644,3645,21-10-2020 14:57:14.166628,Pollo · Desayunos,Abasto,12500,3600,16100
3645,3646,21-10-2020 14:57:14.532945,Desayunos · Comida Rápida,La Veneca,18900,6300,25200
3646,3647,21-10-2020 14:57:14.899172,Pizza,pizza andante,13600,4200,17800
3647,3648,21-10-2020 14:57:15.015669,Desayunos · Panadería,Siena Café,27800,3700,31500
3648,3649,21-10-2020 14:57:15.281948,Desayunos · Café,Matchacha,27800,5900,33700
3649,3650,21-10-2020 14:57:15.498064,Saludable · Desayunos,Raices Bienestar Gourmet,9000,6600,15600
3650,3651,21-10-2020 14:57:15.714178,Desayunos · Helados,San Giorgio Gelateria,12500,3100,15600
3651,3652,21-10-2020 14:57:16.080652,Postres · Desayunos,Protein Bakes,53400,5900,59300
3652,3653,21-10-2020 14:57:16.397083,Postres · Desayunos,BagBog Bagels,24300,6400,30700
3653,3654,21-10-2020 14:57:16.563367,Desayunos · Jugos y Batidos,Frutiwow,35000,4100,39100
3654,3655,21-10-2020 14:57:16.779508,Postres · Desayunos,BagBog Bagels,35000,6400,41400
3655,3656,21-10-2020 14:57:17.146388,Parrilla · Café,Gaira Café,27800,4400,32200
3656,3657,21-10-2020 14:57:17.462600,Típica · Parrilla,Toya,65000,4200,69200
3657,3658,21-10-2020 14:57:17.679084,Saludable · Desayunos,Guadalupe - Fruteria,53400,5900,59300
3658,3659,21-10-2020 14:57:17.945357,Sánduches,Submarin,70000,3800,73800
3659,3660,21-10-2020 14:57:18.211751,Jugos y Batidos,Pomponio,31800,3600,35400
3660,3661,21-10-2020 14:57:18.478762,Saludable,Ventura Soup y Salad,65000,3800,68800
3661,3662,21-10-2020 14:57:18.594956,Postres · Desayunos,Jacques Pastelería,70000,5900,75900
3662,3663,21-10-2020 14:57:18.860911,Desayunos · Árabe,Boniato Sabores Vivos,10700,5300,16000
3663,3664,21-10-2020 14:57:19.127228,Desayunos · Panadería,Decofruta,37900,4700,42600
3664,3665,21-10-2020 14:57:19.393221,Típica,Bandejas Mrg,29500,3800,33300
3665,3666,21-10-2020 14:57:19.659506,Parrilla,Campocina,24300,4600,28900
3666,3667,21-10-2020 14:57:19.875478,Típica,La Cocina,31800,4600,36400
3667,3668,21-10-2020 14:57:19.991588,Desayunos · Café,Aromacafé el Placer de Compartir,53400,5000,58400
3668,3669,21-10-2020 14:57:20.357692,Desayunos · Típica,Papadió - Colombianas,8900,5700,14600
3669,3670,21-10-2020 14:57:20.673970,Parrilla,Arroces Maria Paula,37900,6800,44700
3670,3671,21-10-2020 14:57:20.939966,Desayunos · Comida Rápida,Chocolatto,70000,3400,73400
3671,3672,21-10-2020 14:57:21.056050,Saludable · Desayunos,Copacabana Açai Bowls,45800,3000,48800
3672,3673,21-10-2020 14:57:21.371976,Internacional,La Esquina con Sabor Parrilla,53900,3000,56900
3673,3674,21-10-2020 14:57:21.688338,Desayunos · Típica,La Frijolada,27800,4500,32300
3674,3675,21-10-2020 14:57:22.004446,Parrilla · Internacional,Taperia de la Plaza,15600,5700,21300
3675,3676,21-10-2020 14:57:22.120679,Sushi,Kim Pop,37900,5400,43300
3676,3677,21-10-2020 14:57:22.486856,Helados,Buon Gelato,7500,4400,11900
3677,3678,21-10-2020 14:57:22.753082,Típica · Parrilla,Mi Ranchito Parrilla,15600,4400,20000
3678,3679,21-10-2020 14:57:23.069352,Típica · Parrilla,La Parilla de David,13600,3100,16700
3679,3680,21-10-2020 14:57:23.185402,Crepes,San Crepes,53900,4900,58800
3680,3681,21-10-2020 14:57:23.401414,Postres,La Galeta,34500,3000,37500
3681,3682,21-10-2020 14:57:23.518641,Típica · Parrilla,Typykos,9000,6000,15000
3682,3683,21-10-2020 14:57:23.634539,Desayunos · Típica,Calentao Express,8900,6000,14900
3683,3684,21-10-2020 14:57:24.000923,Postres · Café,Celestino Café,18900,5900,24800
3684,3685,21-10-2020 14:57:24.367064,Típica · Pescados y Mariscos,La Vitualla,18900,6300,25200
3685,3686,21-10-2020 14:57:24.683445,Mexicana,Mexicanachos,35000,3900,38900
3686,3687,21-10-2020 14:57:24.899407,Desayunos · Café,Aromacafé el Placer de Compartir,48750,5000,53750
3687,3688,21-10-2020 14:57:25.165806,Típica,El Mondongo y Mucho Mas,9000,5600,14600
3688,3689,21-10-2020 14:57:25.281693,Mexicana,La leyenda mexican kitchen,13000,3200,16200
3689,3690,21-10-2020 14:57:25.447883,Postres · Helados,Mahé,45800,6000,51800
3690,3691,21-10-2020 14:57:25.714027,Desayunos · Café,Moramia,27800,4700,32500
3691,3692,21-10-2020 14:57:26.080442,Desayunos · Sánduches,Danilo Colombia,13000,3300,16300
3692,3693,21-10-2020 14:57:26.296364,Parrilla,Arroces Maria Paula,65000,6800,71800
3693,3694,21-10-2020 14:57:26.562599,Típica · Pescados y Mariscos,La Vitualla,53900,6300,60200
3694,3695,21-10-2020 14:57:26.778472,Postres · Desayunos,Cosmo Cookies,15000,5900,20900
3695,3696,21-10-2020 14:57:26.944653,Saludable · Parrilla,The Angels Grill and Drinks,35000,6200,41200
3696,3697,21-10-2020 14:57:27.060485,Desayunos · Típica,Papadió - Colombianas,15000,5700,20700
3697,3698,21-10-2020 14:57:27.276644,Desayunos · Árabe,Boniato Sabores Vivos,13000,5300,18300
3698,3699,21-10-2020 14:57:27.642792,Desayunos · Pescados y Mariscos,Gypsy Bistro,70000,4500,74500
3699,3700,21-10-2020 14:57:27.809021,Parrilla,Campocina,35000,4600,39600
3700,3701,21-10-2020 14:57:27.924902,Desayunos · Árabe,Boniato Sabores Vivos,13000,5300,18300
3701,3702,21-10-2020 14:57:28.191151,Desayunos · Comida Rápida,La Veneca,11870,6300,18170
3702,3703,21-10-2020 14:57:28.507393,Postres · Desayunos,Gelateria Da Favola,24200,6500,30700
3703,3704,21-10-2020 14:57:28.624773,Desayunos · Helados,San Giorgio Gelateria,31800,3100,34900
3704,3705,21-10-2020 14:57:28.740740,Mexicana,Hidalgo Taquería,17800,4900,22700
3705,3706,21-10-2020 14:57:29.056987,Pollo · Desayunos,Abasto,31800,3600,35400
3706,3707,21-10-2020 14:57:29.222912,Desayunos · Panadería,Le Pain Quotidien,35000,3900,38900
3707,3708,21-10-2020 14:57:29.539310,Desayunos · Comida Rápida,Chocolatto,10700,3400,14100
3708,3709,21-10-2020 14:57:29.755539,Desayunos,Sr Buñuelo,39700,6400,46100
3709,3710,21-10-2020 14:57:30.122281,Desayunos · Típica,Parrilla Farandula Típico,35000,5900,40900
3710,3711,21-10-2020 14:57:30.338198,Desayunos · Café,El Gualilo,31800,6200,38000
3711,3712,21-10-2020 14:57:30.654537,Desayunos · Típica,La Parrilla Dorada Polo,65000,6600,71600
3712,3713,21-10-2020 14:57:30.920715,Desayunos · Café,Libertario Coffee Roasters,27800,4600,32400
3713,3714,21-10-2020 14:57:31.237096,Desayunos · Típica,La Parrilla Dorada Polo,53900,6600,60500
3714,3715,21-10-2020 14:57:31.353050,Mexicana,La leyenda mexican kitchen,24300,3200,27500
3715,3716,21-10-2020 14:57:31.719498,Pollo · China,China Tao,31800,3500,35300
3716,3717,21-10-2020 14:57:32.035795,Típica,El Mondongo y Mucho Mas,70000,5600,75600
3717,3718,21-10-2020 14:57:32.252042,Postres · Desayunos,La Folie - Postres,24200,3300,27500
3718,3719,21-10-2020 14:57:32.518450,Típica,Sabores De Mi Tierra,23000,5400,28400
3719,3720,21-10-2020 14:57:32.834989,Hamburguesas · Panadería,NYC Burgers,7500,6200,13700
3720,3721,21-10-2020 14:57:32.951117,Postres · Panadería,RIGHT AWAY FOODS,12500,6600,19100
3721,3722,21-10-2020 14:57:33.317564,Hamburguesas,Bendito Cordero,37900,5800,43700
3722,3723,21-10-2020 14:57:33.483524,Internacional,Rio Sabores y Experiencias,24200,4100,28300
3723,3724,21-10-2020 14:57:33.851292,Postres · Desayunos,Maltihelado,65000,4500,69500
3724,3725,21-10-2020 14:57:34.068033,Desayunos · Sánduches,Garnish,13600,5200,18800
3725,3726,21-10-2020 14:57:34.184275,China,China Food Col,11870,3600,15470
3726,3727,21-10-2020 14:57:34.550521,Saludable,Puro Verde,37900,5700,43600
3727,3728,21-10-2020 14:57:34.716920,Peruana,Masivo,13600,5800,19400
3728,3729,21-10-2020 14:57:35.083179,Hamburguesas · Desayunos,El Inglés Gastro Pub,15600,6600,22200
3729,3730,21-10-2020 14:57:35.449887,Postres · Desayunos,Protein Bakes,11870,5900,17770
3730,3731,21-10-2020 14:57:35.716088,Desayunos · Panadería,Pasteleite,9000,5900,14900
3731,3732,21-10-2020 14:57:35.982582,Típica,La Herencia,45800,5900,51700
3732,3733,21-10-2020 14:57:36.348732,Saludable,Ventura Soup y Salad,45800,3800,49600
3733,3734,21-10-2020 14:57:36.665115,Saludable · Desayunos,Guadalupe - Fruteria,13000,5900,18900
3734,3735,21-10-2020 14:57:36.831065,Desayunos · Típica,Papadió - Colombianas,11870,5700,17570
3735,3736,21-10-2020 14:57:37.097514,Pizza,18 Scalini,37900,4300,42200
3736,3737,21-10-2020 14:57:37.363587,Sushi · Desayunos,Maki Roll,27800,4300,32100
3737,3738,21-10-2020 14:57:37.479806,Pollo,Oliva Va,15000,5600,20600
3738,3739,21-10-2020 14:57:37.696112,Desayunos · Café,Aromacafé el Placer de Compartir,24300,5000,29300
3739,3740,21-10-2020 14:57:37.912439,Saludable,Puro Verde,23000,5700,28700
3740,3741,21-10-2020 14:57:38.128657,Parrilla,El Tambor,10700,6800,17500
3741,3742,21-10-2020 14:57:38.245242,Desayunos · Italiana,Rceta By Rausch,29500,3600,33100
3742,3743,21-10-2020 14:57:38.561511,Pollo,Oliva Va,37900,5600,43500
3743,3744,21-10-2020 14:57:38.929300,Pollo · Saludable,Tremenda Sal y Dulce,18900,6500,25400
3744,3745,21-10-2020 14:57:39.245607,Desayunos · Jugos y Batidos,Frutiwow,35000,4100,39100
3745,3746,21-10-2020 14:57:39.562244,Pollo · Sánduches,Pollos Century,15600,3000,18600
3746,3747,21-10-2020 14:57:39.828551,Saludable · Desayunos,Raices Bienestar Gourmet,10700,6600,17300
3747,3748,21-10-2020 14:57:39.994764,Helados,Buon Gelato,48750,4400,53150
3748,3749,21-10-2020 14:57:40.210962,Típica · Parrilla,Mi Ranchito Parrilla,34500,4400,38900
3749,3750,21-10-2020 14:57:40.377416,Pescados y Mariscos,Fish Place - Del Mar,35000,5400,40400
3750,3751,21-10-2020 14:57:40.743812,Sushi,Umi,23000,5600,28600
3751,3752,21-10-2020 14:57:40.910415,Parrilla,Arroces Maria Paula,7500,6800,14300
3752,3753,21-10-2020 14:57:41.026566,Jugos y Batidos,Pomponio,70000,3600,73600
3753,3754,21-10-2020 14:57:41.143033,Comida Rápida,Fiesta Digital Andrés,31800,3100,34900
3754,3755,21-10-2020 14:57:41.359218,Desayunos · Jugos y Batidos,Kuriwaji,70000,6300,76300
3755,3756,21-10-2020 14:57:41.475680,Desayunos,Fratelli - Desayunos,53900,4600,58500
3756,3757,21-10-2020 14:57:41.691969,Café · Helados,Sofia heladería y café,18900,5800,24700
3757,3758,21-10-2020 14:57:42.008889,Postres · Café,Loló Coffee & Snacks,13600,4600,18200
3758,3759,21-10-2020 14:57:42.375670,Desayunos · Café,vereda central calle 99,7500,5700,13200
3759,3760,21-10-2020 14:57:42.542867,Postres · Desayunos,Buñuelos nacho,29500,6600,36100
3760,3761,21-10-2020 14:57:42.859713,Desayunos · Típica,Calentao Express,70000,6000,76000
3761,3762,21-10-2020 14:57:43.226990,Típica,La Olla de Barro,35000,5300,40300
3762,3763,21-10-2020 14:57:43.544032,Postres · Helados,Mahé,7500,6000,13500
3763,3764,21-10-2020 14:57:43.911611,Saludable · Típica,Sopas Mrg,31800,3100,34900
3764,3765,21-10-2020 14:57:44.278654,Desayunos · Típica,90 Calentados,13600,3700,17300
3765,3766,21-10-2020 14:57:44.645857,Desayunos,Señor Desayuno,45800,6800,52600
3766,3767,21-10-2020 14:57:44.962545,Típica,Sabores De Mi Tierra,12500,5400,17900
3767,3768,21-10-2020 14:57:45.229570,Desayunos · Típica,Rojo Gourmet,27800,4700,32500
3768,3769,21-10-2020 14:57:45.596228,Saludable · Desayunos,Básico y elemental,35000,5000,40000
3769,3770,21-10-2020 14:57:45.863576,Típica,Lo Nuestro,18900,3100,22000
3770,3771,21-10-2020 14:57:46.131209,Sushi,Umi,12500,5600,18100
3771,3772,21-10-2020 14:57:46.347414,Saludable · Desayunos,Re.al Alimentos Reales,70000,4000,74000
3772,3773,21-10-2020 14:57:46.464257,Café · Helados,Sofia heladería y café,7500,5800,13300
3773,3774,21-10-2020 14:57:46.630446,Saludable · Jugos y Batidos,Berdes Drinks & Salads,39700,3500,43200
3774,3775,21-10-2020 14:57:46.747321,Saludable · Desayunos,Agua Dulce,31800,3700,35500
3775,3776,21-10-2020 14:57:47.013582,Postres · Desayunos,Jacques Pastelería,15600,5900,21500
3776,3777,21-10-2020 14:57:47.330439,Sushi · Desayunos,Maki Roll,29500,4300,33800
3777,3778,21-10-2020 14:57:47.596491,Hamburguesas · Saludable,Restaurant Inn,35000,6100,41100
3778,3779,21-10-2020 14:57:47.912647,Desayunos · Típica,Criollomania,48750,5200,53950
3779,3780,21-10-2020 14:57:48.278759,Típica,La Olla de Barro,53900,5300,59200
3780,3781,21-10-2020 14:57:48.444943,Alta Cocina · Parrilla,Criterión,23000,6000,29000
3781,3782,21-10-2020 14:57:48.560823,Postres · Desayunos,Maltihelados,29500,6200,35700
3782,3783,21-10-2020 14:57:48.927075,Típica,La Olla de Barro,70000,5300,75300
3783,3784,21-10-2020 14:57:49.243197,Parrilla · Café,Figaro Café/ Restaurante Argentino,15600,5800,21400
3784,3785,21-10-2020 14:57:49.560671,Desayunos · Café,Moramia,13000,4700,17700
3785,3786,21-10-2020 14:57:49.827013,Típica,Lo Nuestro,35000,3100,38100
3786,3787,21-10-2020 14:57:50.143245,Saludable · Desayunos,Básico y Elemental,17800,5900,23700
3787,3788,21-10-2020 14:57:50.509618,Postres,Levelma,13000,6200,19200
3788,3789,21-10-2020 14:57:50.725576,Típica · Parrilla,Typykos,23000,6000,29000
3789,3790,21-10-2020 14:57:50.991653,Típica,Salsig,13000,5600,18600
3790,3791,21-10-2020 14:57:51.357845,Parrilla,Coquitas,12500,5600,18100
3791,3792,21-10-2020 14:57:51.473859,Desayunos · Panadería,Juliana Restaurante,10700,6100,16800
3792,3793,21-10-2020 14:57:51.640040,Saludable · Desayunos,La Estampilla,37900,6000,43900
3793,3794,21-10-2020 14:57:51.956289,Saludable · Desayunos,Fresh Co,23000,5600,28600
3794,3795,21-10-2020 14:57:52.172425,Pollo · Pescados y Mariscos,Bang Bang Rice,70000,3400,73400
3795,3796,21-10-2020 14:57:52.338310,Típica,Campo Victoria,48750,3000,51750
3796,3797,21-10-2020 14:57:52.554504,Típica,Carbón & Mondongos,45800,6400,52200
3797,3798,21-10-2020 14:57:52.670430,Hamburguesas,Bendito Cordero,10700,5800,16500
3798,3799,21-10-2020 14:57:52.886405,Desayunos · Panadería,Juliana Restaurante,53900,6100,60000
3799,3800,21-10-2020 14:57:53.252798,Típica · Parrilla,Parrilla Farandula Gourmet,48750,5100,53850
3800,3801,21-10-2020 14:57:53.368912,Desayunos,Bagel Shop,70000,3200,73200
3801,3802,21-10-2020 14:57:53.534958,Postres · Desayunos,Café Quindio,8900,5700,14600
3802,3803,21-10-2020 14:57:53.801344,Pollo,Señor Fantástico,8900,4700,13600
3803,3804,21-10-2020 14:57:53.967427,Típica · Parrilla,Toya,37900,4200,42100
3804,3805,21-10-2020 14:57:54.283807,Desayunos · Típica,90 Calentados,12500,3700,16200
3805,3806,21-10-2020 14:57:54.399687,Desayunos · Panadería,Juliana Restaurante,35000,6100,41100
3806,3807,21-10-2020 14:57:54.566883,Crepes,San Crepes,24200,4900,29100
3807,3808,21-10-2020 14:57:54.732794,Desayunos · Italiana,Rceta By Rausch,17800,3600,21400
3808,3809,21-10-2020 14:57:54.998791,Desayunos · Café,Frambas,24200,3400,27600
3809,3810,21-10-2020 14:57:55.114849,Típica · Pescados y Mariscos,Arroces Mrg,15600,4300,19900
3810,3811,21-10-2020 14:57:55.281070,Saludable,MIMA,70000,3700,73700
3811,3812,21-10-2020 14:57:55.647219,Típica,Lo Nuestro,23000,3100,26100
3812,3813,21-10-2020 14:57:55.863242,Típica · Parrilla,Typykos,39700,6000,45700
3813,3814,21-10-2020 14:57:56.229526,Desayunos,Cafetería el Kippe,39700,3200,42900
3814,3815,21-10-2020 14:57:56.595775,Desayunos · Típica,Fogón Sangileño,12500,5000,17500
3815,3816,21-10-2020 14:57:56.811788,Postres · Desayunos,Café Quindio,15600,5700,21300
3816,3817,21-10-2020 14:57:56.927781,Crepes,San Crepes,39700,4900,44600
3817,3818,21-10-2020 14:57:57.043752,Desayunos · Típica,Papadió - Colombianas,39700,5700,45400
3818,3819,21-10-2020 14:57:57.410067,Desayunos · Típica,Rojo Gourmet,35000,4700,39700
3819,3820,21-10-2020 14:57:57.776370,Italiana,Bocatto Di Passo,18900,5000,23900
3820,3821,21-10-2020 14:57:57.892520,Típica,Sabrosito,35000,4000,39000
3821,3822,21-10-2020 14:57:58.058576,Pollo · Desayunos,Caserito Gourmet,31800,6700,38500
3822,3823,21-10-2020 14:57:58.424864,Desayunos · Típica,Calentao Express,7500,6000,13500
3823,3824,21-10-2020 14:57:58.590994,Típica,Lo Nuestro,48750,3100,51850
3824,3825,21-10-2020 14:57:58.757061,Desayunos · Panadería,Santa Juana Food Bar,24300,5900,30200
3825,3826,21-10-2020 14:57:58.872914,Parrilla,Arroces Maria Paula,13600,6800,20400
3826,3827,21-10-2020 14:57:59.038840,Típica,Salsig,34500,5600,40100
3827,3828,21-10-2020 14:57:59.355001,Pescados y Mariscos,Fish Place - Del Mar,13600,5400,19000
3828,3829,21-10-2020 14:57:59.572456,Pizza,Pastas Laurentina,27800,4800,32600
3829,3830,21-10-2020 14:57:59.838669,Panadería,Boul,7500,3100,10600
3830,3831,21-10-2020 14:58:00.154865,Parrilla,Rústico Picadería,10700,3800,14500
3831,3832,21-10-2020 14:58:00.471014,Desayunos · Panadería,Ficchi Panadería,53400,3100,56500
3832,3833,21-10-2020 14:58:00.737351,Desayunos · Café,Moramia,35000,4700,39700
3833,3834,21-10-2020 14:58:01.053856,Saludable · Parrilla,The Angels Grill and Drinks,7500,6200,13700
3834,3835,21-10-2020 14:58:01.320200,Sánduches · China,Peru Mix,48750,5900,54650
3835,3836,21-10-2020 14:58:01.536523,Postres · Desayunos,Gelateria Da Favola,70000,6500,76500
3836,3837,21-10-2020 14:58:01.652665,Desayunos · Típica,Rojo Gourmet,29500,4700,34200
3837,3838,21-10-2020 14:58:02.019245,Postres,Toledo Pastelería,45800,6800,52600
3838,3839,21-10-2020 14:58:02.285562,Típica · Parrilla,El Santandereano,39700,5200,44900
3839,3840,21-10-2020 14:58:02.602093,Desayunos · Panadería,Limarys,24200,6500,30700
3840,3841,21-10-2020 14:58:02.968926,Parrilla,Rústico Picadería,10700,3800,14500
3841,3842,21-10-2020 14:58:03.235454,Mexicana,Mexicanachos,17800,3900,21700
3842,3843,21-10-2020 14:58:03.602722,Postres,Levelma,70000,6200,76200
3843,3844,21-10-2020 14:58:03.969532,Desayunos,El Fogón Castellano,24300,3200,27500
3844,3845,21-10-2020 14:58:04.085674,Típica,Bendita S,45800,4600,50400
3845,3846,21-10-2020 14:58:04.201827,Postres · Desayunos,Maltihelados,35000,6200,41200
3846,3847,21-10-2020 14:58:04.317974,Pollo · Desayunos,Workzone,24200,3100,27300
3847,3848,21-10-2020 14:58:04.434168,Postres · Helados,Mahé,39700,6000,45700
3848,3849,21-10-2020 14:58:04.550375,Jugos y Batidos,Pomponio,70000,3600,73600
3849,3850,21-10-2020 14:58:04.867851,Postres · Desayunos,Maltihelado,31800,4500,36300
3850,3851,21-10-2020 14:58:04.984229,Mexicana,La leyenda mexican kitchen,48750,3200,51950
3851,3852,21-10-2020 14:58:05.100686,Saludable · Desayunos,Libre de Culpa,10700,4000,14700
3852,3853,21-10-2020 14:58:05.317056,Típica,Sopitas y Más,17800,4200,22000
3853,3854,21-10-2020 14:58:05.583343,Pizza,18 Scalini,18900,4300,23200
3854,3855,21-10-2020 14:58:05.949863,Italiana,F*cking Good Pizza,53400,4200,57600
3855,3856,21-10-2020 14:58:06.066141,Parrilla,El Tambor,39700,6800,46500
3856,3857,21-10-2020 14:58:06.332452,Típica,Bandejas Mrg,24200,3800,28000
3857,3858,21-10-2020 14:58:06.498661,Pollo · Desayunos,Caserito Gourmet,15000,6700,21700
3858,3859,21-10-2020 14:58:06.865188,Parrilla,Carnes la Zarza,11870,4900,16770
3859,3860,21-10-2020 14:58:07.231436,Saludable · Desayunos,Malú,35000,3700,38700
3860,3861,21-10-2020 14:58:07.347767,Italiana,Bocatto Di Passo,7500,5000,12500
3861,3862,21-10-2020 14:58:07.564009,Típica · Parrilla,Typykos,45800,6000,51800
3862,3863,21-10-2020 14:58:07.830350,Sushi,Umi,7500,5600,13100
3863,3864,21-10-2020 14:58:07.996456,Hamburguesas,Burger Society,53900,4100,58000
3864,3865,21-10-2020 14:58:08.263019,Saludable · Desayunos,La Estampilla,53400,6000,59400
3865,3866,21-10-2020 14:58:08.579829,Hamburguesas · Alitas,Beer,70000,6600,76600
3866,3867,21-10-2020 14:58:08.896122,Sushi,Kim Pop,9000,5400,14400
3867,3868,21-10-2020 14:58:09.262571,Desayunos · Comida Rápida,Chocolatto,65000,3400,68400
3868,3869,21-10-2020 14:58:09.378926,Postres · Desayunos,KOKOA & co.,37900,4700,42600
3869,3870,21-10-2020 14:58:09.695288,Desayunos · Típica,Casa Vieja,29500,6000,35500
3870,3871,21-10-2020 14:58:09.912785,Desayunos · Panadería,Decofruta,31800,4700,36500
3871,3872,21-10-2020 14:58:10.279417,Típica · Parrilla,La Ternera Parrilla,24300,5200,29500
3872,3873,21-10-2020 14:58:10.445788,Desayunos · Jugos y Batidos,Dont Be Hungry,23000,5600,28600
3873,3874,21-10-2020 14:58:10.561876,Desayunos · Panadería,Pasteleite,24200,5900,30100
3874,3875,21-10-2020 14:58:10.828249,Postres,Beiked,39700,4000,43700
3875,3876,21-10-2020 14:58:11.094561,Parrilla,Arroces Maria Paula,13600,6800,20400
3876,3877,21-10-2020 14:58:11.211256,Desayunos · Internacional,Camilia,23000,3900,26900
3877,3878,21-10-2020 14:58:11.327454,Saludable · Desayunos,Copacabana Açai Bowls,24300,3000,27300
3878,3879,21-10-2020 14:58:11.443741,Desayunos · Café,Aromacafé el Placer de Compartir,13600,5000,18600
3879,3880,21-10-2020 14:58:11.710056,Hamburguesas · Desayunos,El Inglés Gastro Pub,31800,6600,38400
3880,3881,21-10-2020 14:58:11.826198,Pollo,Heart & Cooking,39700,5000,44700
3881,3882,21-10-2020 14:58:12.192556,Saludable · Desayunos,Bon Eat - Saludable,53900,4800,58700
3882,3883,21-10-2020 14:58:12.458958,Desayunos · Panadería,Premium Break Bakery,39700,3700,43400
3883,3884,21-10-2020 14:58:12.825550,Desayunos · Panadería,Limarys,24300,6500,30800
3884,3885,21-10-2020 14:58:13.142074,Desayunos,El Corral - Desayunos,10700,5000,15700
3885,3886,21-10-2020 14:58:13.508453,Internacional,La Esquina con Sabor Parrilla,7500,3000,10500
3886,3887,21-10-2020 14:58:13.824970,Postres · Café,Loló Coffee & Snacks,27800,4600,32400
3887,3888,21-10-2020 14:58:14.141381,Típica,Salsig,31800,5600,37400
3888,3889,21-10-2020 14:58:14.257457,Típica · Parrilla,La Parilla de David,65000,3100,68100
3889,3890,21-10-2020 14:58:14.423686,Postres · Desayunos,Maria Luisa - Postres,12500,4300,16800
3890,3891,21-10-2020 14:58:14.690234,Saludable · Desayunos,Raices Bienestar Gourmet,27800,6600,34400
3891,3892,21-10-2020 14:58:14.906584,Saludable · Desayunos,Libre de Culpa,53900,4000,57900
3892,3893,21-10-2020 14:58:15.023791,Desayunos · Típica,La Parrilla Dorada Polo,29500,6600,36100
3893,3894,21-10-2020 14:58:15.340172,Poke,Poke Go,53400,4600,58000
3894,3895,21-10-2020 14:58:15.606621,Mexicana,La leyenda mexican kitchen,39700,3200,42900
3895,3896,21-10-2020 14:58:15.872902,Pizza,pizza andante,18900,4200,23100
3896,3897,21-10-2020 14:58:16.139256,Desayunos · Café,Norma's Ice Cream Café,34500,6300,40800
3897,3898,21-10-2020 14:58:16.505942,Saludable · Desayunos,Malú,27800,3700,31500
3898,3899,21-10-2020 14:58:16.672322,Desayunos,Don Leo,34500,6000,40500
3899,3900,21-10-2020 14:58:16.988947,Típica,El Cucharón - Tipica,35000,4400,39400
3900,3901,21-10-2020 14:58:17.355454,Pollo · Desayunos,Workzone,10700,3100,13800
3901,3902,21-10-2020 14:58:17.471784,Desayunos · Café,Aromacafé el Placer de Compartir,53900,5000,58900
3902,3903,21-10-2020 14:58:17.738444,Hamburguesas · Panadería,NYC Burgers,35000,6200,41200
3903,3904,21-10-2020 14:58:18.004799,Saludable · Desayunos,Distrito Gourmet,12500,3700,16200
3904,3905,21-10-2020 14:58:18.171086,Saludable · Desayunos,Bawana - Sandwich,9000,3400,12400
3905,3906,21-10-2020 14:58:18.387536,Postres · Desayunos,Protein Bakes,48750,5900,54650
3906,3907,21-10-2020 14:58:18.553833,Desayunos,El Corral - Desayunos,12500,5000,17500
3907,3908,21-10-2020 14:58:18.920264,Pollo,Señor Fantástico,13000,4700,17700
3908,3909,21-10-2020 14:58:19.136610,Típica · Parrilla,El Santandereano,53900,5200,59100
3909,3910,21-10-2020 14:58:19.352950,Helados,Buon Gelato,53400,4400,57800
3910,3911,21-10-2020 14:58:19.619209,Parrilla,Parrilla Pimentón,53900,3400,57300
3911,3912,21-10-2020 14:58:19.935578,Mexicana,La leyenda mexican kitchen,12500,3200,15700
3912,3913,21-10-2020 14:58:20.052806,Mexicana,La leyenda mexican kitchen,17800,3200,21000
3913,3914,21-10-2020 14:58:20.169160,Desayunos · Café,El Gualilo,48750,6200,54950
3914,3915,21-10-2020 14:58:20.535469,Desayunos · Típica,Cochon,34500,3300,37800
3915,3916,21-10-2020 14:58:20.651704,China,China Food Col,23000,3600,26600
3916,3917,21-10-2020 14:58:20.817977,Saludable · Desayunos,Bon Eat - Saludable,35000,4800,39800
3917,3918,21-10-2020 14:58:21.184411,Sushi,Umi,11870,5600,17470
3918,3919,21-10-2020 14:58:21.350738,Helados,Orso To Go,45800,6800,52600
3919,3920,21-10-2020 14:58:21.717316,Sánduches · Pescados y Mariscos,Pacific Comida de Mar,12500,4000,16500
3920,3921,21-10-2020 14:58:22.083906,Desayunos,Señor Desayuno,37900,6800,44700
3921,3922,21-10-2020 14:58:22.200051,Pollo,Chicken House,23000,4200,27200
3922,3923,21-10-2020 14:58:22.466705,Peruana,Uma Cantina Peruana,27800,3200,31000
3923,3924,21-10-2020 14:58:22.632983,Postres,Toledo Pastelería,45800,6800,52600
3924,3925,21-10-2020 14:58:22.799208,Típica,El Mondongo y Mucho Mas,24300,5600,29900
3925,3926,21-10-2020 14:58:22.965801,Pollo · Pescados y Mariscos,Bang Bang Rice,13600,3400,17000
3926,3927,21-10-2020 14:58:23.332417,Desayunos · Típica,Fogón Sangileño,23000,5000,28000
3927,3928,21-10-2020 14:58:23.649329,Desayunos · Árabe,Boniato Sabores Vivos,11870,5300,17170
3928,3929,21-10-2020 14:58:23.915621,Parrilla · Café,Figaro Café/ Restaurante Argentino,35000,5800,40800
3929,3930,21-10-2020 14:58:24.182042,Postres · Desayunos,Maltihelado,10700,4500,15200
3930,3931,21-10-2020 14:58:24.398459,Desayunos,Fratelli - Desayunos,24300,4600,28900
3931,3932,21-10-2020 14:58:24.715192,Peruana · Internacional,La Chifería,23000,6600,29600
3932,3933,21-10-2020 14:58:24.981572,Sushi · Asiática,Tu Sushi,13000,6400,19400
3933,3934,21-10-2020 14:58:25.149020,Desayunos · Jugos y Batidos,Kuriwaji,53900,6300,60200
3934,3935,21-10-2020 14:58:25.365650,Hamburguesas,Monchis - Hamburguesa,29500,4300,33800
3935,3936,21-10-2020 14:58:25.732173,Desayunos · Panadería,Ficchi Panadería,17800,3100,20900
3936,3937,21-10-2020 14:58:26.048640,Postres,Levelma,45800,6200,52000
3937,3938,21-10-2020 14:58:26.415210,Desayunos · Panadería,Limarys,39700,6500,46200
3938,3939,21-10-2020 14:58:26.531608,Desayunos · Típica,Calentao Express,8900,6000,14900
3939,3940,21-10-2020 14:58:26.748149,Saludable,Hanai - Bowls Saludables,11870,5900,17770
3940,3941,21-10-2020 14:58:26.864563,Típica,Juan Chorizo,35000,3900,38900
3941,3942,21-10-2020 14:58:27.181085,Típica,Bandejas Mrg,37900,3800,41700
3942,3943,21-10-2020 14:58:27.547600,Desayunos · Jugos y Batidos,Frutiwow,23000,4100,27100
3943,3944,21-10-2020 14:58:27.663996,Postres · Saludable,Ana Rebana,9000,6300,15300
3944,3945,21-10-2020 14:58:27.880495,Típica · Pescados y Mariscos,Arroces Mrg,15600,4300,19900
3945,3946,21-10-2020 14:58:28.197012,Postres · Desayunos,Aury Postres - Comidas & Picadas,65000,4700,69700
3946,3947,21-10-2020 14:58:28.363516,Pollo · Desayunos,Abasto,39700,3600,43300
3947,3948,21-10-2020 14:58:28.679985,Típica · Parrilla,Mi Ranchito Parrilla,65000,4400,69400
3948,3949,21-10-2020 14:58:28.996664,Comida Rápida · Perros Calientes,Similoa - Comida Rapida,65000,3700,68700
3949,3950,21-10-2020 14:58:29.263295,Desayunos,Fratelli - Desayunos,13600,4600,18200
3950,3951,21-10-2020 14:58:29.379933,Desayunos · Típica,90 Calentados,45800,3700,49500
3951,3952,21-10-2020 14:58:29.646821,Pollo,Heart & Cooking,53400,5000,58400
3952,3953,21-10-2020 14:58:30.013558,Pollo · Saludable,Yerbabuena,45800,3900,49700
3953,3954,21-10-2020 14:58:30.331041,Peruana,Uma Cantina Peruana,23000,3200,26200
3954,3955,21-10-2020 14:58:30.497550,Típica,La Herencia,27800,5900,33700
3955,3956,21-10-2020 14:58:30.814076,Pizza,pizza andante,70000,4200,74200
3956,3957,21-10-2020 14:58:31.180609,Desayunos · Panadería,Santa Juana Food Bar,53900,5900,59800
3957,3958,21-10-2020 14:58:31.396988,Típica,La Herencia,48750,5900,54650
3958,3959,21-10-2020 14:58:31.713748,Poke,Poke Go,29500,4600,34100
3959,3960,21-10-2020 14:58:31.930392,Postres · Desayunos,Sweet Tale,39700,5800,45500
3960,3961,21-10-2020 14:58:32.196920,Hamburguesas · Desayunos,El Inglés Gastro Pub,24200,6600,30800
3961,3962,21-10-2020 14:58:32.363546,Postres · Desayunos,Protein Bakes,35000,5900,40900
3962,3963,21-10-2020 14:58:32.479972,Desayunos,La Frijolada Desayunos,27800,4400,32200
3963,3964,21-10-2020 14:58:32.646549,Desayunos · Típica,Criollomania,48750,5200,53950
3964,3965,21-10-2020 14:58:32.913006,Típica · Parrilla,El Santandereano,48750,5200,53950
3965,3966,21-10-2020 14:58:33.029373,Típica · Parrilla,Toya,29500,4200,33700
3966,3967,21-10-2020 14:58:33.395949,Alta Cocina · Postres,La Pinta,53900,4500,58400
3967,3968,21-10-2020 14:58:33.512525,Pollo · Desayunos,Workzone,53400,3100,56500
3968,3969,21-10-2020 14:58:33.779086,Postres · Desayunos,Maria Luisa - Postres,29500,4300,33800
3969,3970,21-10-2020 14:58:33.895390,Desayunos · Café,vereda central calle 99,15000,5700,20700
3970,3971,21-10-2020 14:58:34.011661,Pollo · Sánduches,Pollos Century,70000,3000,73000
3971,3972,21-10-2020 14:58:34.278444,Postres · Desayunos,Café Quindio,23000,5700,28700
3972,3973,21-10-2020 14:58:34.545161,Parrilla,Carnes la Zarza,11870,4900,16770
3973,3974,21-10-2020 14:58:34.761752,Sánduches,Submarin,48750,3800,52550
3974,3975,21-10-2020 14:58:35.128468,Pollo · Sánduches,Pollos Century,23000,3000,26000
3975,3976,21-10-2020 14:58:35.346077,Desayunos,Cafetería el Kippe,48750,3200,51950
3976,3977,21-10-2020 14:58:35.562722,Postres · Desayunos,Cosmo Cookies,24300,5900,30200
3977,3978,21-10-2020 14:58:35.829310,Postres · Desayunos,Vivalight Market.,10700,6500,17200
3978,3979,21-10-2020 14:58:36.095792,Pollo · Saludable,Gratina,53400,4200,57600
3979,3980,21-10-2020 14:58:36.312389,Pescados y Mariscos,Fish Place - Del Mar,8900,5400,14300
3980,3981,21-10-2020 14:58:36.479037,Postres · Desayunos,Gelateria Da Favola,53400,6500,59900
3981,3982,21-10-2020 14:58:36.795734,Típica,Sabores De Mi Tierra,17800,5400,23200
3982,3983,21-10-2020 14:58:37.012396,Pollo · Desayunos,Piaf,34500,6500,41000
3983,3984,21-10-2020 14:58:37.178756,Saludable · Desayunos,Maracuyá,65000,6700,71700
3984,3985,21-10-2020 14:58:37.345219,Saludable · Desayunos,Fresh Co,11870,5600,17470
3985,3986,21-10-2020 14:58:37.561715,Típica,Sabrosito,24200,4000,28200
3986,3987,21-10-2020 14:58:37.778260,Sushi · Asiática,Arigato,34500,5300,39800
3987,3988,21-10-2020 14:58:37.994846,Sushi · Asiática,Arigato,39700,5300,45000
3988,3989,21-10-2020 14:58:38.111409,Asiática,TeT,34500,5900,40400
3989,3990,21-10-2020 14:58:38.478286,Pollo · Sánduches,Pollos Century,7500,3000,10500
3990,3991,21-10-2020 14:58:38.594767,Saludable,A2manos,53900,4200,58100
3991,3992,21-10-2020 14:58:38.711272,Desayunos · Típica,Fogón Sangileño,15000,5000,20000
3992,3993,21-10-2020 14:58:38.877875,Parrilla,El Tambor,53400,6800,60200
3993,3994,21-10-2020 14:58:38.994253,Peruana,Uma Cantina Peruana,31800,3200,35000
3994,3995,21-10-2020 14:58:39.110657,Saludable · Desayunos,Distrito Gourmet,13600,3700,17300
3995,3996,21-10-2020 14:58:39.477516,Sushi · Desayunos,Maki Roll,8900,4300,13200
3996,3997,21-10-2020 14:58:39.644012,Pollo · Pescados y Mariscos,Bang Bang Rice,15600,3400,19000
3997,3998,21-10-2020 14:58:39.960858,Desayunos · Café,vereda central calle 99,37900,5700,43600
3998,3999,21-10-2020 14:58:40.177497,Desayunos,Archies Desayunos,13600,3100,16700
3999,4000,21-10-2020 14:58:40.395329,Café · Helados,Sofia heladería y café,15600,5800,21400
4000,4001,21-10-2020 14:58:40.612176,Postres · Desayunos,Maltihelado,70000,4500,74500
4001,4002,21-10-2020 14:58:40.828854,Desayunos,El Corral - Desayunos,53400,5000,58400
4002,4003,21-10-2020 14:58:41.045348,Desayunos · Parrilla,Mi Patria,15000,4600,19600
4003,4004,21-10-2020 14:58:41.311896,Comida Rápida · Perros Calientes,Similoa - Comida Rapida,53400,3700,57100
4004,4005,21-10-2020 14:58:41.628557,Postres · Desayunos,Aury Postres - Comidas & Picadas,34500,4700,39200
4005,4006,21-10-2020 14:58:41.945430,Saludable · Desayunos,La Cesta,7500,4700,12200
4006,4007,21-10-2020 14:58:42.111800,Hamburguesas,Monchis - Hamburguesa,23000,4300,27300
4007,4008,21-10-2020 14:58:42.431645,Desayunos · Panadería,Santa Juana Food Bar,18900,5900,24800
4008,4009,21-10-2020 14:58:42.648352,Hamburguesas,Bendito Cordero,12500,5800,18300
4009,4010,21-10-2020 14:58:42.914974,Parrilla,Arepaisa de Medellín,9000,5600,14600
4010,4011,21-10-2020 14:58:43.031525,Pescados y Mariscos,Fish Place - Del Mar,18900,5400,24300
4011,4012,21-10-2020 14:58:43.298190,Saludable · Desayunos,Distrito Gourmet,35000,3700,38700
4012,4013,21-10-2020 14:58:43.665051,China,China Food Col,24300,3600,27900
4013,4014,21-10-2020 14:58:43.881968,Parrilla,Campocina,24200,4600,28800
4014,4015,21-10-2020 14:58:44.148660,Postres · Desayunos,Maltihelados,23000,6200,29200
4015,4016,21-10-2020 14:58:44.415456,Parrilla,Restaurante Bar Mi Ranchito,29500,5200,34700
4016,4017,21-10-2020 14:58:44.632083,Desayunos · Típica,La Frijolada,37900,4500,42400
4017,4018,21-10-2020 14:58:44.748630,Pizza · Italiana,Piatto - Pizza,18900,6600,25500
4018,4019,21-10-2020 14:58:45.115687,Postres · Desayunos,Restaurante Cornelia,31800,5500,37300
4019,4020,21-10-2020 14:58:45.332441,Desayunos · Típica,Calentao Express,10700,6000,16700
4020,4021,21-10-2020 14:58:45.650600,Típica,Cazuelitas 93,13600,3900,17500
4021,4022,21-10-2020 14:58:45.967555,Postres · Desayunos,La Folie - Postres,53400,3300,56700
4022,4023,21-10-2020 14:58:46.134143,Saludable · Desayunos,Básico y Elemental,24300,5900,30200
4023,4024,21-10-2020 14:58:46.350922,Pollo,Oliva Va,39700,5600,45300
4024,4025,21-10-2020 14:58:46.717760,Sushi · Asiática,Arigato,29500,5300,34800
4025,4026,21-10-2020 14:58:47.034558,Desayunos · Panadería,Santa Juana Food Bar,23000,5900,28900
4026,4027,21-10-2020 14:58:47.351431,Desayunos · Empanadas,Empanadas Doraditas.com,24300,3000,27300
4027,4028,21-10-2020 14:58:47.718480,Pizza · Italiana,Pisapore - Pizza,13600,6600,20200
4028,4029,21-10-2020 14:58:47.885337,Pollo · Desayunos,Candelina,13000,5300,18300
4029,4030,21-10-2020 14:58:48.051840,Postres · Desayunos,Sweet Tale,48750,5800,54550
4030,4031,21-10-2020 14:58:48.368694,Sánduches · China,Peru Mix,13600,5900,19500
4031,4032,21-10-2020 14:58:48.535246,Desayunos,Señor Desayuno,45800,6800,52600
4032,4033,21-10-2020 14:58:48.751828,Típica · Parrilla,Parrilla Farandula Gourmet,31800,5100,36900
4033,4034,21-10-2020 14:58:49.068653,Desayunos · Panadería,Santa Juana Food Bar,53400,5900,59300
4034,4035,21-10-2020 14:58:49.285427,Pollo · Desayunos,Caserito Gourmet,31800,6700,38500
4035,4036,21-10-2020 14:58:49.402040,Postres · Desayunos,Restaurante Cornelia,23000,5500,28500
4036,4037,21-10-2020 14:58:49.619215,Parrilla,Arepaisa de Medellín,31800,5600,37400
4037,4038,21-10-2020 14:58:49.836047,Italiana,F*cking Good Pizza,24200,4200,28400
4038,4039,21-10-2020 14:58:50.052829,Saludable · Desayunos,Agua Dulce,17800,3700,21500
4039,4040,21-10-2020 14:58:50.219604,Hamburguesas · Alitas,Beer,65000,6600,71600
4040,4041,21-10-2020 14:58:50.436324,Típica,Sabores De Mi Tierra,29500,5400,34900
4041,4042,21-10-2020 14:58:50.654127,Saludable · Típica,Sopas Mrg,27800,3100,30900
4042,4043,21-10-2020 14:58:50.971063,Típica · Pescados y Mariscos,Arroces Mrg,7500,4300,11800
4043,4044,21-10-2020 14:58:51.287986,Típica · Parrilla,El Portal de la Antigua,17800,5600,23400
4044,4045,21-10-2020 14:58:51.454542,Parrilla,Rústico Picadería,53400,3800,57200
4045,4046,21-10-2020 14:58:51.721562,Pollo,Señor Fantástico,18900,4700,23600
4046,4047,21-10-2020 14:58:51.938341,Desayunos,El Corral - Desayunos,15000,5000,20000
4047,4048,21-10-2020 14:58:52.305341,Postres · Desayunos,Aury Postres - Comidas & Picadas,35000,4700,39700
4048,4049,21-10-2020 14:58:52.421831,Típica · Parrilla,Mi Ranchito Parrilla,53400,4400,57800
4049,4050,21-10-2020 14:58:52.588412,Saludable · Desayunos,Copacabana Açai Bowls,29500,3000,32500
4050,4051,21-10-2020 14:58:52.905552,Desayunos · Café,Frambas,27800,3400,31200
4051,4052,21-10-2020 14:58:53.222575,Típica · Parrilla,Toya,27800,4200,32000
4052,4053,21-10-2020 14:58:53.589732,Saludable · Desayunos,Bawana - Sandwich,13600,3400,17000
4053,4054,21-10-2020 14:58:53.906745,Sánduches · Pescados y Mariscos,Pacific Comida de Mar,45800,4000,49800
4054,4055,21-10-2020 14:58:54.123464,Sushi,Sushi Reel,53900,4700,58600
4055,4056,21-10-2020 14:58:54.440670,Desayunos · Sánduches,Frutos del Bosque,17800,3500,21300
4056,4057,21-10-2020 14:58:54.557522,Parrilla · Café,Gaira Café,37900,4400,42300
4057,4058,21-10-2020 14:58:54.874347,Sánduches · Pescados y Mariscos,Pacific Comida de Mar,35000,4000,39000
4058,4059,21-10-2020 14:58:55.041012,Sushi · Asiática,Arigato,24200,5300,29500
4059,4060,21-10-2020 14:58:55.207732,Desayunos · Café,Norma's Ice Cream Café,18900,6300,25200
4060,4061,21-10-2020 14:58:55.424866,Sushi · Asiática,Arigato,18900,5300,24200
4061,4062,21-10-2020 14:58:55.792784,Postres · Desayunos,Maltihelados,65000,6200,71200
4062,4063,21-10-2020 14:58:56.159628,Postres · Café,Loló Coffee & Snacks,8900,4600,13500
4063,4064,21-10-2020 14:58:56.476448,Típica,El Mondongo y Mucho Mas,24200,5600,29800
4064,4065,21-10-2020 14:58:56.592964,Típica,Salsig,48750,5600,54350
4065,4066,21-10-2020 14:58:56.909906,Poke,Poke Go,23000,4600,27600
4066,4067,21-10-2020 14:58:57.076553,Postres · Desayunos,Café Quindio,65000,5700,70700
4067,4068,21-10-2020 14:58:57.243201,Saludable,The Good Rice Bowls,9000,3500,12500
4068,4069,21-10-2020 14:58:57.560116,Saludable · Desayunos,Bon Eat - Saludable,24300,4800,29100
4069,4070,21-10-2020 14:58:57.776899,Mexicana,Hidalgo Taquería,11870,4900,16770
4070,4071,21-10-2020 14:58:58.043633,Saludable · Desayunos,Malú,9000,3700,12700
4071,4072,21-10-2020 14:58:58.160193,Sushi,Kim Pop,10700,5400,16100
4072,4073,21-10-2020 14:58:58.426979,Saludable · Desayunos,Guadalupe - Fruteria,35000,5900,40900
4073,4074,21-10-2020 14:58:58.643780,Café · Helados,Sofia heladería y café,24200,5800,30000
4074,4075,21-10-2020 14:58:59.010864,Parrilla,Campocina,24200,4600,28800
4075,4076,21-10-2020 14:58:59.377928,Comida Rápida,Fiesta Digital Andrés,31800,3100,34900
4076,4077,21-10-2020 14:58:59.744927,Desayunos · Típica,D´Porco,29500,3900,33400
4077,4078,21-10-2020 14:59:00.011742,Parrilla,Rústico Picadería,13600,3800,17400
4078,4079,21-10-2020 14:59:00.128342,Panadería,Boul,13600,3100,16700
4079,4080,21-10-2020 14:59:00.345306,Desayunos · Italiana,Rceta By Rausch,70000,3600,73600
4080,4081,21-10-2020 14:59:00.662168,Desayunos · Comida Rápida,Chocolatto,45800,3400,49200
4081,4082,21-10-2020 14:59:01.030186,Postres · Desayunos,Amelie Helados,13600,6400,20000
4082,4083,21-10-2020 14:59:01.247094,Saludable · Desayunos,Distrito Gourmet,24300,3700,28000
4083,4084,21-10-2020 14:59:01.463988,Desayunos · Panadería,Siena Café,48750,3700,52450
4084,4085,21-10-2020 14:59:01.730951,Desayunos,Señor Desayuno,29500,6800,36300
4085,4086,21-10-2020 14:59:01.947764,Desayunos,Jacinta Arepas de Huevo,10700,4000,14700
4086,4087,21-10-2020 14:59:02.064536,Sánduches,Submarin,48750,3800,52550
4087,4088,21-10-2020 14:59:02.431459,Típica,Bandejas Mrg,31800,3800,35600
4088,4089,21-10-2020 14:59:02.748267,Saludable · Desayunos,Fresh Co,15600,5600,21200
4089,4090,21-10-2020 14:59:03.015082,Postres · Café,Celestino Café,13000,5900,18900
4090,4091,21-10-2020 14:59:03.231870,Desayunos · Helados,San Giorgio Gelateria,23000,3100,26100
4091,4092,21-10-2020 14:59:03.348610,Desayunos,Señor Desayuno,48750,6800,55550
4092,4093,21-10-2020 14:59:03.665553,Desayunos · Típica,Peninsula Calentados y Parrilla,37900,3400,41300
4093,4094,21-10-2020 14:59:03.882297,Desayunos · Típica,Rojo Gourmet,7500,4700,12200
4094,4095,21-10-2020 14:59:03.998984,Jugos y Batidos,Pomponio,11870,3600,15470
4095,4096,21-10-2020 14:59:04.315934,Postres · Desayunos,La Folie - Postres,34500,3300,37800
4096,4097,21-10-2020 14:59:04.633367,Típica · Pescados y Mariscos,Arroces Mrg,27800,4300,32100
4097,4098,21-10-2020 14:59:04.950571,Típica,Campo Victoria,53900,3000,56900
4098,4099,21-10-2020 14:59:05.317647,Típica,Sabores De Mi Tierra,34500,5400,39900
4099,4100,21-10-2020 14:59:05.584401,Peruana,Masivo,70000,5800,75800
4100,4101,21-10-2020 14:59:05.851223,Desayunos · Café,Moramia,34500,4700,39200
4101,4102,21-10-2020 14:59:06.069440,Saludable,Hanai - Bowls Saludables,34500,5900,40400
4102,4103,21-10-2020 14:59:06.436437,Postres · Desayunos,Buñuelos nacho,15000,6600,21600
4103,4104,21-10-2020 14:59:06.603458,Saludable · Desayunos,Malú,70000,3700,73700
4104,4105,21-10-2020 14:59:06.770444,Desayunos · Árabe,Boniato Sabores Vivos,8900,5300,14200
4105,4106,21-10-2020 14:59:06.987322,Desayunos · Típica,Casa Vieja,34500,6000,40500
4106,4107,21-10-2020 14:59:07.104190,Desayunos,La Frijolada Desayunos,34500,4400,38900
4107,4108,21-10-2020 14:59:07.421253,Hamburguesas,Gofi Burger,35000,5100,40100
4108,4109,21-10-2020 14:59:07.688275,Desayunos,Sunny Breakfast Brunch,9000,4300,13300
4109,4110,21-10-2020 14:59:07.905302,Desayunos · Típica,Alce,70000,4900,74900
4110,4111,21-10-2020 14:59:08.122135,Desayunos · Típica,Desayunadero de la 42,9000,5900,14900
4111,4112,21-10-2020 14:59:08.489254,Desayunos · Típica,Peninsula Calentados y Parrilla,18900,3400,22300
4112,4113,21-10-2020 14:59:08.806244,Desayunos · Panadería,Santa Juana Food Bar,45800,5900,51700
4113,4114,21-10-2020 14:59:08.973238,Pollo · Sánduches,Pollos Century,11870,3000,14870
4114,4115,21-10-2020 14:59:09.240103,Desayunos · Internacional,Camilia,65000,3900,68900
4115,4116,21-10-2020 14:59:09.457009,Asiática,TeT,29500,5900,35400
4116,4117,21-10-2020 14:59:09.674039,Típica · Pescados y Mariscos,Arroces Mrg,23000,4300,27300
4117,4118,21-10-2020 14:59:10.041192,Desayunos,Don Leo,48750,6000,54750
4118,4119,21-10-2020 14:59:10.157957,Desayunos,Don Leo,29500,6000,35500
4119,4120,21-10-2020 14:59:10.475044,Postres · Helados,Mahé,7500,6000,13500
4120,4121,21-10-2020 14:59:10.641948,Postres · Desayunos,Buñuelos nacho,48750,6600,55350
4121,4122,21-10-2020 14:59:10.808773,Sánduches · China,Peru Mix,53900,5900,59800
4122,4123,21-10-2020 14:59:11.076820,Típica,El Cucharón - Tipica,13600,4400,18000
4123,4124,21-10-2020 14:59:11.444045,Pollo · Desayunos,Workzone,35000,3100,38100
4124,4125,21-10-2020 14:59:11.811463,Desayunos · Empanadas,Empanadas Doraditas.com,17800,3000,20800
4125,4126,21-10-2020 14:59:12.078439,Postres · Desayunos,Jacques Pastelería,65000,5900,70900
4126,4127,21-10-2020 14:59:12.445568,Saludable · Jugos y Batidos,Berdes Drinks & Salads,24300,3500,27800
4127,4128,21-10-2020 14:59:12.612936,Saludable · Desayunos,Copacabana Açai Bowls,45800,3000,48800
4128,4129,21-10-2020 14:59:12.830002,Saludable · Desayunos,Copacabana Açai Bowls,23000,3000,26000
4129,4130,21-10-2020 14:59:13.047010,Saludable · Desayunos,Maracuyá,70000,6700,76700
4130,4131,21-10-2020 14:59:13.363990,Café · Helados,Sofia heladería y café,11870,5800,17670
4131,4132,21-10-2020 14:59:13.631108,Parrilla · Café,Gaira Café,24300,4400,28700
4132,4133,21-10-2020 14:59:13.848031,Desayunos · Típica,Alce,23000,4900,27900
4133,4134,21-10-2020 14:59:14.165023,Desayunos · Mexicana,La Mera Mera - Mexicana,24200,3100,27300
4134,4135,21-10-2020 14:59:14.532015,Parrilla,Arroces Maria Paula,12500,6800,19300
4135,4136,21-10-2020 14:59:14.799182,Típica · Parrilla,Typykos,37900,6000,43900
4136,4137,21-10-2020 14:59:15.016037,Parrilla · Café,Gaira Café,29500,4400,33900
4137,4138,21-10-2020 14:59:15.333210,Desayunos · Pescados y Mariscos,Luzí­a - Mediterranea,70000,5700,75700
4138,4139,21-10-2020 14:59:15.700242,Saludable · Desayunos,Distrito Gourmet,24300,3700,28000
4139,4140,21-10-2020 14:59:15.867392,Helados,Buon Gelato,24200,4400,28600
4140,4141,21-10-2020 14:59:16.235693,Desayunos,Don Leo,7500,6000,13500
4141,4142,21-10-2020 14:59:16.352716,Pizza,Pizza Andante,9000,6300,15300
4142,4143,21-10-2020 14:59:16.719898,Pollo,Chicken House,7500,4200,11700
4143,4144,21-10-2020 14:59:16.836841,Postres · Desayunos,Maltihelados,15600,6200,21800
4144,4145,21-10-2020 14:59:16.953678,Desayunos · Panadería,Siena Café,10700,3700,14400
4145,4146,21-10-2020 14:59:17.270669,Desayunos · Árabe,Boniato Sabores Vivos,23000,5300,28300
4146,4147,21-10-2020 14:59:17.537875,Saludable · Desayunos,Copacabana Açai Bowls,9000,3000,12000
4147,4148,21-10-2020 14:59:17.704880,Típica,Bendita S,15600,4600,20200
4148,4149,21-10-2020 14:59:18.072003,Helados,Orso To Go,8900,6800,15700
4149,4150,21-10-2020 14:59:18.289007,Pollo · Pescados y Mariscos,Bang Bang Rice,23000,3400,26400
4150,4151,21-10-2020 14:59:18.506092,Crepes,La Chabatta,7500,5900,13400
4151,4152,21-10-2020 14:59:18.623307,Desayunos · Café,Libertario Coffee Roasters,7500,4600,12100
4152,4153,21-10-2020 14:59:18.990898,Hamburguesas,Gofi Burger,13000,5100,18100
4153,4154,21-10-2020 14:59:19.157918,Desayunos · Panadería,Le Pain Quotidien,53900,3900,57800
4154,4155,21-10-2020 14:59:19.475085,Mexicana,Mexicanachos,65000,3900,68900
4155,4156,21-10-2020 14:59:19.742284,Desayunos · Panadería,Santa Juana Food Bar,65000,5900,70900
4156,4157,21-10-2020 14:59:20.059561,Postres · Café,Loló Coffee & Snacks,34500,4600,39100
4157,4158,21-10-2020 14:59:20.176360,Típica,Cazuelitas 93,11870,3900,15770
4158,4159,21-10-2020 14:59:20.343566,Hamburguesas · Panadería,NYC Burgers,12500,6200,18700
4159,4160,21-10-2020 14:59:20.660925,Desayunos · Café,Moramia,29500,4700,34200
4160,4161,21-10-2020 14:59:21.028152,Desayunos · Jugos y Batidos,Frutiwow,15600,4100,19700
4161,4162,21-10-2020 14:59:21.195195,Saludable · Desayunos,Bon Eat - Saludable,37900,4800,42700
4162,4163,21-10-2020 14:59:21.513500,Mexicana,La leyenda mexican kitchen,15000,3200,18200
4163,4164,21-10-2020 14:59:21.780748,Desayunos · Panadería,Santa Juana Food Bar,53900,5900,59800
4164,4165,21-10-2020 14:59:21.997895,Postres · Desayunos,Café Quindio,24200,5700,29900
4165,4166,21-10-2020 14:59:22.164904,Desayunos · Panadería,Artesanos,9000,4300,13300
4166,4167,21-10-2020 14:59:22.432055,Postres · Café,Loló Coffee & Snacks,53900,4600,58500
4167,4168,21-10-2020 14:59:22.599224,Desayunos · Típica,D´Porco,48750,3900,52650
4168,4169,21-10-2020 14:59:22.716281,Postres · Desayunos,Jacques Pastelería,24200,5900,30100
4169,4170,21-10-2020 14:59:22.883387,Típica · Parrilla,La Ternera Parrilla,39700,5200,44900
4170,4171,21-10-2020 14:59:23.250623,Desayunos · Comida Rápida,Chocolatto,35000,3400,38400
4171,4172,21-10-2020 14:59:23.367781,Comida Rápida · Perros Calientes,Similoa - Comida Rapida,27800,3700,31500
4172,4173,21-10-2020 14:59:23.685029,Postres · Desayunos,Café Quindio,12500,5700,18200
4173,4174,21-10-2020 14:59:23.852008,Desayunos,Bagel Shop,53400,3200,56600
4174,4175,21-10-2020 14:59:24.069185,Típica,La Olla de Barro,45800,5300,51100
4175,4176,21-10-2020 14:59:24.386310,Sánduches,Submarin,18900,3800,22700
4176,4177,21-10-2020 14:59:24.603657,Postres · Desayunos,Aury Postres - Comidas & Picadas,45800,4700,50500
4177,4178,21-10-2020 14:59:24.971141,Desayunos · Típica,Fogón Sangileño,17800,5000,22800
4178,4179,21-10-2020 14:59:25.338489,Típica · Parrilla,Toya,27800,4200,32000
4179,4180,21-10-2020 14:59:25.605841,Desayunos · Sánduches,Garnish,8900,5200,14100
4180,4181,21-10-2020 14:59:25.772858,Desayunos,Butter,12500,6700,19200
4181,4182,21-10-2020 14:59:25.989941,Desayunos · Típica,La Parrilla Dorada Polo,34500,6600,41100
4182,4183,21-10-2020 14:59:26.307241,Desayunos · Café,Norma's Ice Cream Café,53900,6300,60200
4183,4184,21-10-2020 14:59:26.625739,Pollo,Chicken House,17800,4200,22000
4184,4185,21-10-2020 14:59:26.793164,Pollo · Saludable,Gratina,23000,4200,27200
4185,4186,21-10-2020 14:59:27.160506,Pizza,pizza andante,23000,4200,27200
4186,4187,21-10-2020 14:59:27.277555,Saludable · Desayunos,Fresh Co,17800,5600,23400
4187,4188,21-10-2020 14:59:27.594811,Saludable · Desayunos,Malú,31800,3700,35500
4188,4189,21-10-2020 14:59:27.912058,Típica,Cazuelitas 93,35000,3900,38900
4189,4190,21-10-2020 14:59:28.179173,Desayunos · Panadería,Juliana Restaurante,8900,6100,15000
4190,4191,21-10-2020 14:59:28.546509,Desayunos · Café,Libertario Coffee Roasters,10700,4600,15300
4191,4192,21-10-2020 14:59:28.913755,Postres,La Galeta,53900,3000,56900
4192,4193,21-10-2020 14:59:29.080874,Desayunos · Típica,Casa Vieja,29500,6000,35500
4193,4194,21-10-2020 14:59:29.448151,Poke,Poke Go,23000,4600,27600
4194,4195,21-10-2020 14:59:29.765557,Desayunos · Café,Frambas,24200,3400,27600
4195,4196,21-10-2020 14:59:29.932581,Desayunos · Helados,San Giorgio Gelateria,29500,3100,32600
4196,4197,21-10-2020 14:59:30.099652,Pizza,pizza andante,24200,4200,28400
4197,4198,21-10-2020 14:59:30.216677,Desayunos · Típica,Parrilla Farandula Típico,34500,5900,40400
4198,4199,21-10-2020 14:59:30.584005,Café · Helados,Sofia heladería y café,11870,5800,17670
4199,4200,21-10-2020 14:59:30.701301,Desayunos · Panadería,Limarys,23000,6500,29500
4200,4201,21-10-2020 14:59:30.818251,Típica,El Mondongo y Mucho Mas,39700,5600,45300
4201,4202,21-10-2020 14:59:31.085625,Saludable,Hanai - Bowls Saludables,35000,5900,40900
4202,4203,21-10-2020 14:59:31.352787,Hamburguesas,Bendito Cordero,53400,5800,59200
4203,4204,21-10-2020 14:59:31.671146,Desayunos · Comida Rápida,Chocolatto,35000,3400,38400
4204,4205,21-10-2020 14:59:31.888651,Desayunos · Café,Matchacha,37900,5900,43800
4205,4206,21-10-2020 14:59:32.155883,Desayunos · Típica,Desayunadero de la 42,39700,5900,45600
4206,4207,21-10-2020 14:59:32.523568,Saludable · Desayunos,Fresh Co,35000,5600,40600
4207,4208,21-10-2020 14:59:32.690738,Desayunos · Típica,Rojo Gourmet,15000,4700,19700
4208,4209,21-10-2020 14:59:32.907945,Hamburguesas · Panadería,NYC Burgers,15600,6200,21800
4209,4210,21-10-2020 14:59:33.275304,Mexicana,Mexicanachos,8900,3900,12800
4210,4211,21-10-2020 14:59:33.492466,Hamburguesas · Panadería,NYC Burgers,12500,6200,18700
4211,4212,21-10-2020 14:59:33.659632,Postres · Desayunos,Maltihelado,45800,4500,50300
4212,4213,21-10-2020 14:59:33.776807,Parrilla,Restaurante Bar Mi Ranchito,27800,5200,33000
4213,4214,21-10-2020 14:59:34.144363,Peruana,Uma Cantina Peruana,53400,3200,56600
4214,4215,21-10-2020 14:59:34.361764,Comida Rápida · Perros Calientes,Similoa - Comida Rapida,27800,3700,31500
4215,4216,21-10-2020 14:59:34.479078,Postres · Desayunos,Restaurante Cornelia,12500,5500,18000
4216,4217,21-10-2020 14:59:34.596532,Típica · Pescados y Mariscos,La Vitualla,7500,6300,13800
4217,4218,21-10-2020 14:59:34.813899,Helados,Buon Gelato,17800,4400,22200
4218,4219,21-10-2020 14:59:35.131357,Desayunos · Panadería,Choclofee,10700,4700,15400
4219,4220,21-10-2020 14:59:35.398939,Postres · Desayunos,Gelateria Da Favola,37900,6500,44400
4220,4221,21-10-2020 14:59:35.666656,Parrilla,Arroces Maria Paula,27800,6800,34600
4221,4222,21-10-2020 14:59:35.884125,Pizza,pizza andante,12500,4200,16700
4222,4223,21-10-2020 14:59:36.051710,Asiática,TeT,53900,5900,59800
4223,4224,21-10-2020 14:59:36.269029,Postres · Desayunos,La Folie - Postres,15000,3300,18300
4224,4225,21-10-2020 14:59:36.636688,Típica · Pescados y Mariscos,Arroces Mrg,8900,4300,13200
4225,4226,21-10-2020 14:59:36.805599,Desayunos · Empanadas,Mis Delicias,34500,3200,37700
4226,4227,21-10-2020 14:59:37.122910,Parrilla,Arroces Maria Paula,31800,6800,38600
4227,4228,21-10-2020 14:59:37.390199,Desayunos · Empanadas,Mis Delicias,23000,3200,26200
4228,4229,21-10-2020 14:59:37.707743,Saludable · Desayunos,Raices Bienestar Gourmet,24300,6600,30900
4229,4230,21-10-2020 14:59:38.025021,Asiática,Thai Station,35000,6000,41000
4230,4231,21-10-2020 14:59:38.242253,Saludable,Hanai - Bowls Saludables,13600,5900,19500
4231,4232,21-10-2020 14:59:38.559652,Típica,La Olla de Barro,9000,5300,14300
4232,4233,21-10-2020 14:59:38.927146,Pizza,pizza andante,31800,4200,36000
4233,4234,21-10-2020 14:59:39.044791,Desayunos · Típica,Alce,18900,4900,23800
4234,4235,21-10-2020 14:59:39.261995,Desayunos · Típica,Peninsula Calentados y Parrilla,17800,3400,21200
4235,4236,21-10-2020 14:59:39.629536,Saludable · Desayunos,Malú,27800,3700,31500
4236,4237,21-10-2020 14:59:39.796898,Parrilla · Café,Gaira Café,35000,4400,39400
4237,4238,21-10-2020 14:59:39.913960,Desayunos · Café,Aromacafé el Placer de Compartir,37900,5000,42900
4238,4239,21-10-2020 14:59:40.030908,Típica,La Herencia,70000,5900,75900
4239,4240,21-10-2020 14:59:40.298355,Desayunos · Panadería,Le Pain Quotidien,70000,3900,73900
4240,4241,21-10-2020 14:59:40.665836,Saludable · Desayunos,Raices Bienestar Gourmet,13600,6600,20200
4241,4242,21-10-2020 14:59:40.933205,Pollo · Pescados y Mariscos,Bang Bang Rice,31800,3400,35200
4242,4243,21-10-2020 14:59:41.150385,Desayunos · Jugos y Batidos,Dont Be Hungry,24300,5600,29900
4243,4244,21-10-2020 14:59:41.267681,Peruana,Uma Cantina Peruana,35000,3200,38200
4244,4245,21-10-2020 14:59:41.585081,Parrilla,Carnes la Zarza,9000,4900,13900
4245,4246,21-10-2020 14:59:41.752166,Desayunos · Típica,D´Porco,24200,3900,28100
4246,4247,21-10-2020 14:59:42.070772,Saludable · Desayunos,Básico y elemental,17800,5000,22800
4247,4248,21-10-2020 14:59:42.338163,Desayunos · Italiana,Rceta By Rausch,39700,3600,43300
4248,4249,21-10-2020 14:59:42.555236,Pollo · Típica,Auyama,53900,3900,57800
4249,4250,21-10-2020 14:59:42.772544,Desayunos · Panadería,Siena Café,23000,3700,26700
4250,4251,21-10-2020 14:59:42.889821,Mexicana,Cantina La 15,34500,4300,38800
4251,4252,21-10-2020 14:59:43.257355,Desayunos,Don Leo,15000,6000,21000
4252,4253,21-10-2020 14:59:43.524712,Postres · Desayunos,La Folie - Postres,13600,3300,16900
4253,4254,21-10-2020 14:59:43.691843,Típica · Parrilla,Mi Ranchito Parrilla,12500,4400,16900
4254,4255,21-10-2020 14:59:43.859003,Hamburguesas · Alitas,Beer,35000,6600,41600
4255,4256,21-10-2020 14:59:43.976417,Hamburguesas,Burger Society,53400,4100,57500
4256,4257,21-10-2020 14:59:44.093552,Crepes,La Chabatta,45800,5900,51700
4257,4258,21-10-2020 14:59:44.411160,Desayunos · Café,Frambas,24200,3400,27600
4258,4259,21-10-2020 14:59:44.778850,Postres · Café,Loló Coffee & Snacks,35000,4600,39600
4259,4260,21-10-2020 14:59:44.896019,Desayunos · Panadería,El Pan de Phillippe,53900,4600,58500
4260,4261,21-10-2020 14:59:45.013309,Desayunos,Sunny Breakfast Brunch,29500,4300,33800
4261,4262,21-10-2020 14:59:45.330556,Desayunos · Panadería,Artesanos,48750,4300,53050
4262,4263,21-10-2020 14:59:45.597896,China,China Food Col,18900,3600,22500
4263,4264,21-10-2020 14:59:45.915447,Saludable,A2manos,34500,4200,38700
4264,4265,21-10-2020 14:59:46.182828,Desayunos · Pescados y Mariscos,Gypsy Bistro,53400,4500,57900
4265,4266,21-10-2020 14:59:46.400059,Pizza,Pastas Laurentina,15600,4800,20400
4266,4267,21-10-2020 14:59:46.767676,Comida Rápida,Fiesta Digital Andrés,8900,3100,12000
4267,4268,21-10-2020 14:59:47.034928,Peruana · Internacional,La Chifería,10700,6600,17300
4268,4269,21-10-2020 14:59:47.303443,Mexicana,La leyenda mexican kitchen,34500,3200,37700
4269,4270,21-10-2020 14:59:47.570987,Típica,Bandejas Mrg,7500,3800,11300
4270,4271,21-10-2020 14:59:47.688320,Hamburguesas,Monchis - Hamburguesa,12500,4300,16800
4271,4272,21-10-2020 14:59:47.905809,Desayunos · Típica,Cochon,53400,3300,56700
4272,4273,21-10-2020 14:59:48.123145,Típica · Pescados y Mariscos,Arroces Mrg,31800,4300,36100
4273,4274,21-10-2020 14:59:48.490657,Hamburguesas · Saludable,Restaurant Inn,31800,6100,37900
4274,4275,21-10-2020 14:59:48.708065,Desayunos · Sánduches,Garnish,37900,5200,43100
4275,4276,21-10-2020 14:59:48.925380,Panadería,Boul,35000,3100,38100
4276,4277,21-10-2020 14:59:49.242680,Desayunos · Típica,Calentao Express,13600,6000,19600
4277,4278,21-10-2020 14:59:49.359744,Saludable,Puro Verde,39700,5700,45400
4278,4279,21-10-2020 14:59:49.476965,Típica · Parrilla,La Ternera Parrilla,34500,5200,39700
4279,4280,21-10-2020 14:59:49.694342,Desayunos · Italiana,Rceta By Rausch,15600,3600,19200
4280,4281,21-10-2020 14:59:49.961732,Postres · Desayunos,Buñuelos nacho,11870,6600,18470
4281,4282,21-10-2020 14:59:50.279193,Parrilla · Café,Gaira Café,37900,4400,42300
4282,4283,21-10-2020 14:59:50.646874,Saludable · Desayunos,Agua Dulce,24200,3700,27900
4283,4284,21-10-2020 14:59:50.914320,Desayunos · Típica,D'Porco - Lechona,11870,6300,18170
4284,4285,21-10-2020 14:59:51.181782,Parrilla,Arroces Maria Paula,12500,6800,19300
4285,4286,21-10-2020 14:59:51.349003,Café · Helados,Sofia heladería y café,12500,5800,18300
4286,4287,21-10-2020 14:59:51.566284,Postres,Toledo Pastelería,31800,6800,38600
4287,4288,21-10-2020 14:59:51.733792,Desayunos,Sunny Breakfast Brunch,39700,4300,44000
4288,4289,21-10-2020 14:59:51.850978,Desayunos · Panadería,Juliana Restaurante,35000,6100,41100
4289,4290,21-10-2020 14:59:52.068363,Pollo · Desayunos,Candelina,7500,5300,12800
4290,4291,21-10-2020 14:59:52.235572,Típica,Sabores De Mi Tierra,8900,5400,14300
4291,4292,21-10-2020 14:59:52.604382,Desayunos · Café,Frambas,17800,3400,21200
4292,4293,21-10-2020 14:59:52.922101,Desayunos · Típica,Peninsula Calentados y Parrilla,37900,3400,41300
4293,4294,21-10-2020 14:59:53.139727,Hamburguesas,Burger Society,15000,4100,19100
4294,4295,21-10-2020 14:59:53.307113,Parrilla,Beraca Parrilla Bbq,13600,5600,19200
4295,4296,21-10-2020 14:59:53.524621,Típica,Campo Victoria,70000,3000,73000
4296,4297,21-10-2020 14:59:53.792114,Desayunos · Típica,Alce,24300,4900,29200
4297,4298,21-10-2020 14:59:53.909541,Desayunos · Sánduches,Garnish,10700,5200,15900
4298,4299,21-10-2020 14:59:54.227162,Desayunos · Pescados y Mariscos,Gypsy Bistro,48750,4500,53250
4299,4300,21-10-2020 14:59:54.544785,Típica,Campo Victoria,15000,3000,18000
4300,4301,21-10-2020 14:59:54.762290,Típica,Sopitas y Más,39700,4200,43900
4301,4302,21-10-2020 14:59:55.029799,Típica · Parrilla,Parrilla Farandula Gourmet,35000,5100,40100
4302,4303,21-10-2020 14:59:55.247213,Mexicana,La leyenda mexican kitchen,17800,3200,21000
4303,4304,21-10-2020 14:59:55.415047,Parrilla,Carnes la Zarza,53900,4900,58800
4304,4305,21-10-2020 14:59:55.632635,Desayunos · Café,Aromacafé el Placer de Compartir,70000,5000,75000
4305,4306,21-10-2020 14:59:55.950269,Desayunos · Panadería,Pasteleite,34500,5900,40400
4306,4307,21-10-2020 14:59:56.117907,Saludable · Desayunos,Guadalupe - Fruteria,48750,5900,54650
4307,4308,21-10-2020 14:59:56.235177,Saludable · Desayunos,Fresh Co,24300,5600,29900
4308,4309,21-10-2020 14:59:56.352489,Saludable · Desayunos,Copacabana Açai Bowls,39700,3000,42700
4309,4310,21-10-2020 14:59:56.469828,Desayunos,Bagel Shop,31800,3200,35000
4310,4311,21-10-2020 14:59:56.737359,Mexicana,Hidalgo Taquería,35000,4900,39900
4311,4312,21-10-2020 14:59:57.055081,Parrilla,Arroces Maria Paula,24200,6800,31000
4312,4313,21-10-2020 14:59:57.222531,Desayunos,Bagel Shop,23000,3200,26200
4313,4314,21-10-2020 14:59:57.540208,Mexicana,La leyenda mexican kitchen,27800,3200,31000
4314,4315,21-10-2020 14:59:57.858862,Saludable · Parrilla,The Angels Grill and Drinks,48750,6200,54950
4315,4316,21-10-2020 14:59:58.076609,Pollo · Saludable,Tremenda Sal y Dulce,53900,6500,60400
4316,4317,21-10-2020 14:59:58.344158,Saludable · Desayunos,Básico y Elemental,17800,5900,23700
4317,4318,21-10-2020 14:59:58.461633,Desayunos,Fratelli - Desayunos,65000,4600,69600
4318,4319,21-10-2020 14:59:58.829109,Saludable · Desayunos,La Cesta,37900,4700,42600
4319,4320,21-10-2020 14:59:59.196763,Crepes,La Chabatta,13000,5900,18900
4320,4321,21-10-2020 14:59:59.564459,Desayunos · Italiana,Rceta By Rausch,70000,3600,73600
4321,4322,21-10-2020 14:59:59.781946,Sánduches,Submarin,13600,3800,17400
4322,4323,21-10-2020 14:59:59.899429,Parrilla,Parrilla Pimentón,39700,3400,43100
4323,4324,21-10-2020 15:00:00.066964,Desayunos · Jugos y Batidos,Frutiwow,24300,4100,28400
4324,4325,21-10-2020 15:00:00.334502,Pollo · China,China Tao,8900,3500,12400
4325,4326,21-10-2020 15:00:00.602049,Parrilla · Café,Gaira Café,53400,4400,57800
4326,4327,21-10-2020 15:00:00.919767,Típica,Sopitas y Más,31800,4200,36000
4327,4328,21-10-2020 15:00:01.287472,Desayunos · Típica,Alce,10700,4900,15600
4328,4329,21-10-2020 15:00:01.554967,Saludable · Desayunos,Fresh Co,13600,5600,19200
4329,4330,21-10-2020 15:00:01.872621,Típica,Cabrito Santandereano,13600,6600,20200
4330,4331,21-10-2020 15:00:02.140232,Hamburguesas · Saludable,Restaurant Inn,9000,6100,15100
4331,4332,21-10-2020 15:00:02.307593,Desayunos · Internacional,Camilia,53900,3900,57800
4332,4333,21-10-2020 15:00:02.675248,Pizza · Italiana,Pisapore - Pizza,18900,6600,25500
4333,4334,21-10-2020 15:00:02.943789,Pescados y Mariscos,Pescadero Héroes del Mar,8900,6600,15500
4334,4335,21-10-2020 15:00:03.311311,Desayunos · Café,Moramia,7500,4700,12200
4335,4336,21-10-2020 15:00:03.428761,Postres · Desayunos,Gelateria Da Favola,10700,6500,17200
4336,4337,21-10-2020 15:00:03.546190,Saludable · Desayunos,Bawana - Sandwich,27800,3400,31200
4337,4338,21-10-2020 15:00:03.713758,Postres · Café,Loló Coffee & Snacks,13600,4600,18200
4338,4339,21-10-2020 15:00:03.881324,Típica,La Cocina,53400,4600,58000
4339,4340,21-10-2020 15:00:04.149065,Crepes,La Chabatta,65000,5900,70900
4340,4341,21-10-2020 15:00:04.316818,Sánduches · Pescados y Mariscos,Pacific Comida de Mar,11870,4000,15870
4341,4342,21-10-2020 15:00:04.434327,Típica · Parrilla,Mi Ranchito Parrilla,35000,4400,39400
4342,4343,21-10-2020 15:00:04.702088,Pizza,pizza andante,15000,4200,19200
4343,4344,21-10-2020 15:00:05.069775,Parrilla · Internacional,Taperia de la Plaza,13600,5700,19300
4344,4345,21-10-2020 15:00:05.187199,Sánduches · Pescados y Mariscos,Pacific Comida de Mar,24200,4000,28200
4345,4346,21-10-2020 15:00:05.354669,Parrilla · Café,Figaro Café/ Restaurante Argentino,35000,5800,40800
4346,4347,21-10-2020 15:00:05.472083,Comida Rápida · Perros Calientes,Similoa - Comida Rapida,35000,3700,38700
4347,4348,21-10-2020 15:00:05.639672,Helados,Orso To Go,45800,6800,52600
4348,4349,21-10-2020 15:00:06.007385,Típica,Sopitas y Más,15600,4200,19800
4349,4350,21-10-2020 15:00:06.124905,Postres · Desayunos,BagBog Bagels,70000,6400,76400
4350,4351,21-10-2020 15:00:06.492652,Desayunos · Panadería,Siena Café,13600,3700,17300
4351,4352,21-10-2020 15:00:06.810499,Saludable,The Good Rice Bowls,24300,3500,27800
4352,4353,21-10-2020 15:00:07.128168,Desayunos · Parrilla,Mi Patria,9000,4600,13600
4353,4354,21-10-2020 15:00:07.446052,Desayunos,Butter,11870,6700,18570
4354,4355,21-10-2020 15:00:07.563743,Pollo · Saludable,Gratina,13600,4200,17800
4355,4356,21-10-2020 15:00:07.731190,Parrilla,Arepaisa de Medellín,23000,5600,28600
4356,4357,21-10-2020 15:00:07.949825,Sánduches · Pescados y Mariscos,Pacific Comida de Mar,11870,4000,15870
4357,4358,21-10-2020 15:00:08.167631,Parrilla,Carnes la Zarza,53900,4900,58800
4358,4359,21-10-2020 15:00:08.535280,Típica,La Herencia,18900,5900,24800
4359,4360,21-10-2020 15:00:08.853079,Postres · Desayunos,Restaurante Cornelia,34500,5500,40000
4360,4361,21-10-2020 15:00:09.120768,Postres · Desayunos,Amelie Helados,35000,6400,41400
4361,4362,21-10-2020 15:00:09.338220,Saludable · Desayunos,Re.al Alimentos Reales,35000,4000,39000
4362,4363,21-10-2020 15:00:09.706005,Típica,Sabores De Mi Tierra,70000,5400,75400
4363,4364,21-10-2020 15:00:10.023673,Italiana,F*cking Good Pizza,39700,4200,43900
4364,4365,21-10-2020 15:00:10.241209,Hamburguesas,Monchis - Hamburguesa,48750,4300,53050
4365,4366,21-10-2020 15:00:10.458671,Saludable · Desayunos,Bawana - Sandwich,10700,3400,14100
4366,4367,21-10-2020 15:00:10.676276,Mexicana,La leyenda mexican kitchen,53400,3200,56600
4367,4368,21-10-2020 15:00:10.893904,Desayunos · Café,Moramia,53900,4700,58600
4368,4369,21-10-2020 15:00:11.061282,Desayunos · Panadería,Artesanos,31800,4300,36100
4369,4370,21-10-2020 15:00:11.328867,Postres · Desayunos,Gelateria Da Favola,53900,6500,60400
4370,4371,21-10-2020 15:00:11.446538,Saludable · Desayunos,Básico y Elemental,9000,5900,14900
4371,4372,21-10-2020 15:00:11.664478,Peruana,Uma Cantina Peruana,9000,3200,12200
4372,4373,21-10-2020 15:00:11.882023,Asiática,Thai Station,27800,6000,33800
4373,4374,21-10-2020 15:00:11.999380,Mexicana,Hidalgo Taquería,24200,4900,29100
4374,4375,21-10-2020 15:00:12.267086,Parrilla · Internacional,Taperia de la Plaza,18900,5700,24600
4375,4376,21-10-2020 15:00:12.584941,Postres · Desayunos,Sharmus,17800,6100,23900
4376,4377,21-10-2020 15:00:12.902695,Desayunos · Típica,Cochon,24200,3300,27500
4377,4378,21-10-2020 15:00:13.170401,Desayunos · Típica,Peninsula Calentados y Parrilla,24200,3400,27600
4378,4379,21-10-2020 15:00:13.438181,Internacional,La Esquina con Sabor Parrilla,23000,3000,26000
4379,4380,21-10-2020 15:00:13.755923,Postres · Desayunos,Cosmo Cookies,24200,5900,30100
4380,4381,21-10-2020 15:00:14.023801,Desayunos · Típica,Fogón Sangileño,15600,5000,20600
4381,4382,21-10-2020 15:00:14.291419,Peruana,Uma Cantina Peruana,65000,3200,68200
4382,4383,21-10-2020 15:00:14.409018,Saludable · Desayunos,Libre de Culpa,48750,4000,52750
4383,4384,21-10-2020 15:00:14.626916,Desayunos · Árabe,Boniato Sabores Vivos,34500,5300,39800
4384,4385,21-10-2020 15:00:14.844626,Saludable · Desayunos,Básico y elemental,35000,5000,40000
4385,4386,21-10-2020 15:00:14.962260,Desayunos · Panadería,Limarys,18900,6500,25400
4386,4387,21-10-2020 15:00:15.179912,Saludable,The Good Rice Bowls,53900,3500,57400
4387,4388,21-10-2020 15:00:15.297778,Hamburguesas,Bendito Cordero,35000,5800,40800
4388,4389,21-10-2020 15:00:15.415350,Postres · Desayunos,Protein Bakes,29500,5900,35400
4389,4390,21-10-2020 15:00:15.683127,Desayunos · Café,Moramia,18900,4700,23600
4390,4391,21-10-2020 15:00:16.000875,Saludable,Puro Verde,11870,5700,17570
4391,4392,21-10-2020 15:00:16.368665,Típica · Parrilla,La Ternera Parrilla,13600,5200,18800
4392,4393,21-10-2020 15:00:16.686732,Comida Rápida · Perros Calientes,Similoa - Comida Rapida,23000,3700,26700
4393,4394,21-10-2020 15:00:16.904398,Típica,Salsig,31800,5600,37400
4394,4395,21-10-2020 15:00:17.222455,Saludable,Puro Verde,48750,5700,54450
4395,4396,21-10-2020 15:00:17.340032,Helados,Buon Gelato,65000,4400,69400
4396,4397,21-10-2020 15:00:17.658053,Saludable · Desayunos,Guadalupe - Fruteria,48750,5900,54650
4397,4398,21-10-2020 15:00:17.826513,Postres · Panadería,RIGHT AWAY FOODS,23000,6600,29600
4398,4399,21-10-2020 15:00:18.195530,Desayunos · Empanadas,Mis Delicias,9000,3200,12200
4399,4400,21-10-2020 15:00:18.313607,Desayunos · Panadería,Siena Café,23000,3700,26700
4400,4401,21-10-2020 15:00:18.631688,Parrilla · Café,Gaira Café,13000,4400,17400
4401,4402,21-10-2020 15:00:18.800206,Pizza · Italiana,Pisapore - Pizza,48750,6600,55350
4402,4403,21-10-2020 15:00:18.918150,Típica,Sopitas y Más,39700,4200,43900
4403,4404,21-10-2020 15:00:19.035956,Postres · Desayunos,Buñuelos nacho,7500,6600,14100
4404,4405,21-10-2020 15:00:19.203886,Parrilla,Beraca Parrilla Bbq,35000,5600,40600
4405,4406,21-10-2020 15:00:19.372217,Desayunos · Panadería,Limarys,9000,6500,15500
4406,4407,21-10-2020 15:00:19.540122,Desayunos · Panadería,Artesanos,70000,4300,74300
4407,4408,21-10-2020 15:00:19.858228,Parrilla,Restaurante Bar Mi Ranchito,37900,5200,43100
4408,4409,21-10-2020 15:00:20.026180,Pizza,18 Scalini,8900,4300,13200
4409,4410,21-10-2020 15:00:20.294677,Pollo · Sánduches,Pollos Century,7500,3000,10500
4410,4411,21-10-2020 15:00:20.612821,Pizza,pizza andante,29500,4200,33700
4411,4412,21-10-2020 15:00:20.780657,Desayunos · Café,Matchacha,37900,5900,43800
4412,4413,21-10-2020 15:00:20.948390,Desayunos · Café,Frambas,37900,3400,41300
4413,4414,21-10-2020 15:00:21.267126,Pollo · Sánduches,Pollos Century,9000,3000,12000
4414,4415,21-10-2020 15:00:21.535181,Postres · Desayunos,Maria Luisa - Postres,23000,4300,27300
4415,4416,21-10-2020 15:00:21.753179,Típica,La Cocina,35000,4600,39600
4416,4417,21-10-2020 15:00:22.071427,Pollo · Desayunos,Abasto,15000,3600,18600
4417,4418,21-10-2020 15:00:22.289997,Típica · Parrilla,Mi Ranchito Parrilla,37900,4400,42300
4418,4419,21-10-2020 15:00:22.507945,Desayunos,Fratelli - Desayunos,34500,4600,39100
4419,4420,21-10-2020 15:00:22.775981,Desayunos · Café,El Gualilo,15000,6200,21200
4420,4421,21-10-2020 15:00:23.094136,Saludable · Desayunos,Libre de Culpa,35000,4000,39000
4421,4422,21-10-2020 15:00:23.363711,Típica,Sabores De Mi Tierra,15000,5400,20400
4422,4423,21-10-2020 15:00:23.531814,Alta Cocina · Postres,La Pinta,37900,4500,42400
4423,4424,21-10-2020 15:00:23.699685,Típica · Pescados y Mariscos,Arroces Mrg,35000,4300,39300
4424,4425,21-10-2020 15:00:24.017811,Desayunos · Panadería,Artesanos,24300,4300,28600
4425,4426,21-10-2020 15:00:24.236455,Postres,La Galeta,12500,3000,15500
4426,4427,21-10-2020 15:00:24.404531,Parrilla,Coquitas,37900,5600,43500
4427,4428,21-10-2020 15:00:24.722882,Típica · Parrilla,Mi Ranchito Parrilla,15600,4400,20000
4428,4429,21-10-2020 15:00:24.890737,Desayunos,Don Leo,27800,6000,33800
4429,4430,21-10-2020 15:00:25.109355,Típica,La Herencia,23000,5900,28900
4430,4431,21-10-2020 15:00:25.477398,Saludable,MIMA,17800,3700,21500
4431,4432,21-10-2020 15:00:25.695481,Desayunos · Típica,D´Porco,35000,3900,38900
4432,4433,21-10-2020 15:00:25.813304,Postres · Desayunos,La Folie - Postres,15000,3300,18300
4433,4434,21-10-2020 15:00:26.081670,Postres · Desayunos,Sharmus,13600,6100,19700
4434,4435,21-10-2020 15:00:26.199516,Hamburguesas,Burger Society,45800,4100,49900
4435,4436,21-10-2020 15:00:26.467493,Desayunos · Panadería,Ficchi Panadería,24200,3100,27300
4436,4437,21-10-2020 15:00:26.635610,Desayunos · Café,vereda central calle 99,15600,5700,21300
4437,4438,21-10-2020 15:00:26.754241,Sushi · Asiática,Arigato,27800,5300,33100
4438,4439,21-10-2020 15:00:27.072426,Alta Cocina · Parrilla,Criterión,70000,6000,76000
4439,4440,21-10-2020 15:00:27.190350,Comida Rápida,Fiesta Digital Andrés,18900,3100,22000
4440,4441,21-10-2020 15:00:27.408655,Desayunos · Típica,D´Porco,23000,3900,26900
4441,4442,21-10-2020 15:00:27.527104,Postres · Desayunos,La Folie - Postres,65000,3300,68300
4442,4443,21-10-2020 15:00:27.845278,Postres · Desayunos,Sweet Tale,45800,5800,51600
4443,4444,21-10-2020 15:00:28.063107,Hamburguesas · Desayunos,El Inglés Gastro Pub,35000,6600,41600
4444,4445,21-10-2020 15:00:28.181057,Pollo · Típica,Auyama,23000,3900,26900
4445,4446,21-10-2020 15:00:28.450613,Saludable · Desayunos,Fresh Co,18900,5600,24500
4446,4447,21-10-2020 15:00:28.668803,Pollo,Oliva Va,7500,5600,13100
4447,4448,21-10-2020 15:00:28.936874,Desayunos · Típica,Casa Vieja,8900,6000,14900
4448,4449,21-10-2020 15:00:29.104998,Pollo · Desayunos,Abasto,31800,3600,35400
4449,4450,21-10-2020 15:00:29.323560,Pollo · Desayunos,Abasto,27800,3600,31400
4450,4451,21-10-2020 15:00:29.691883,Postres · Café,Celestino Café,8900,5900,14800
4451,4452,21-10-2020 15:00:30.060304,Típica,Salsig,13600,5600,19200
4452,4453,21-10-2020 15:00:30.328618,Hamburguesas,Gofi Burger,29500,5100,34600
4453,4454,21-10-2020 15:00:30.697288,Hamburguesas · Panadería,NYC Burgers,34500,6200,40700
4454,4455,21-10-2020 15:00:30.865312,Desayunos · Sánduches,Frutos del Bosque,48750,3500,52250
4455,4456,21-10-2020 15:00:30.983215,Postres,Levelma,18900,6200,25100
4456,4457,21-10-2020 15:00:31.251300,Comida Rápida,Fiesta Digital Andrés,45800,3100,48900
4457,4458,21-10-2020 15:00:31.620140,Desayunos · Típica,La Frijolada,8900,4500,13400
4458,4459,21-10-2020 15:00:31.988654,Parrilla,Restaurante Bar Mi Ranchito,24300,5200,29500
4459,4460,21-10-2020 15:00:32.206728,Postres · Desayunos,BagBog Bagels,12500,6400,18900
4460,4461,21-10-2020 15:00:32.575089,Postres · Desayunos,Cosmo Cookies,35000,5900,40900
4461,4462,21-10-2020 15:00:32.693842,Saludable · Desayunos,La Cesta,8900,4700,13600
4462,4463,21-10-2020 15:00:33.062144,Jugos y Batidos,Pomponio,13600,3600,17200
4463,4464,21-10-2020 15:00:33.280142,Pollo · Desayunos,Workzone,18900,3100,22000
4464,4465,21-10-2020 15:00:33.649839,Pollo · Sánduches,Pollos Century,35000,3000,38000
4465,4466,21-10-2020 15:00:33.968861,Pollo · Desayunos,Abasto,10700,3600,14300
4466,4467,21-10-2020 15:00:34.337116,Saludable · Desayunos,Agua Dulce,10700,3700,14400
4467,4468,21-10-2020 15:00:34.705394,Pescados y Mariscos,Pescadero Héroes del Mar,24200,6600,30800
4468,4469,21-10-2020 15:00:34.923547,Saludable,MIMA,70000,3700,73700
4469,4470,21-10-2020 15:00:35.092206,Postres · Desayunos,La Folie - Postres,24200,3300,27500
4470,4471,21-10-2020 15:00:35.260407,Desayunos,La Frijolada Desayunos,9000,4400,13400
4471,4472,21-10-2020 15:00:35.528744,Desayunos · Jugos y Batidos,Kuriwaji,35000,6300,41300
4472,4473,21-10-2020 15:00:35.796916,Desayunos,Sr Buñuelo,13000,6400,19400
4473,4474,21-10-2020 15:00:36.166119,Crepes,San Crepes,35000,4900,39900
4474,4475,21-10-2020 15:00:36.334311,Pollo · Pescados y Mariscos,Bang Bang Rice,18900,3400,22300
4475,4476,21-10-2020 15:00:36.702507,Italiana,F*cking Good Pizza,7500,4200,11700
4476,4477,21-10-2020 15:00:36.970708,Parrilla,OAK Ahumado y Brebajes,23000,6000,29000
4477,4478,21-10-2020 15:00:37.289679,Desayunos · Mexicana,La Mera Mera - Mexicana,7500,3100,10600
4478,4479,21-10-2020 15:00:37.407773,Desayunos · Típica,Alce,37900,4900,42800
4479,4480,21-10-2020 15:00:37.676174,Desayunos,El Fogón Castellano,15600,3200,18800
4480,4481,21-10-2020 15:00:37.844612,Típica · Parrilla,Typykos,7500,6000,13500
4481,4482,21-10-2020 15:00:37.963195,Hamburguesas · Panadería,NYC Burgers,37900,6200,44100
4482,4483,21-10-2020 15:00:38.181404,Desayunos · Panadería,El Pan de Phillippe,15000,4600,19600
4483,4484,21-10-2020 15:00:38.299328,Típica,El Cucharón - Tipica,70000,4400,74400
4484,4485,21-10-2020 15:00:38.567591,Sushi · Asiática,Arigato,10700,5300,16000
4485,4486,21-10-2020 15:00:38.687397,Desayunos,Sr Buñuelo,65000,6400,71400
4486,4487,21-10-2020 15:00:38.905689,Pollo · Sánduches,Pollos Century,24200,3000,27200
4487,4488,21-10-2020 15:00:39.123828,Desayunos · Panadería,Artesanos,65000,4300,69300
4488,4489,21-10-2020 15:00:39.492224,Saludable · Desayunos,Bawana - Sandwich,24300,3400,27700
4489,4490,21-10-2020 15:00:39.760998,Saludable · Jugos y Batidos,Berdes Drinks & Salads,34500,3500,38000
4490,4491,21-10-2020 15:00:39.879286,Postres · Desayunos,Amelie Helados,15000,6400,21400
4491,4492,21-10-2020 15:00:40.147593,Pollo · Desayunos,Abasto,11870,3600,15470
4492,4493,21-10-2020 15:00:40.515917,Peruana · Internacional,La Chifería,23000,6600,29600
4493,4494,21-10-2020 15:00:40.834787,Típica · Parrilla,La Parilla de David,34500,3100,37600
4494,4495,21-10-2020 15:00:41.103122,Desayunos · Café,Frambas,31800,3400,35200
4495,4496,21-10-2020 15:00:41.421557,Saludable · Desayunos,Agua Dulce,35000,3700,38700
4496,4497,21-10-2020 15:00:41.589813,Café · Helados,Sofia heladería y café,35000,5800,40800
4497,4498,21-10-2020 15:00:41.758677,Saludable · Desayunos,Malú,34500,3700,38200
4498,4499,21-10-2020 15:00:41.876979,Desayunos · Jugos y Batidos,Frutiwow,23000,4100,27100
4499,4500,21-10-2020 15:00:41.995008,Desayunos · Típica,Alce,15600,4900,20500
4500,4501,21-10-2020 15:00:42.163268,Parrilla,Parrilla Pimentón,8900,3400,12300
4501,4502,21-10-2020 15:00:42.432204,Desayunos · Italiana,Rceta By Rausch,12500,3600,16100
4502,4503,21-10-2020 15:00:42.650672,Saludable · Desayunos,Re.al Alimentos Reales,24200,4000,28200
4503,4504,21-10-2020 15:00:42.918942,Desayunos · Café,vereda central calle 99,48750,5700,54450
4504,4505,21-10-2020 15:00:43.036939,Desayunos · Pescados y Mariscos,Luzí­a - Mediterranea,39700,5700,45400
4505,4506,21-10-2020 15:00:43.355862,Desayunos,Desayunos en Bogotá,37900,3400,41300
4506,4507,21-10-2020 15:00:43.524017,Saludable · Desayunos,Bawana - Sandwich,53900,3400,57300
4507,4508,21-10-2020 15:00:43.743221,Sushi · Asiática,Arigato,45800,5300,51100
4508,4509,21-10-2020 15:00:43.911495,Pollo,Señor Fantástico,13600,4700,18300
4509,4510,21-10-2020 15:00:44.230450,Desayunos · Café,Moramia,17800,4700,22500
4510,4511,21-10-2020 15:00:44.548758,Desayunos,Sunny Breakfast Brunch,48750,4300,53050
4511,4512,21-10-2020 15:00:44.867082,Típica,El Mondongo y Mucho Mas,53900,5600,59500
4512,4513,21-10-2020 15:00:45.085418,Saludable · Típica,Sopas Mrg,11870,3100,14970
4513,4514,21-10-2020 15:00:45.354111,Desayunos · Café,Aromacafé el Placer de Compartir,13000,5000,18000
4514,4515,21-10-2020 15:00:45.572284,Típica · Parrilla,La Parilla de David,11870,3100,14970
4515,4516,21-10-2020 15:00:45.790403,Desayunos · Jugos y Batidos,Dont Be Hungry,27800,5600,33400
4516,4517,21-10-2020 15:00:45.958477,Pollo · Desayunos,Workzone,45800,3100,48900
4517,4518,21-10-2020 15:00:46.076924,Desayunos · Jugos y Batidos,Dont Be Hungry,37900,5600,43500
4518,4519,21-10-2020 15:00:46.345306,Típica · Parrilla,Mi Ranchito Parrilla,10700,4400,15100
4519,4520,21-10-2020 15:00:46.613476,Desayunos · Sánduches,Garnish,17800,5200,23000
4520,4521,21-10-2020 15:00:46.831607,Mexicana,La leyenda mexican kitchen,8900,3200,12100
4521,4522,21-10-2020 15:00:47.000192,Postres,Levelma,34500,6200,40700
4522,4523,21-10-2020 15:00:47.218377,Desayunos · Helados,San Giorgio Gelateria,31800,3100,34900
4523,4524,21-10-2020 15:00:47.536742,Típica,La Herencia,18900,5900,24800
4524,4525,21-10-2020 15:00:47.855004,Desayunos · Pescados y Mariscos,Gypsy Bistro,12500,4500,17000
4525,4526,21-10-2020 15:00:48.173849,Desayunos · Café,Aromacafé el Placer de Compartir,70000,5000,75000
4526,4527,21-10-2020 15:00:48.292032,Desayunos · Panadería,Pasteleite,10700,5900,16600
4527,4528,21-10-2020 15:00:48.410054,Desayunos · Pescados y Mariscos,Gypsy Bistro,35000,4500,39500
4528,4529,21-10-2020 15:00:48.728406,Desayunos,Sunny Breakfast Brunch,35000,4300,39300
4529,4530,21-10-2020 15:00:48.898119,Saludable · Parrilla,Box,18900,3700,22600
4530,4531,21-10-2020 15:00:49.166420,Postres · Saludable,Ana Rebana,45800,6300,52100
4531,4532,21-10-2020 15:00:49.334505,Parrilla,Rústico Picadería,39700,3800,43500
4532,4533,21-10-2020 15:00:49.502566,Sushi · Asiática,Arigato,12500,5300,17800
4533,4534,21-10-2020 15:00:49.871497,Postres · Desayunos,Maltihelados,39700,6200,45900
4534,4535,21-10-2020 15:00:49.989703,Postres · Desayunos,Cosmo Cookies,15000,5900,20900
4535,4536,21-10-2020 15:00:50.307907,Saludable · Desayunos,Fresh Co,53400,5600,59000
4536,4537,21-10-2020 15:00:50.626515,Postres · Desayunos,Protein Bakes,24300,5900,30200
4537,4538,21-10-2020 15:00:50.845355,Alta Cocina · Italiana,Trattoria de la Plaza,27800,6000,33800
4538,4539,21-10-2020 15:00:51.163743,Desayunos · Café,Norma's Ice Cream Café,11870,6300,18170
4539,4540,21-10-2020 15:00:51.332134,Postres · Desayunos,Sharmus,15000,6100,21100
4540,4541,21-10-2020 15:00:51.550685,Típica,Sabrosito,13600,4000,17600
4541,4542,21-10-2020 15:00:51.869999,Desayunos · Internacional,Camilia,11870,3900,15770
4542,4543,21-10-2020 15:00:52.138844,Pollo · Pescados y Mariscos,Bang Bang Rice,48750,3400,52150
4543,4544,21-10-2020 15:00:52.507651,Saludable,MIMA,13000,3700,16700
4544,4545,21-10-2020 15:00:52.626408,Desayunos · Típica,90 Calentados,18900,3700,22600
4545,4546,21-10-2020 15:00:52.795238,Saludable · Desayunos,Malú,12500,3700,16200
4546,4547,21-10-2020 15:00:52.913532,Pollo · Desayunos,Workzone,31800,3100,34900
4547,4548,21-10-2020 15:00:53.081861,Desayunos · Típica,La Parrilla Dorada Polo,11870,6600,18470
4548,4549,21-10-2020 15:00:53.350429,Pescados y Mariscos,Fish Place - Del Mar,11870,5400,17270
4549,4550,21-10-2020 15:00:53.569456,Poke,Poke Go,9000,4600,13600
4550,4551,21-10-2020 15:00:53.687899,Pollo · Saludable,Tremenda Sal y Dulce,7500,6500,14000
4551,4552,21-10-2020 15:00:53.806419,Desayunos · Pescados y Mariscos,Gypsy Bistro,12500,4500,17000
4552,4553,21-10-2020 15:00:54.126318,Postres · Desayunos,Maria Luisa - Postres,12500,4300,16800
4553,4554,21-10-2020 15:00:54.245288,Mexicana,La leyenda mexican kitchen,70000,3200,73200
4554,4555,21-10-2020 15:00:54.363437,Saludable · Desayunos,Bawana - Sandwich,17800,3400,21200
4555,4556,21-10-2020 15:00:54.531756,Sánduches · Pescados y Mariscos,Pacific Comida de Mar,35000,4000,39000
4556,4557,21-10-2020 15:00:54.850403,Parrilla,Arepaisa de Medellín,15600,5600,21200
4557,4558,21-10-2020 15:00:54.969495,Parrilla,El Tambor,45800,6800,52600
4558,4559,21-10-2020 15:00:55.288047,Desayunos,Butter,35000,6700,41700
4559,4560,21-10-2020 15:00:55.556333,Postres,Beiked,18900,4000,22900
4560,4561,21-10-2020 15:00:55.874908,Parrilla,Carnes la Zarza,29500,4900,34400
4561,4562,21-10-2020 15:00:56.093959,Saludable · Desayunos,Guadalupe - Fruteria,24200,5900,30100
4562,4563,21-10-2020 15:00:56.262633,Desayunos · Típica,Rojo Gourmet,45800,4700,50500
4563,4564,21-10-2020 15:00:56.381329,Saludable · Desayunos,Básico y elemental,35000,5000,40000
4564,4565,21-10-2020 15:00:56.700040,Parrilla,Rústico Picadería,45800,3800,49600
4565,4566,21-10-2020 15:00:56.818972,Pizza · Parrilla,Urban Lunch,7500,4000,11500
4566,4567,21-10-2020 15:00:56.937219,Pollo · Sánduches,Pollos Century,35000,3000,38000
4567,4568,21-10-2020 15:00:57.255614,Pollo,Oliva Va,48750,5600,54350
4568,4569,21-10-2020 15:00:57.624075,Asiática,Thai Station,48750,6000,54750
4569,4570,21-10-2020 15:00:57.993187,Parrilla · Café,Gaira Café,9000,4400,13400
4570,4571,21-10-2020 15:00:58.311596,Pescados y Mariscos,La Gran Cazuela,24300,3200,27500
4571,4572,21-10-2020 15:00:58.480082,Postres · Desayunos,Gelateria Da Favola,39700,6500,46200
4572,4573,21-10-2020 15:00:58.698362,Saludable · Desayunos,Raices Bienestar Gourmet,7500,6600,14100
4573,4574,21-10-2020 15:00:58.867202,Saludable · Desayunos,Malú,13600,3700,17300
4574,4575,21-10-2020 15:00:59.186730,Internacional,Rio Sabores y Experiencias,45800,4100,49900
4575,4576,21-10-2020 15:00:59.405099,Panadería,Boul,10700,3100,13800
4576,4577,21-10-2020 15:00:59.673633,Parrilla,Arepaisa de Medellín,53900,5600,59500
4577,4578,21-10-2020 15:00:59.942450,Típica · Parrilla,Typykos,9000,6000,15000
4578,4579,21-10-2020 15:01:00.311090,Típica,El Mondongo y Mucho Mas,37900,5600,43500
4579,4580,21-10-2020 15:01:00.429395,Saludable · Desayunos,Maracuyá,31800,6700,38500
4580,4581,21-10-2020 15:01:00.747786,Saludable · Desayunos,Copacabana Açai Bowls,34500,3000,37500
4581,4582,21-10-2020 15:01:00.866990,Saludable · Parrilla,The Angels Grill and Drinks,23000,6200,29200
4582,4583,21-10-2020 15:01:01.185725,Desayunos,Fratelli - Desayunos,45800,4600,50400
4583,4584,21-10-2020 15:01:01.403844,Desayunos · Helados,San Giorgio Gelateria,23000,3100,26100
4584,4585,21-10-2020 15:01:01.772557,Pollo,Señor Fantástico,70000,4700,74700
4585,4586,21-10-2020 15:01:02.041621,Típica · Pescados y Mariscos,La Vitualla,13600,6300,19900
4586,4587,21-10-2020 15:01:02.410064,Desayunos · Típica,D'Porco - Lechona,27800,6300,34100
4587,4588,21-10-2020 15:01:02.578366,Pizza · Parrilla,Urban Lunch,27800,4000,31800
4588,4589,21-10-2020 15:01:02.696774,Desayunos,Fratelli - Desayunos,65000,4600,69600
4589,4590,21-10-2020 15:01:03.015799,Desayunos · Café,vereda central calle 99,17800,5700,23500
4590,4591,21-10-2020 15:01:03.334159,Desayunos · Italiana,Rceta By Rausch,39700,3600,43300
4591,4592,21-10-2020 15:01:03.602637,Desayunos · Café,El Gualilo,24200,6200,30400
4592,4593,21-10-2020 15:01:03.720987,Sánduches,Submarin,37900,3800,41700
4593,4594,21-10-2020 15:01:04.040027,Crepes,San Crepes,35000,4900,39900
4594,4595,21-10-2020 15:01:04.309778,Desayunos · Panadería,Decofruta,11870,4700,16570
4595,4596,21-10-2020 15:01:04.477968,Desayunos · Sánduches,Garnish,15000,5200,20200
4596,4597,21-10-2020 15:01:04.646396,Pollo · Saludable,Yerbabuena,12500,3900,16400
4597,4598,21-10-2020 15:01:04.865282,Desayunos · Panadería,Artesanos,23000,4300,27300
4598,4599,21-10-2020 15:01:05.083543,Sushi · Asiática,Arigato,34500,5300,39800
4599,4600,21-10-2020 15:01:05.252106,Postres,La Galeta,24200,3000,27200
4600,4601,21-10-2020 15:01:05.370739,Desayunos · Panadería,Le Pain Quotidien,65000,3900,68900
4601,4602,21-10-2020 15:01:05.539812,Desayunos · Pescados y Mariscos,Luzí­a - Mediterranea,53400,5700,59100
4602,4603,21-10-2020 15:01:05.658467,Pizza,Pastas Laurentina,65000,4800,69800
4603,4604,21-10-2020 15:01:05.876842,Típica,Bandejas Mrg,12500,3800,16300
4604,4605,21-10-2020 15:01:06.245463,Mexicana,Hidalgo Taquería,17800,4900,22700
4605,4606,21-10-2020 15:01:06.614646,Pizza,18 Scalini,7500,4300,11800
4606,4607,21-10-2020 15:01:06.733103,Típica,Cazuelitas 93,17800,3900,21700
4607,4608,21-10-2020 15:01:06.951464,Saludable · Desayunos,Bawana - Sandwich,23000,3400,26400
4608,4609,21-10-2020 15:01:07.069788,Desayunos · Típica,La Frijolada,23000,4500,27500
4609,4610,21-10-2020 15:01:07.288700,Desayunos,Butter,31800,6700,38500
4610,4611,21-10-2020 15:01:07.507171,Postres · Desayunos,Buñuelos nacho,7500,6600,14100
4611,4612,21-10-2020 15:01:07.875758,Pizza · Parrilla,Urban Lunch,70000,4000,74000
4612,4613,21-10-2020 15:01:08.194423,Pescados y Mariscos,La Gran Cazuela,8900,3200,12100
4613,4614,21-10-2020 15:01:08.563634,Alta Cocina · Italiana,Trattoria de la Plaza,11870,6000,17870
4614,4615,21-10-2020 15:01:08.682175,Postres · Panadería,RIGHT AWAY FOODS,34500,6600,41100
4615,4616,21-10-2020 15:01:09.050861,Saludable · Desayunos,La Estampilla,53900,6000,59900
4616,4617,21-10-2020 15:01:09.169345,Hamburguesas,Gofi Burger,24300,5100,29400
4617,4618,21-10-2020 15:01:09.489440,Típica,La Herencia,17800,5900,23700
4618,4619,21-10-2020 15:01:09.607960,Hamburguesas,Monchis - Hamburguesa,34500,4300,38800
4619,4620,21-10-2020 15:01:09.976695,Desayunos · Sánduches,Frutos del Bosque,17800,3500,21300
4620,4621,21-10-2020 15:01:10.195303,Desayunos · Helados,San Giorgio Gelateria,24300,3100,27400
4621,4622,21-10-2020 15:01:10.564550,Parrilla,OAK Ahumado y Brebajes,29500,6000,35500
4622,4623,21-10-2020 15:01:10.933073,Típica,Bandejas Mrg,37900,3800,41700
4623,4624,21-10-2020 15:01:11.101538,Típica,Bendita S,70000,4600,74600
4624,4625,21-10-2020 15:01:11.269974,Saludable,Amor Propio saludable,8900,4000,12900
4625,4626,21-10-2020 15:01:11.439091,Desayunos · Parrilla,Mi Patria,27800,4600,32400
4626,4627,21-10-2020 15:01:11.658074,Parrilla,Restaurante Bar Mi Ranchito,7500,5200,12700
4627,4628,21-10-2020 15:01:11.976616,Comida Rápida,Fiesta Digital Andrés,15000,3100,18100
4628,4629,21-10-2020 15:01:12.245103,Típica,Sabores De Mi Tierra,7500,5400,12900
4629,4630,21-10-2020 15:01:12.364032,Desayunos · Panadería,Premium Break Bakery,35000,3700,38700
4630,4631,21-10-2020 15:01:12.632847,Panadería,Boul,15600,3100,18700
4631,4632,21-10-2020 15:01:12.951433,Sushi,Sushi Reel,65000,4700,69700
4632,4633,21-10-2020 15:01:13.170005,Típica,Cabrito Santandereano,15000,6600,21600
4633,4634,21-10-2020 15:01:13.288992,Hamburguesas · Saludable,Restaurant Inn,53900,6100,60000
4634,4635,21-10-2020 15:01:13.457832,Hamburguesas,Monchis - Hamburguesa,53900,4300,58200
4635,4636,21-10-2020 15:01:13.776686,Pollo,Señor Fantástico,18900,4700,23600
4636,4637,21-10-2020 15:01:13.945567,Desayunos,Don Leo,70000,6000,76000
4637,4638,21-10-2020 15:01:14.064578,Pizza · Italiana,Piatto - Pizza,45800,6600,52400
4638,4639,21-10-2020 15:01:14.433298,Típica · Pescados y Mariscos,Arroces Mrg,24200,4300,28500
4639,4640,21-10-2020 15:01:14.652866,Desayunos · Típica,Desayunadero de la 42,53400,5900,59300
4640,4641,21-10-2020 15:01:14.871565,Típica · Parrilla,Toya,9000,4200,13200
4641,4642,21-10-2020 15:01:15.190776,Desayunos,Butter,29500,6700,36200
4642,4643,21-10-2020 15:01:15.409482,Desayunos · Panadería,Pasteleite,31800,5900,37700
4643,4644,21-10-2020 15:01:15.627950,Típica,Bendita S,15600,4600,20200
4644,4645,21-10-2020 15:01:15.746513,Sushi · Asiática,Arigato,39700,5300,45000
4645,4646,21-10-2020 15:01:16.065794,Saludable · Típica,Sopas Mrg,39700,3100,42800
4646,4647,21-10-2020 15:01:16.234289,Parrilla · Internacional,Taperia de la Plaza,13000,5700,18700
4647,4648,21-10-2020 15:01:16.352744,Típica,Juan Chorizo,7500,3900,11400
4648,4649,21-10-2020 15:01:16.621430,Desayunos,Don Leo,13000,6000,19000
4649,4650,21-10-2020 15:01:16.840292,Postres · Panadería,RIGHT AWAY FOODS,23000,6600,29600
4650,4651,21-10-2020 15:01:17.209081,Típica,Sabores De Mi Tierra,23000,5400,28400
4651,4652,21-10-2020 15:01:17.427794,Desayunos · Mexicana,La Mera Mera - Mexicana,70000,3100,73100
4652,4653,21-10-2020 15:01:17.646572,Típica,Salsig,39700,5600,45300
4653,4654,21-10-2020 15:01:17.865771,Pizza,Pizza Andante,15000,6300,21300
4654,4655,21-10-2020 15:01:17.984325,Desayunos · Típica,Fogón Sangileño,53400,5000,58400
4655,4656,21-10-2020 15:01:18.253020,Saludable · Desayunos,Básico y Elemental,17800,5900,23700
4656,4657,21-10-2020 15:01:18.371694,Hamburguesas,Bendito Cordero,39700,5800,45500
4657,4658,21-10-2020 15:01:18.741090,Desayunos · Internacional,Camilia,8900,3900,12800
4658,4659,21-10-2020 15:01:19.059738,Saludable,MIMA,9000,3700,12700
4659,4660,21-10-2020 15:01:19.328470,Pollo,Heart & Cooking,53400,5000,58400
4660,4661,21-10-2020 15:01:19.497107,Postres · Desayunos,Vivalight Market.,8900,6500,15400
4661,4662,21-10-2020 15:01:19.667562,Postres · Desayunos,Sweet Tale,53400,5800,59200
4662,4663,21-10-2020 15:01:19.886397,Postres · Desayunos,KOKOA & co.,7500,4700,12200
4663,4664,21-10-2020 15:01:20.105273,Saludable · Jugos y Batidos,Berdes Drinks & Salads,70000,3500,73500
4664,4665,21-10-2020 15:01:20.273892,Pollo · Desayunos,Abasto,35000,3600,38600
4665,4666,21-10-2020 15:01:20.443166,Desayunos,El Fogón Castellano,34500,3200,37700
4666,4667,21-10-2020 15:01:20.762189,Pollo · Desayunos,Piaf,7500,6500,14000
4667,4668,21-10-2020 15:01:21.080904,Saludable · Desayunos,Fresh Co,29500,5600,35100
4668,4669,21-10-2020 15:01:21.299575,Postres · Desayunos,KOKOA & co.,23000,4700,27700
4669,4670,21-10-2020 15:01:21.619033,Desayunos,Don Leo,65000,6000,71000
4670,4671,21-10-2020 15:01:21.837765,Desayunos · Café,Frambas,24200,3400,27600
4671,4672,21-10-2020 15:01:22.006136,Desayunos · Típica,Papadió - Colombianas,29500,5700,35200
4672,4673,21-10-2020 15:01:22.224728,Saludable · Típica,Sopas Mrg,39700,3100,42800
4673,4674,21-10-2020 15:01:22.343908,Mexicana,Cantina La 15,27800,4300,32100
4674,4675,21-10-2020 15:01:22.562921,Hamburguesas · Pescados y Mariscos,El Velero,24300,6500,30800
4675,4676,21-10-2020 15:01:22.782233,Postres · Desayunos,La Folie - Postres,34500,3300,37800
4676,4677,21-10-2020 15:01:23.151375,Parrilla · Café,Gaira Café,70000,4400,74400
4677,4678,21-10-2020 15:01:23.521569,Postres · Desayunos,Protein Bakes,7500,5900,13400
4678,4679,21-10-2020 15:01:23.640613,Desayunos,Butter,45800,6700,52500
4679,4680,21-10-2020 15:01:24.010232,Desayunos · Panadería,Le Pain Quotidien,17800,3900,21700
4680,4681,21-10-2020 15:01:24.129690,Saludable · Desayunos,Básico y elemental,53900,5000,58900
4681,4682,21-10-2020 15:01:24.499079,Parrilla,El Tambor,37900,6800,44700
4682,4683,21-10-2020 15:01:24.819651,Pizza · Italiana,Pisapore - Pizza,13600,6600,20200
4683,4684,21-10-2020 15:01:24.938318,Comida Rápida,Fiesta Digital Andrés,7500,3100,10600
4684,4685,21-10-2020 15:01:25.158057,Postres · Desayunos,Maria Luisa - Postres,24300,4300,28600
4685,4686,21-10-2020 15:01:25.377800,Desayunos · Típica,Calentao Express,53400,6000,59400
4686,4687,21-10-2020 15:01:25.497272,Postres · Desayunos,Café Quindio,24300,5700,30000
4687,4688,21-10-2020 15:01:25.766001,Internacional,La Esquina con Sabor Parrilla,17800,3000,20800
4688,4689,21-10-2020 15:01:26.085625,Desayunos · Jugos y Batidos,Kuriwaji,13000,6300,19300
4689,4690,21-10-2020 15:01:26.304767,Sushi · Asiática,Arigato,39700,5300,45000
4690,4691,21-10-2020 15:01:26.474035,Postres · Desayunos,Sharmus,37900,6100,44000
4691,4692,21-10-2020 15:01:26.642721,Hamburguesas,Monchis - Hamburguesa,7500,4300,11800
4692,4693,21-10-2020 15:01:26.912197,Parrilla,El Tambor,15600,6800,22400
4693,4694,21-10-2020 15:01:27.081429,Sushi,Umi,10700,5600,16300
4694,4695,21-10-2020 15:01:27.300182,Desayunos · Típica,Desayunadero de la 42,53900,5900,59800
4695,4696,21-10-2020 15:01:27.669104,Típica · Parrilla,Parrilla Farandula Gourmet,35000,5100,40100
4696,4697,21-10-2020 15:01:27.987903,Saludable,Puro Verde,18900,5700,24600
4697,4698,21-10-2020 15:01:28.257331,Desayunos,Señor Desayuno,24300,6800,31100
4698,4699,21-10-2020 15:01:28.525965,Postres · Desayunos,Sweet Tale,7500,5800,13300
4699,4700,21-10-2020 15:01:28.644520,Desayunos · Panadería,Pasteleite,11870,5900,17770
4700,4701,21-10-2020 15:01:28.863135,Saludable · Desayunos,Libre de Culpa,18900,4000,22900
4701,4702,21-10-2020 15:01:29.132501,Parrilla,Restaurante Bar Mi Ranchito,13600,5200,18800
4702,4703,21-10-2020 15:01:29.501773,Desayunos · Típica,Criollomania,9000,5200,14200
4703,4704,21-10-2020 15:01:29.871887,Saludable · Parrilla,Box,12500,3700,16200
4704,4705,21-10-2020 15:01:30.040638,Pollo · Típica,Auyama,53400,3900,57300
4705,4706,21-10-2020 15:01:30.259994,Saludable · Desayunos,Libre de Culpa,37900,4000,41900
4706,4707,21-10-2020 15:01:30.378851,Saludable · Desayunos,Raices Bienestar Gourmet,7500,6600,14100
4707,4708,21-10-2020 15:01:30.598040,Hamburguesas,Gofi Burger,15600,5100,20700
4708,4709,21-10-2020 15:01:30.816780,Hamburguesas · Alitas,Beer,15600,6600,22200
4709,4710,21-10-2020 15:01:31.036136,Pollo,Oliva Va,45800,5600,51400
4710,4711,21-10-2020 15:01:31.304938,Desayunos,Bagel Shop,35000,3200,38200
4711,4712,21-10-2020 15:01:31.673720,Pollo · Sánduches,Pollos Century,35000,3000,38000
4712,4713,21-10-2020 15:01:31.842316,Parrilla,Arepaisa de Medellín,11870,5600,17470
4713,4714,21-10-2020 15:01:32.161986,Típica · Pescados y Mariscos,Arroces Mrg,11870,4300,16170
4714,4715,21-10-2020 15:01:32.431116,Típica · Pescados y Mariscos,La Vitualla,35000,6300,41300
4715,4716,21-10-2020 15:01:32.650355,Postres · Café,Loló Coffee & Snacks,11870,4600,16470
4716,4717,21-10-2020 15:01:32.869651,Desayunos · Panadería,El Pan de Phillippe,35000,4600,39600
4717,4718,21-10-2020 15:01:32.989422,Desayunos,Sunny Breakfast Brunch,15600,4300,19900
4718,4719,21-10-2020 15:01:33.259022,Comida Rápida,Fiesta Digital Andrés,39700,3100,42800
4719,4720,21-10-2020 15:01:33.578929,Desayunos · Panadería,El Pan de Phillippe,34500,4600,39100
4720,4721,21-10-2020 15:01:33.848292,Típica,Juan Chorizo,13600,3900,17500
4721,4722,21-10-2020 15:01:34.067948,Saludable · Desayunos,La Estampilla,34500,6000,40500
4722,4723,21-10-2020 15:01:34.287396,Postres · Desayunos,Protein Bakes,10700,5900,16600
4723,4724,21-10-2020 15:01:34.506678,Hamburguesas,Burger Society,53900,4100,58000
4724,4725,21-10-2020 15:01:34.775969,Parrilla,Rústico Picadería,53400,3800,57200
4725,4726,21-10-2020 15:01:35.046569,Postres,Toledo Pastelería,34500,6800,41300
4726,4727,21-10-2020 15:01:35.165676,Mexicana,Hidalgo Taquería,8900,4900,13800
4727,4728,21-10-2020 15:01:35.434738,Hamburguesas,Gofi Burger,27800,5100,32900
4728,4729,21-10-2020 15:01:35.604068,Postres · Desayunos,Gelateria Da Favola,13600,6500,20100
4729,4730,21-10-2020 15:01:35.823956,Saludable · Desayunos,Maracuyá,13600,6700,20300
4730,4731,21-10-2020 15:01:35.943198,Desayunos · Café,Norma's Ice Cream Café,53400,6300,59700
4731,4732,21-10-2020 15:01:36.262761,Postres · Desayunos,Restaurante Cornelia,35000,5500,40500
4732,4733,21-10-2020 15:01:36.632179,Pescados y Mariscos,La Gran Cazuela,7500,3200,10700
4733,4734,21-10-2020 15:01:36.802063,Típica,Sabrosito,35000,4000,39000
4734,4735,21-10-2020 15:01:36.971436,Desayunos,Cafetería el Kippe,15000,3200,18200
4735,4736,21-10-2020 15:01:37.340967,Desayunos · Jugos y Batidos,Dont Be Hungry,18900,5600,24500
4736,4737,21-10-2020 15:01:37.510256,Jugos y Batidos,Pomponio,35000,3600,38600
4737,4738,21-10-2020 15:01:37.730281,Alta Cocina · Parrilla,Criterión,13600,6000,19600
4738,4739,21-10-2020 15:01:38.099791,Desayunos · Pescados y Mariscos,Gypsy Bistro,13000,4500,17500
4739,4740,21-10-2020 15:01:38.219024,Hamburguesas,Bendito Cordero,15000,5800,20800
4740,4741,21-10-2020 15:01:38.388493,Desayunos,Jacinta Arepas de Huevo,35000,4000,39000
4741,4742,21-10-2020 15:01:38.758524,Sushi,Kim Pop,37900,5400,43300
4742,4743,21-10-2020 15:01:38.877800,Helados,Orso To Go,27800,6800,34600
4743,4744,21-10-2020 15:01:39.147092,Parrilla,Rústico Picadería,15600,3800,19400
4744,4745,21-10-2020 15:01:39.366518,Postres,La Tertulia,35000,3400,38400
4745,4746,21-10-2020 15:01:39.686591,Saludable · Desayunos,Bawana - Sandwich,53400,3400,56800
4746,4747,21-10-2020 15:01:40.006192,Saludable · Desayunos,Bawana - Sandwich,9000,3400,12400
4747,4748,21-10-2020 15:01:40.376857,Postres · Desayunos,Protein Bakes,7500,5900,13400
4748,4749,21-10-2020 15:01:40.746508,Típica,Carbón & Mondongos,8900,6400,15300
4749,4750,21-10-2020 15:01:40.966590,Típica · Parrilla,Mi Ranchito Parrilla,45800,4400,50200
4750,4751,21-10-2020 15:01:41.235798,Típica,Campo Victoria,10700,3000,13700
4751,4752,21-10-2020 15:01:41.505357,Pollo · Saludable,Tremenda Sal y Dulce,13000,6500,19500
4752,4753,21-10-2020 15:01:41.824893,Saludable,MIMA,11870,3700,15570
4753,4754,21-10-2020 15:01:42.195084,Desayunos · Panadería,Ficchi Panadería,34500,3100,37600
4754,4755,21-10-2020 15:01:42.414698,Peruana,Masivo,31800,5800,37600
4755,4756,21-10-2020 15:01:42.583649,Parrilla,Coquitas,70000,5600,75600
4756,4757,21-10-2020 15:01:42.953016,Típica · Pescados y Mariscos,La Vitualla,53400,6300,59700
4757,4758,21-10-2020 15:01:43.222807,Desayunos · Internacional,Camilia,29500,3900,33400
4758,4759,21-10-2020 15:01:43.341881,Típica,La Cocina,8900,4600,13500
4759,4760,21-10-2020 15:01:43.461053,Pollo · Desayunos,Candelina,11870,5300,17170
4760,4761,21-10-2020 15:01:43.630992,Pizza,18 Scalini,18900,4300,23200
4761,4762,21-10-2020 15:01:43.850834,Postres · Desayunos,Sharmus,24200,6100,30300
4762,4763,21-10-2020 15:01:44.120114,Postres · Desayunos,Aury Postres - Comidas & Picadas,31800,4700,36500
4763,4764,21-10-2020 15:01:44.439603,Desayunos · Jugos y Batidos,Frutiwow,9000,4100,13100
4764,4765,21-10-2020 15:01:44.659649,Desayunos · Jugos y Batidos,Dont Be Hungry,31800,5600,37400
4765,4766,21-10-2020 15:01:44.880150,Alta Cocina · Italiana,Trattoria de la Plaza,35000,6000,41000
4766,4767,21-10-2020 15:01:45.150090,Asiática,Thai Station,7500,6000,13500
4767,4768,21-10-2020 15:01:45.369721,Típica · Parrilla,El Portal de la Antigua,13000,5600,18600
4768,4769,21-10-2020 15:01:45.590404,Desayunos · Típica,Criollomania,23000,5200,28200
4769,4770,21-10-2020 15:01:45.760575,Desayunos · Café,Matchacha,23000,5900,28900
4770,4771,21-10-2020 15:01:45.930022,Desayunos,Don Leo,53900,6000,59900
4771,4772,21-10-2020 15:01:46.299523,Pescados y Mariscos,Pescadero Héroes del Mar,9000,6600,15600
4772,4773,21-10-2020 15:01:46.419246,Hamburguesas,Gofi Burger,10700,5100,15800
4773,4774,21-10-2020 15:01:46.789439,Sushi · Asiática,Tu Sushi,10700,6400,17100
4774,4775,21-10-2020 15:01:47.009491,Desayunos · Café,Frambas,23000,3400,26400
4775,4776,21-10-2020 15:01:47.329410,Pizza · Italiana,Pisapore - Pizza,9000,6600,15600
4776,4777,21-10-2020 15:01:47.499143,Postres · Desayunos,KOKOA & co.,18900,4700,23600
4777,4778,21-10-2020 15:01:47.869562,Saludable · Desayunos,Agua Dulce,37900,3700,41600
4778,4779,21-10-2020 15:01:47.989951,Desayunos · Típica,Fogón Sangileño,70000,5000,75000
4779,4780,21-10-2020 15:01:48.262258,Jugos y Batidos,Pomponio,11870,3600,15470
4780,4781,21-10-2020 15:01:48.632728,Postres · Desayunos,Sweet Tale,18900,5800,24700
4781,4782,21-10-2020 15:01:48.852586,Helados,Buon Gelato,53400,4400,57800
4782,4783,21-10-2020 15:01:49.171822,Pescados y Mariscos,Pescadero Héroes del Mar,23000,6600,29600
4783,4784,21-10-2020 15:01:49.542261,Típica · Parrilla,Toya,27800,4200,32000
4784,4785,21-10-2020 15:01:49.862215,Pizza · Parrilla,Urban Lunch,18900,4000,22900
4785,4786,21-10-2020 15:01:49.982092,Desayunos · Café,Aromacafé el Placer de Compartir,8900,5000,13900
4786,4787,21-10-2020 15:01:50.101961,Saludable · Desayunos,Bawana - Sandwich,37900,3400,41300
4787,4788,21-10-2020 15:01:50.471952,Saludable · Desayunos,Bawana - Sandwich,31800,3400,35200
4788,4789,21-10-2020 15:01:50.592455,China,China Food Col,15600,3600,19200
4789,4790,21-10-2020 15:01:50.812598,Desayunos · Típica,Parrilla Farandula Típico,24200,5900,30100
4790,4791,21-10-2020 15:01:51.082270,Peruana,Uma Cantina Peruana,12500,3200,15700
4791,4792,21-10-2020 15:01:51.201823,Alta Cocina · Italiana,Trattoria de la Plaza,27800,6000,33800
4792,4793,21-10-2020 15:01:51.471916,Pollo,Heart & Cooking,9000,5000,14000
4793,4794,21-10-2020 15:01:51.641777,Postres · Desayunos,Restaurante Cornelia,18900,5500,24400
4794,4795,21-10-2020 15:01:51.861101,Saludable,MIMA,9000,3700,12700
4795,4796,21-10-2020 15:01:51.980683,Desayunos · Típica,90 Calentados,15600,3700,19300
4796,4797,21-10-2020 15:01:52.350406,Mexicana,Mexicanachos,7500,3900,11400
4797,4798,21-10-2020 15:01:52.670033,Desayunos · Panadería,Pasteleite,29500,5900,35400
4798,4799,21-10-2020 15:01:52.889862,Desayunos · Jugos y Batidos,Dont Be Hungry,37900,5600,43500
4799,4800,21-10-2020 15:01:53.259444,Desayunos · Sánduches,Frutos del Bosque,34500,3500,38000
4800,4801,21-10-2020 15:01:53.579056,Postres,Toledo Pastelería,10700,6800,17500
4801,4802,21-10-2020 15:01:53.949397,Desayunos · Panadería,Juliana Restaurante,7500,6100,13600
4802,4803,21-10-2020 15:01:54.169196,Postres · Desayunos,Buñuelos nacho,13600,6600,20200
4803,4804,21-10-2020 15:01:54.488739,Desayunos · Típica,La Frijolada,37900,4500,42400
4804,4805,21-10-2020 15:01:54.808787,Parrilla · Café,Figaro Café/ Restaurante Argentino,35000,5800,40800
4805,4806,21-10-2020 15:01:54.978243,Desayunos · Típica,Calentao Express,35000,6000,41000
4806,4807,21-10-2020 15:01:55.298017,Italiana,F*cking Good Pizza,17800,4200,22000
4807,4808,21-10-2020 15:01:55.568047,Saludable,Amor Propio saludable,23000,4000,27000
4808,4809,21-10-2020 15:01:55.888841,Sushi · Asiática,Tu Sushi,17800,6400,24200
4809,4810,21-10-2020 15:01:56.158344,Desayunos · Panadería,Ficchi Panadería,9000,3100,12100
4810,4811,21-10-2020 15:01:56.278622,Típica,Salsig,37900,5600,43500
4811,4812,21-10-2020 15:01:56.548286,Pizza · Italiana,Piatto - Pizza,23000,6600,29600
4812,4813,21-10-2020 15:01:56.817929,Postres · Saludable,Ana Rebana,34500,6300,40800
4813,4814,21-10-2020 15:01:57.088157,Sushi,Kim Pop,23000,5400,28400
4814,4815,21-10-2020 15:01:57.207909,Saludable · Desayunos,La Estampilla,23000,6000,29000
4815,4816,21-10-2020 15:01:57.477924,Saludable · Parrilla,The Angels Grill and Drinks,15000,6200,21200
4816,4817,21-10-2020 15:01:57.597970,Típica,Lo Nuestro,8900,3100,12000
4817,4818,21-10-2020 15:01:57.817729,Desayunos · Panadería,Ficchi Panadería,29500,3100,32600
4818,4819,21-10-2020 15:01:58.187606,Parrilla,Coquitas,17800,5600,23400
4819,4820,21-10-2020 15:01:58.507975,Pizza,Pastas Laurentina,9000,4800,13800
4820,4821,21-10-2020 15:01:58.627938,Hamburguesas,Burger Society,8900,4100,13000
4821,4822,21-10-2020 15:01:58.797285,Pescados y Mariscos,La Gran Cazuela,18900,3200,22100
4822,4823,21-10-2020 15:01:58.916435,Pollo · Pescados y Mariscos,Bang Bang Rice,39700,3400,43100
4823,4824,21-10-2020 15:01:59.086480,Desayunos,Don Leo,27800,6000,33800
4824,4825,21-10-2020 15:01:59.256336,Parrilla · Café,Figaro Café/ Restaurante Argentino,11870,5800,17670
4825,4826,21-10-2020 15:01:59.425946,Desayunos · Pescados y Mariscos,Luzí­a - Mediterranea,70000,5700,75700
4826,4827,21-10-2020 15:01:59.795650,Desayunos,Bagel Shop,70000,3200,73200
4827,4828,21-10-2020 15:01:59.916178,Sushi,Sushi Reel,37900,4700,42600
4828,4829,21-10-2020 15:02:00.286237,Desayunos · Típica,Fogón Sangileño,11870,5000,16870
4829,4830,21-10-2020 15:02:00.455689,Desayunos,Archies Desayunos,48750,3100,51850
4830,4831,21-10-2020 15:02:00.775507,Desayunos,Desayunos en Bogotá,53400,3400,56800
4831,4832,21-10-2020 15:02:01.145118,Saludable · Desayunos,Bawana - Sandwich,15600,3400,19000
4832,4833,21-10-2020 15:02:01.465563,Desayunos · Típica,D'Porco - Lechona,24200,6300,30500
4833,4834,21-10-2020 15:02:01.835262,Desayunos · Sánduches,Frutos del Bosque,29500,3500,33000
4834,4835,21-10-2020 15:02:01.954723,Desayunos · Típica,Peninsula Calentados y Parrilla,35000,3400,38400
4835,4836,21-10-2020 15:02:02.174231,Desayunos · Panadería,Choclofee,45800,4700,50500
4836,4837,21-10-2020 15:02:02.443961,Pollo · Típica,Auyama,17800,3900,21700
4837,4838,21-10-2020 15:02:02.563364,Saludable · Desayunos,Distrito Gourmet,31800,3700,35500
4838,4839,21-10-2020 15:02:02.733652,Pizza,Pastas Laurentina,10700,4800,15500
4839,4840,21-10-2020 15:02:03.003447,Pollo · Saludable,Gratina,45800,4200,50000
4840,4841,21-10-2020 15:02:03.123436,Típica,Cabrito Santandereano,70000,6600,76600
4841,4842,21-10-2020 15:02:03.243381,Postres · Desayunos,Maria Luisa - Postres,48750,4300,53050
4842,4843,21-10-2020 15:02:03.463172,Postres,Levelma,17800,6200,24000
4843,4844,21-10-2020 15:02:03.582645,Típica,El Mondongo y Mucho Mas,35000,5600,40600
4844,4845,21-10-2020 15:02:03.852853,Saludable · Desayunos,La Estampilla,24300,6000,30300
4845,4846,21-10-2020 15:02:04.172543,Parrilla,Carnes la Zarza,23000,4900,27900
4846,4847,21-10-2020 15:02:04.392231,Parrilla,Beraca Parrilla Bbq,23000,5600,28600
4847,4848,21-10-2020 15:02:04.561665,Desayunos,Butter,18900,6700,25600
4848,4849,21-10-2020 15:02:04.831105,Desayunos · Café,Moramia,9000,4700,13700
4849,4850,21-10-2020 15:02:05.000550,Saludable · Parrilla,Box,13600,3700,17300
4850,4851,21-10-2020 15:02:05.121614,Desayunos · Helados,San Giorgio Gelateria,24200,3100,27300
4851,4852,21-10-2020 15:02:05.441836,Saludable · Parrilla,Box,23000,3700,26700
4852,4853,21-10-2020 15:02:05.762085,Pollo · Desayunos,Abasto,35000,3600,38600
4853,4854,21-10-2020 15:02:05.981257,Sushi · Asiática,Arigato,31800,5300,37100
4854,4855,21-10-2020 15:02:06.351812,Postres · Desayunos,Aury Postres - Comidas & Picadas,13000,4700,17700
4855,4856,21-10-2020 15:02:06.621540,Pollo · Saludable,Tremenda Sal y Dulce,8900,6500,15400
4856,4857,21-10-2020 15:02:06.941806,Pizza,pizza andante,7500,4200,11700
4857,4858,21-10-2020 15:02:07.211639,Peruana · Internacional,La Chifería,23000,6600,29600
4858,4859,21-10-2020 15:02:07.431321,Postres,Beiked,48750,4000,52750
4859,4860,21-10-2020 15:02:07.650552,Asiática,TeT,13600,5900,19500
4860,4861,21-10-2020 15:02:07.919928,Alta Cocina · Italiana,Trattoria de la Plaza,9000,6000,15000
4861,4862,21-10-2020 15:02:08.189336,Desayunos · Panadería,El Pan de Phillippe,17800,4600,22400
4862,4863,21-10-2020 15:02:08.509437,Postres · Desayunos,Sharmus,13600,6100,19700
4863,4864,21-10-2020 15:02:08.829191,Postres · Desayunos,Maria Luisa - Postres,7500,4300,11800
4864,4865,21-10-2020 15:02:09.149063,Pollo,Chicken House,70000,4200,74200
4865,4866,21-10-2020 15:02:09.368524,Desayunos · Panadería,Ficchi Panadería,11870,3100,14970
4866,4867,21-10-2020 15:02:09.588034,Saludable,A2manos,48750,4200,52950
4867,4868,21-10-2020 15:02:09.957591,Saludable · Típica,Saludable Mrg,15000,5800,20800
4868,4869,21-10-2020 15:02:10.327625,Desayunos · Jugos y Batidos,Dont Be Hungry,45800,5600,51400
4869,4870,21-10-2020 15:02:10.496955,Postres · Desayunos,Maltihelado,24300,4500,28800
4870,4871,21-10-2020 15:02:10.616919,Típica,Sopitas y Más,18900,4200,23100
4871,4872,21-10-2020 15:02:10.887009,Postres · Café,Celestino Café,65000,5900,70900
4872,4873,21-10-2020 15:02:11.006114,Desayunos · Panadería,Siena Café,39700,3700,43400
4873,4874,21-10-2020 15:02:11.125942,Sushi,Canoa To Go,31800,5900,37700
4874,4875,21-10-2020 15:02:11.246525,Pizza · Italiana,Pisapore - Pizza,53400,6600,60000
4875,4876,21-10-2020 15:02:11.367462,Hamburguesas,Bendito Cordero,24300,5800,30100
4876,4877,21-10-2020 15:02:11.537350,Saludable · Desayunos,Malú,37900,3700,41600
4877,4878,21-10-2020 15:02:11.806650,Peruana,Masivo,23000,5800,28800
4878,4879,21-10-2020 15:02:12.176554,Típica,Bandejas Mrg,23000,3800,26800
4879,4880,21-10-2020 15:02:12.446394,Postres · Desayunos,KOKOA & co.,48750,4700,53450
4880,4881,21-10-2020 15:02:12.566587,Panadería,Boul,18900,3100,22000
4881,4882,21-10-2020 15:02:12.786411,Típica,Baondish,24300,5800,30100
4882,4883,21-10-2020 15:02:13.006691,Parrilla,Arroces Maria Paula,24200,6800,31000
4883,4884,21-10-2020 15:02:13.276671,Postres · Desayunos,Protein Bakes,24200,5900,30100
4884,4885,21-10-2020 15:02:13.646351,Mexicana,Hidalgo Taquería,31800,4900,36700
4885,4886,21-10-2020 15:02:13.915754,Mexicana,Mexicanachos,24300,3900,28200
4886,4887,21-10-2020 15:02:14.086000,Desayunos · Café,El Gualilo,29500,6200,35700
4887,4888,21-10-2020 15:02:14.255558,Saludable · Parrilla,The Angels Grill and Drinks,34500,6200,40700
4888,4889,21-10-2020 15:02:14.525431,Saludable,Hanai - Bowls Saludables,35000,5900,40900
4889,4890,21-10-2020 15:02:14.794648,Desayunos · Helados,San Giorgio Gelateria,53400,3100,56500
4890,4891,21-10-2020 15:02:14.963963,Desayunos · Típica,D'Porco - Lechona,48750,6300,55050
4891,4892,21-10-2020 15:02:15.333626,Pollo · Desayunos,Piaf,13000,6500,19500
4892,4893,21-10-2020 15:02:15.554023,Desayunos · Típica,La Frijolada,39700,4500,44200
4893,4894,21-10-2020 15:02:15.673477,Desayunos,Sr Buñuelo,18900,6400,25300
4894,4895,21-10-2020 15:02:15.843143,Sánduches,Submarin,15600,3800,19400
4895,4896,21-10-2020 15:02:16.112805,Saludable · Desayunos,Bon Eat - Saludable,39700,4800,44500
4896,4897,21-10-2020 15:02:16.332325,Saludable · Jugos y Batidos,Berdes Drinks & Salads,23000,3500,26500
4897,4898,21-10-2020 15:02:16.502835,Saludable · Desayunos,La Cesta,11870,4700,16570
4898,4899,21-10-2020 15:02:16.823434,Sushi,Umi,9000,5600,14600
4899,4900,21-10-2020 15:02:17.043191,Desayunos · Comida Rápida,Chocolatto,11870,3400,15270
4900,4901,21-10-2020 15:02:17.162793,Típica · Parrilla,El Portal de la Antigua,53400,5600,59000
4901,4902,21-10-2020 15:02:17.432620,Típica,Campo Victoria,35000,3000,38000
4902,4903,21-10-2020 15:02:17.752582,Saludable · Desayunos,Maracuyá,35000,6700,41700
4903,4904,21-10-2020 15:02:17.872138,Internacional,Rio Sabores y Experiencias,13600,4100,17700
4904,4905,21-10-2020 15:02:18.042459,Parrilla,Rústico Picadería,24300,3800,28100
4905,4906,21-10-2020 15:02:18.362628,Desayunos · Café,Frambas,13000,3400,16400
4906,4907,21-10-2020 15:02:18.732887,Desayunos · Comida Rápida,La Veneca,31800,6300,38100
4907,4908,21-10-2020 15:02:18.902448,Comida Rápida,Fiesta Digital Andrés,53900,3100,57000
4908,4909,21-10-2020 15:02:19.122078,Internacional,La Esquina con Sabor Parrilla,18900,3000,21900
4909,4910,21-10-2020 15:02:19.341578,Postres · Desayunos,Gelateria Da Favola,7500,6500,14000
4910,4911,21-10-2020 15:02:19.712225,Pollo · Saludable,Tremenda Sal y Dulce,65000,6500,71500
4911,4912,21-10-2020 15:02:20.032350,Típica,Salsig,13600,5600,19200
4912,4913,21-10-2020 15:02:20.202558,Desayunos · Jugos y Batidos,Frutiwow,9000,4100,13100
4913,4914,21-10-2020 15:02:20.572505,Típica,Baondish,53900,5800,59700
4914,4915,21-10-2020 15:02:20.742547,Crepes,La Chabatta,23000,5900,28900
4915,4916,21-10-2020 15:02:20.962593,Saludable · Típica,Saludable Mrg,29500,5800,35300
4916,4917,21-10-2020 15:02:21.133644,Poke,Poke Go,15000,4600,19600
4917,4918,21-10-2020 15:02:21.303286,Desayunos · Café,Norma's Ice Cream Café,53900,6300,60200
4918,4919,21-10-2020 15:02:21.674562,Pollo,Oliva Va,45800,5600,51400
4919,4920,21-10-2020 15:02:21.894114,Pollo · China,China Tao,23000,3500,26500
4920,4921,21-10-2020 15:02:22.164104,Alta Cocina · Parrilla,Criterión,11870,6000,17870
4921,4922,21-10-2020 15:02:22.333860,Desayunos · Típica,Papadió - Colombianas,7500,5700,13200
4922,4923,21-10-2020 15:02:22.604014,Desayunos · Parrilla,Mi Patria,7500,4600,12100
4923,4924,21-10-2020 15:02:22.973955,Desayunos · Típica,Fogón Sangileño,27800,5000,32800
4924,4925,21-10-2020 15:02:23.143968,Parrilla,Coquitas,34500,5600,40100
4925,4926,21-10-2020 15:02:23.416595,Desayunos · Café,Aromacafé el Placer de Compartir,9000,5000,14000
4926,4927,21-10-2020 15:02:23.587824,Postres · Desayunos,Maria Luisa - Postres,35000,4300,39300
4927,4928,21-10-2020 15:02:23.858084,Desayunos,Sunny Breakfast Brunch,29500,4300,33800
4928,4929,21-10-2020 15:02:24.078466,Parrilla,Rústico Picadería,48750,3800,52550
4929,4930,21-10-2020 15:02:24.398279,Pollo,Oliva Va,31800,5600,37400
4930,4931,21-10-2020 15:02:24.568275,Saludable · Desayunos,Bawana - Sandwich,11870,3400,15270
4931,4932,21-10-2020 15:02:24.838219,Postres · Desayunos,Restaurante Cornelia,35000,5500,40500
4932,4933,21-10-2020 15:02:25.008276,Parrilla,Restaurante Bar Mi Ranchito,31800,5200,37000
4933,4934,21-10-2020 15:02:25.178113,Desayunos · Café,El Gualilo,53900,6200,60100
4934,4935,21-10-2020 15:02:25.448351,Peruana,Uma Cantina Peruana,35000,3200,38200
4935,4936,21-10-2020 15:02:25.618402,Desayunos · Café,Aromacafé el Placer de Compartir,35000,5000,40000
4936,4937,21-10-2020 15:02:25.938488,Postres · Desayunos,Café Quindio,13600,5700,19300
4937,4938,21-10-2020 15:02:26.258506,Postres,Beiked,24200,4000,28200
4938,4939,21-10-2020 15:02:26.378433,Pollo · Desayunos,Workzone,24300,3100,27400
4939,4940,21-10-2020 15:02:26.648707,Desayunos · Café,El Gualilo,13000,6200,19200
4940,4941,21-10-2020 15:02:26.970546,Sushi,Umi,23000,5600,28600
4941,4942,21-10-2020 15:02:27.090224,Saludable,A2manos,29500,4200,33700
4942,4943,21-10-2020 15:02:27.410403,Parrilla,El Tambor,24300,6800,31100
4943,4944,21-10-2020 15:02:27.780531,Postres · Desayunos,KOKOA & co.,12500,4700,17200
4944,4945,21-10-2020 15:02:28.150563,Típica · Parrilla,Mi Ranchito Parrilla,31800,4400,36200
4945,4946,21-10-2020 15:02:28.270280,Pollo,Chicken House,65000,4200,69200
4946,4947,21-10-2020 15:02:28.590270,Desayunos,Sr Buñuelo,35000,6400,41400
4947,4948,21-10-2020 15:02:28.910137,Desayunos,Don Leo,35000,6000,41000
4948,4949,21-10-2020 15:02:29.029931,Sushi,Umi,15000,5600,20600
4949,4950,21-10-2020 15:02:29.299753,Pollo · Sánduches,Pollos Century,31800,3000,34800
4950,4951,21-10-2020 15:02:29.419580,Típica · Pescados y Mariscos,Arroces Mrg,11870,4300,16170
4951,4952,21-10-2020 15:02:29.639476,Saludable · Desayunos,Básico y elemental,18900,5000,23900
4952,4953,21-10-2020 15:02:29.759432,Saludable · Desayunos,Re.al Alimentos Reales,37900,4000,41900
4953,4954,21-10-2020 15:02:30.079057,Italiana,Bocatto Di Passo,31800,5000,36800
4954,4955,21-10-2020 15:02:30.248704,Postres · Café,Loló Coffee & Snacks,37900,4600,42500
4955,4956,21-10-2020 15:02:30.568465,Hamburguesas · Alitas,Beer,45800,6600,52400
4956,4957,21-10-2020 15:02:30.938486,Peruana,Masivo,7500,5800,13300
4957,4958,21-10-2020 15:02:31.108176,Desayunos · Típica,Peninsula Calentados y Parrilla,24200,3400,27600
4958,4959,21-10-2020 15:02:31.378342,Típica · Parrilla,El Portal de la Antigua,24200,5600,29800
4959,4960,21-10-2020 15:02:31.498183,Sushi,Umi,11870,5600,17470
4960,4961,21-10-2020 15:02:31.868124,Peruana · Internacional,La Chifería,24300,6600,30900
4961,4962,21-10-2020 15:02:32.087606,Postres · Desayunos,Buñuelos nacho,34500,6600,41100
4962,4963,21-10-2020 15:02:32.257497,Pollo · Pescados y Mariscos,Bang Bang Rice,23000,3400,26400
4963,4964,21-10-2020 15:02:32.577588,Pollo · Desayunos,Workzone,23000,3100,26100
4964,4965,21-10-2020 15:02:32.697200,Saludable · Desayunos,Malú,34500,3700,38200
4965,4966,21-10-2020 15:02:33.016865,Pescados y Mariscos,Pescadero Héroes del Mar,23000,6600,29600
4966,4967,21-10-2020 15:02:33.336607,Pollo · Saludable,Gratina,45800,4200,50000
4967,4968,21-10-2020 15:02:33.606697,Saludable · Parrilla,Box,48750,3700,52450
4968,4969,21-10-2020 15:02:33.977082,Saludable · Desayunos,Agua Dulce,17800,3700,21500
4969,4970,21-10-2020 15:02:34.197001,Italiana,Bocatto Di Passo,35000,5000,40000
4970,4971,21-10-2020 15:02:34.466539,Postres · Desayunos,KOKOA & co.,17800,4700,22500
4971,4972,21-10-2020 15:02:34.636495,Hamburguesas · Saludable,Restaurant Inn,17800,6100,23900
4972,4973,21-10-2020 15:02:34.806461,Hamburguesas,Gofi Burger,15000,5100,20100
4973,4974,21-10-2020 15:02:35.176490,Típica · Parrilla,El Santandereano,70000,5200,75200
4974,4975,21-10-2020 15:02:35.446167,Postres,Beiked,65000,4000,69000
4975,4976,21-10-2020 15:02:35.715782,Desayunos · Típica,D´Porco,31800,3900,35700
4976,4977,21-10-2020 15:02:35.885264,Pizza,Pastas Laurentina,11870,4800,16670
4977,4978,21-10-2020 15:02:36.205111,Peruana,Masivo,8900,5800,14700
4978,4979,21-10-2020 15:02:36.574974,Desayunos · Parrilla,Mi Patria,65000,4600,69600
4979,4980,21-10-2020 15:02:36.744616,Típica,Sabores De Mi Tierra,48750,5400,54150
4980,4981,21-10-2020 15:02:36.964069,Sánduches · Pescados y Mariscos,Pacific Comida de Mar,23000,4000,27000
4981,4982,21-10-2020 15:02:37.335331,Desayunos,Fratelli - Desayunos,24300,4600,28900
4982,4983,21-10-2020 15:02:37.505587,Sushi,Sushi Reel,24200,4700,28900
4983,4984,21-10-2020 15:02:37.825276,Típica,Cazuelitas 93,24200,3900,28100
4984,4985,21-10-2020 15:02:37.944850,Saludable · Desayunos,Malú,17800,3700,21500
4985,4986,21-10-2020 15:02:38.165214,Desayunos,Desayunos en Bogotá,53400,3400,56800
4986,4987,21-10-2020 15:02:38.284844,Postres,La Galeta,24200,3000,27200
4987,4988,21-10-2020 15:02:38.604707,Alta Cocina · Italiana,Trattoria de la Plaza,48750,6000,54750
4988,4989,21-10-2020 15:02:38.824342,Parrilla,Antojo a Domicilio,13600,5000,18600
4989,4990,21-10-2020 15:02:39.044185,Desayunos · Internacional,Camilia,29500,3900,33400
4990,4991,21-10-2020 15:02:39.314195,Postres · Desayunos,Gelateria Da Favola,27800,6500,34300
4991,4992,21-10-2020 15:02:39.584189,Parrilla,Arroces Maria Paula,29500,6800,36300
4992,4993,21-10-2020 15:02:39.954203,China,China Food Col,7500,3600,11100
4993,4994,21-10-2020 15:02:40.174059,Típica · Parrilla,El Portal de la Antigua,17800,5600,23400
4994,4995,21-10-2020 15:02:40.343768,Pollo · Sánduches,Pollos Century,24200,3000,27200
4995,4996,21-10-2020 15:02:40.713883,Parrilla,Arepaisa de Medellín,27800,5600,33400
4996,4997,21-10-2020 15:02:40.883763,Postres · Desayunos,BagBog Bagels,35000,6400,41400
4997,4998,21-10-2020 15:02:41.203698,Saludable,Puro Verde,13000,5700,18700
4998,4999,21-10-2020 15:02:41.373478,Postres,Levelma,13000,6200,19200
4999,5000,21-10-2020 15:02:41.593233,Parrilla,Arepaisa de Medellín,15000,5600,20600
5000,5001,21-10-2020 15:02:41.863236,Desayunos · Café,Libertario Coffee Roasters,24200,4600,28800
5001,5002,21-10-2020 15:02:42.183189,Desayunos · Árabe,Boniato Sabores Vivos,34500,5300,39800
5002,5003,21-10-2020 15:02:42.404427,Desayunos · Típica,Fogón Sangileño,35000,5000,40000
5003,5004,21-10-2020 15:02:42.674442,Típica,La Cocina,65000,4600,69600
5004,5005,21-10-2020 15:02:43.044831,Típica,Sabores De Mi Tierra,37900,5400,43300
5005,5006,21-10-2020 15:02:43.264600,Panadería,Boul,15000,3100,18100
5006,5007,21-10-2020 15:02:43.584267,Desayunos · Café,Moramia,70000,4700,74700
5007,5008,21-10-2020 15:02:43.804227,Parrilla,Campocina,24300,4600,28900
5008,5009,21-10-2020 15:02:44.074148,Típica · Parrilla,El Portal de la Antigua,29500,5600,35100
5009,5010,21-10-2020 15:02:44.343827,Saludable · Desayunos,Libre de Culpa,23000,4000,27000
5010,5011,21-10-2020 15:02:44.513651,Hamburguesas,Bendito Cordero,65000,5800,70800
5011,5012,21-10-2020 15:02:44.883628,Desayunos · Típica,D´Porco,13000,3900,16900
5012,5013,21-10-2020 15:02:45.253840,Parrilla,Antojo a Domicilio,15000,5000,20000
5013,5014,21-10-2020 15:02:45.524158,Desayunos · Panadería,Artesanos,45800,4300,50100
5014,5015,21-10-2020 15:02:45.844269,Saludable · Parrilla,The Angels Grill and Drinks,39700,6200,45900
5015,5016,21-10-2020 15:02:46.214445,Típica,Sopitas y Más,70000,4200,74200
5016,5017,21-10-2020 15:02:46.484854,Desayunos,Bagel Shop,15000,3200,18200
5017,5018,21-10-2020 15:02:46.804896,Poke,Poke Go,18900,4600,23500
5018,5019,21-10-2020 15:02:47.175032,Saludable · Desayunos,Malú,13600,3700,17300
5019,5020,21-10-2020 15:02:47.294595,Parrilla,Parrilla Pimentón,29500,3400,32900
5020,5021,21-10-2020 15:02:47.565697,Internacional,Rio Sabores y Experiencias,9000,4100,13100
5021,5022,21-10-2020 15:02:47.835589,Postres · Desayunos,Gelateria Da Favola,39700,6500,46200
5022,5023,21-10-2020 15:02:47.955306,Típica,La Herencia,34500,5900,40400
5023,5024,21-10-2020 15:02:48.275072,Pollo · Típica,Auyama,10700,3900,14600
5024,5025,21-10-2020 15:02:48.445326,Alta Cocina · Parrilla,Criterión,65000,6000,71000
5025,5026,21-10-2020 15:02:48.615433,Saludable,Ventura Soup y Salad,53400,3800,57200
5026,5027,21-10-2020 15:02:48.985494,Hamburguesas · Panadería,NYC Burgers,53900,6200,60100
5027,5028,21-10-2020 15:02:49.355096,Pollo · Sánduches,Pollos Century,23000,3000,26000
5028,5029,21-10-2020 15:02:49.575013,Desayunos · Parrilla,Mi Patria,24200,4600,28800
5029,5030,21-10-2020 15:02:49.695092,Sushi,Canoa To Go,23000,5900,28900
5030,5031,21-10-2020 15:02:49.964954,Saludable · Parrilla,Box,31800,3700,35500
5031,5032,21-10-2020 15:02:50.334919,Hamburguesas · Panadería,NYC Burgers,24300,6200,30500
5032,5033,21-10-2020 15:02:50.654843,Sushi,Kim Pop,11870,5400,17270
5033,5034,21-10-2020 15:02:50.824537,Típica,Sopitas y Más,13600,4200,17800
5034,5035,21-10-2020 15:02:51.094352,Saludable · Desayunos,Maracuyá,17800,6700,24500
5035,5036,21-10-2020 15:02:51.414730,Pollo,Oliva Va,15000,5600,20600
5036,5037,21-10-2020 15:02:51.634740,Parrilla,Restaurante Bar Mi Ranchito,12500,5200,17700
5037,5038,21-10-2020 15:02:51.754706,Pizza,Pizza Andante,11870,6300,18170
5038,5039,21-10-2020 15:02:52.074828,Típica,Sabores De Mi Tierra,48750,5400,54150
5039,5040,21-10-2020 15:02:52.394756,Jugos y Batidos,Pomponio,35000,3600,38600
5040,5041,21-10-2020 15:02:52.615755,Poke,Poke Go,34500,4600,39100
5041,5042,21-10-2020 15:02:52.885693,Peruana,Masivo,11870,5800,17670
5042,5043,21-10-2020 15:02:53.055477,Helados,Orso To Go,29500,6800,36300
5043,5044,21-10-2020 15:02:53.225371,Postres · Desayunos,Maltihelados,18900,6200,25100
5044,5045,21-10-2020 15:02:53.495177,Pizza,Pizza Andante,24300,6300,30600
5045,5046,21-10-2020 15:02:53.765273,Desayunos · Jugos y Batidos,Frutiwow,10700,4100,14800
5046,5047,21-10-2020 15:02:53.935211,Típica,Cazuelitas 93,35000,3900,38900
5047,5048,21-10-2020 15:02:54.305411,Postres · Desayunos,Gelateria Da Favola,23000,6500,29500
5048,5049,21-10-2020 15:02:54.675194,Desayunos · Empanadas,Mis Delicias,35000,3200,38200
5049,5050,21-10-2020 15:02:54.995168,Desayunos,Fratelli - Desayunos,13600,4600,18200
5050,5051,21-10-2020 15:02:55.115241,Pollo,Heart & Cooking,53400,5000,58400
5051,5052,21-10-2020 15:02:55.285407,Saludable · Desayunos,Básico y Elemental,65000,5900,70900
5052,5053,21-10-2020 15:02:55.455508,Postres · Saludable,Ana Rebana,39700,6300,46000
5053,5054,21-10-2020 15:02:55.725346,Desayunos · Panadería,Ficchi Panadería,53400,3100,56500
5054,5055,21-10-2020 15:02:55.894755,Saludable · Desayunos,Maracuyá,23000,6700,29700
5055,5056,21-10-2020 15:02:56.264826,Pollo,Heart & Cooking,35000,5000,40000
5056,5057,21-10-2020 15:02:56.434882,Desayunos · Típica,Alce,17800,4900,22700
5057,5058,21-10-2020 15:02:56.554717,Internacional,Rio Sabores y Experiencias,11870,4100,15970
5058,5059,21-10-2020 15:02:56.874701,Típica,Salsig,34500,5600,40100
5059,5060,21-10-2020 15:02:57.044388,Típica · Parrilla,La Parilla de David,13000,3100,16100
5060,5061,21-10-2020 15:02:57.264464,Típica · Parrilla,Mi Ranchito Parrilla,8900,4400,13300
5061,5062,21-10-2020 15:02:57.434326,Típica,Juan Chorizo,34500,3900,38400
5062,5063,21-10-2020 15:02:57.604244,Típica,La Cocina,53900,4600,58500
5063,5064,21-10-2020 15:02:57.775108,Saludable,Amor Propio saludable,7500,4000,11500
5064,5065,21-10-2020 15:02:58.044991,Típica,Juan Chorizo,27800,3900,31700
5065,5066,21-10-2020 15:02:58.364845,Desayunos,Cafetería el Kippe,53400,3200,56600
5066,5067,21-10-2020 15:02:58.585050,Sushi,Kim Pop,17800,5400,23200
5067,5068,21-10-2020 15:02:58.855153,Desayunos · Típica,Calentao Express,13000,6000,19000
5068,5069,21-10-2020 15:02:59.125502,Desayunos · Pescados y Mariscos,Luzí­a - Mediterranea,45800,5700,51500
5069,5070,21-10-2020 15:02:59.345292,Sánduches,Submarin,37900,3800,41700
5070,5071,21-10-2020 15:02:59.615237,Poke,Poke Go,12500,4600,17100
5071,5072,21-10-2020 15:02:59.935512,Saludable · Desayunos,La Cesta,8900,4700,13600
5072,5073,21-10-2020 15:03:00.055325,Mexicana,Hidalgo Taquería,11870,4900,16770
5073,5074,21-10-2020 15:03:00.375256,Parrilla,Parrilla Pimentón,48750,3400,52150
5074,5075,21-10-2020 15:03:00.595628,Hamburguesas,Monchis - Hamburguesa,11870,4300,16170
5075,5076,21-10-2020 15:03:00.865885,Típica,Juan Chorizo,9000,3900,12900
5076,5077,21-10-2020 15:03:01.086041,Pollo,Oliva Va,13000,5600,18600
5077,5078,21-10-2020 15:03:01.455922,Desayunos · Café,vereda central calle 99,48750,5700,54450
5078,5079,21-10-2020 15:03:01.826039,Típica,Carbón & Mondongos,13600,6400,20000
5079,5080,21-10-2020 15:03:02.096112,Parrilla · Café,Gaira Café,12500,4400,16900
5080,5081,21-10-2020 15:03:02.416823,Desayunos,Jacinta Arepas de Huevo,15600,4000,19600
5081,5082,21-10-2020 15:03:02.636837,Desayunos · Empanadas,Empanadas Doraditas.com,29500,3000,32500
5082,5083,21-10-2020 15:03:02.958150,Sushi,Kim Pop,37900,5400,43300
5083,5084,21-10-2020 15:03:03.178113,Hamburguesas · Saludable,Restaurant Inn,13600,6100,19700
5084,5085,21-10-2020 15:03:03.448155,Pollo · China,China Tao,15600,3500,19100
5085,5086,21-10-2020 15:03:03.618200,Peruana · Internacional,La Chifería,15600,6600,22200
5086,5087,21-10-2020 15:03:03.738262,Saludable · Desayunos,Raices Bienestar Gourmet,23000,6600,29600
5087,5088,21-10-2020 15:03:03.858592,Típica,La Herencia,7500,5900,13400
5088,5089,21-10-2020 15:03:04.229325,Postres · Desayunos,Maltihelados,15600,6200,21800
5089,5090,21-10-2020 15:03:04.599379,Postres · Desayunos,Café Quindio,10700,5700,16400
5090,5091,21-10-2020 15:03:04.969627,Saludable · Jugos y Batidos,Berdes Drinks & Salads,34500,3500,38000
5091,5092,21-10-2020 15:03:05.239614,Postres · Desayunos,Maltihelados,70000,6200,76200
5092,5093,21-10-2020 15:03:05.409611,Desayunos,La Frijolada Desayunos,35000,4400,39400
5093,5094,21-10-2020 15:03:05.580139,Italiana,Bocatto Di Passo,45800,5000,50800
5094,5095,21-10-2020 15:03:05.850430,Postres · Desayunos,La Folie - Postres,31800,3300,35100
5095,5096,21-10-2020 15:03:06.020771,Pollo · Saludable,Tremenda Sal y Dulce,27800,6500,34300
5096,5097,21-10-2020 15:03:06.241057,Típica,La Cocina,29500,4600,34100
5097,5098,21-10-2020 15:03:06.361259,Típica · Parrilla,Toya,23000,4200,27200
5098,5099,21-10-2020 15:03:06.731679,Desayunos · Empanadas,Empanadas Doraditas.com,15600,3000,18600
5099,5100,21-10-2020 15:03:06.851989,Típica,Cabrito Santandereano,35000,6600,41600
5100,5101,21-10-2020 15:03:07.072467,Sushi,Umi,24200,5600,29800
5101,5102,21-10-2020 15:03:07.243450,Desayunos · Panadería,Choclofee,11870,4700,16570
5102,5103,21-10-2020 15:03:07.413903,Pollo,Heart & Cooking,39700,5000,44700
5103,5104,21-10-2020 15:03:07.684193,Desayunos · Café,Moramia,39700,4700,44400
5104,5105,21-10-2020 15:03:08.055652,Saludable · Desayunos,Agua Dulce,24200,3700,27900
5105,5106,21-10-2020 15:03:08.226070,Típica,Carbón & Mondongos,24200,6400,30600
5106,5107,21-10-2020 15:03:08.446347,Desayunos · Panadería,Premium Break Bakery,18900,3700,22600
5107,5108,21-10-2020 15:03:08.766756,Desayunos · Panadería,Ficchi Panadería,29500,3100,32600
5108,5109,21-10-2020 15:03:08.987081,Desayunos · Empanadas,Mis Delicias,15000,3200,18200
5109,5110,21-10-2020 15:03:09.157701,Mexicana,Cantina La 15,70000,4300,74300
5110,5111,21-10-2020 15:03:09.428331,Pizza · Italiana,Pisapore - Pizza,31800,6600,38400
5111,5112,21-10-2020 15:03:09.598683,Desayunos,Desayunos en Bogotá,24200,3400,27600
5112,5113,21-10-2020 15:03:09.819323,Pollo · China,China Tao,24300,3500,27800
5113,5114,21-10-2020 15:03:10.089603,Desayunos · Típica,Criollomania,31800,5200,37000
5114,5115,21-10-2020 15:03:10.209750,Desayunos · Café,Moramia,9000,4700,13700
5115,5116,21-10-2020 15:03:10.329797,Pollo · China,China Tao,15000,3500,18500
5116,5117,21-10-2020 15:03:10.700355,Saludable · Desayunos,Bon Eat - Saludable,11870,4800,16670
5117,5118,21-10-2020 15:03:10.820525,Pescados y Mariscos,Pescadero Héroes del Mar,53900,6600,60500
5118,5119,21-10-2020 15:03:10.990791,Internacional,Rio Sabores y Experiencias,10700,4100,14800
5119,5120,21-10-2020 15:03:11.311034,Pollo · Sánduches,Pollos Century,27800,3000,30800
5120,5121,21-10-2020 15:03:11.681505,Desayunos · Panadería,Santa Juana Food Bar,7500,5900,13400
5121,5122,21-10-2020 15:03:11.801814,Típica · Parrilla,La Ternera Parrilla,48750,5200,53950
5122,5123,21-10-2020 15:03:12.122272,Típica,Sopitas y Más,8900,4200,13100
5123,5124,21-10-2020 15:03:12.392531,Desayunos · Típica,D´Porco,17800,3900,21700
5124,5125,21-10-2020 15:03:12.512595,Desayunos · Café,Frambas,53900,3400,57300
5125,5126,21-10-2020 15:03:12.682768,Mexicana,Cantina La 15,15600,4300,19900
5126,5127,21-10-2020 15:03:12.902983,Parrilla,Arepaisa de Medellín,39700,5600,45300
5127,5128,21-10-2020 15:03:13.074204,Desayunos · Panadería,Ficchi Panadería,23000,3100,26100
5128,5129,21-10-2020 15:03:13.345009,Típica,El Cucharón - Tipica,24200,4400,28600
5129,5130,21-10-2020 15:03:13.515733,Típica,Sabores De Mi Tierra,53900,5400,59300
5130,5131,21-10-2020 15:03:13.636199,Postres · Desayunos,La Folie - Postres,53900,3300,57200
5131,5132,21-10-2020 15:03:13.806655,Parrilla,Campocina,12500,4600,17100
5132,5133,21-10-2020 15:03:13.976829,Desayunos · Típica,Peninsula Calentados y Parrilla,8900,3400,12300
5133,5134,21-10-2020 15:03:14.147202,Comida Rápida · Perros Calientes,Similoa - Comida Rapida,35000,3700,38700
5134,5135,21-10-2020 15:03:14.517797,Desayunos · Pescados y Mariscos,Luzí­a - Mediterranea,15000,5700,20700
5135,5136,21-10-2020 15:03:14.638044,Desayunos · Café,El Gualilo,24200,6200,30400
5136,5137,21-10-2020 15:03:14.809118,Desayunos · Típica,Casa Vieja,45800,6000,51800
5137,5138,21-10-2020 15:03:15.180504,Típica,Bandejas Mrg,18900,3800,22700
5138,5139,21-10-2020 15:03:15.301264,Parrilla · Café,Gaira Café,13000,4400,17400
5139,5140,21-10-2020 15:03:15.672412,Desayunos · Café,vereda central calle 99,12500,5700,18200
5140,5141,21-10-2020 15:03:15.943314,Desayunos · Parrilla,Mi Patria,65000,4600,69600
5141,5142,21-10-2020 15:03:16.114627,Postres · Desayunos,Gelateria Da Favola,24300,6500,30800
5142,5143,21-10-2020 15:03:16.335846,Comida Rápida,Fiesta Digital Andrés,48750,3100,51850
5143,5144,21-10-2020 15:03:16.507018,Pollo · Desayunos,Piaf,31800,6500,38300
5144,5145,21-10-2020 15:03:16.628193,Desayunos · Panadería,Choclofee,37900,4700,42600
5145,5146,21-10-2020 15:03:16.748849,Desayunos · Café,Frambas,65000,3400,68400
5146,5147,21-10-2020 15:03:17.070714,Típica,El Cucharón - Tipica,24200,4400,28600
5147,5148,21-10-2020 15:03:17.342360,Típica · Parrilla,Typykos,9000,6000,15000
5148,5149,21-10-2020 15:03:17.663997,Desayunos · Empanadas,Mis Delicias,7500,3200,10700
5149,5150,21-10-2020 15:03:17.784288,Desayunos · Empanadas,Empanadas Doraditas.com,13600,3000,16600
5150,5151,21-10-2020 15:03:17.905187,Postres · Desayunos,La Folie - Postres,45800,3300,49100
5151,5152,21-10-2020 15:03:18.075515,Típica,Salsig,27800,5600,33400
5152,5153,21-10-2020 15:03:18.296797,Sushi · Asiática,Tu Sushi,12500,6400,18900
5153,5154,21-10-2020 15:03:18.667334,Saludable,Amor Propio saludable,48750,4000,52750
5154,5155,21-10-2020 15:03:18.938437,Desayunos · Panadería,Ficchi Panadería,35000,3100,38100
5155,5156,21-10-2020 15:03:19.108656,Postres · Desayunos,Amelie Helados,15600,6400,22000
5156,5157,21-10-2020 15:03:19.279607,Saludable,Puro Verde,24300,5700,30000
5157,5158,21-10-2020 15:03:19.600195,Típica,La Olla de Barro,23000,5300,28300
5158,5159,21-10-2020 15:03:19.921418,Pollo · China,China Tao,29500,3500,33000
5159,5160,21-10-2020 15:03:20.292160,Postres · Café,Celestino Café,15000,5900,20900
5160,5161,21-10-2020 15:03:20.513742,Típica,Cabrito Santandereano,27800,6600,34400
5161,5162,21-10-2020 15:03:20.683933,Desayunos · Café,El Gualilo,53900,6200,60100
5162,5163,21-10-2020 15:03:21.004459,Desayunos · Típica,La Parrilla Dorada Polo,17800,6600,24400
5163,5164,21-10-2020 15:03:21.274818,Típica,Campo Victoria,53900,3000,56900
5164,5165,21-10-2020 15:03:21.645554,Desayunos · Panadería,El Pan de Phillippe,18900,4600,23500
5165,5166,21-10-2020 15:03:21.965919,China,China Food Col,18900,3600,22500
5166,5167,21-10-2020 15:03:22.136199,Desayunos · Típica,Desayunadero de la 42,34500,5900,40400
5167,5168,21-10-2020 15:03:22.456778,Pizza,18 Scalini,39700,4300,44000
5168,5169,21-10-2020 15:03:22.778349,Pollo · Típica,Auyama,35000,3900,38900
5169,5170,21-10-2020 15:03:22.898629,Desayunos · Empanadas,Mis Delicias,39700,3200,42900
5170,5171,21-10-2020 15:03:23.219632,Típica · Parrilla,Mi Ranchito Parrilla,53400,4400,57800
5171,5172,21-10-2020 15:03:23.490141,Saludable,The Good Rice Bowls,35000,3500,38500
5172,5173,21-10-2020 15:03:23.710430,Saludable · Desayunos,Agua Dulce,29500,3700,33200
5173,5174,21-10-2020 15:03:23.980958,Parrilla,Restaurante Bar Mi Ranchito,70000,5200,75200
5174,5175,21-10-2020 15:03:24.351536,Hamburguesas · Saludable,Restaurant Inn,12500,6100,18600
5175,5176,21-10-2020 15:03:24.622092,Desayunos · Café,vereda central calle 99,34500,5700,40200
5176,5177,21-10-2020 15:03:24.842609,Postres · Desayunos,Sweet Tale,9000,5800,14800
5177,5178,21-10-2020 15:03:25.163019,Parrilla,Antojo a Domicilio,45800,5000,50800
5178,5179,21-10-2020 15:03:25.533681,Pollo · Típica,Auyama,31800,3900,35700
5179,5180,21-10-2020 15:03:25.804008,Comida Rápida,Fiesta Digital Andrés,15000,3100,18100
5180,5181,21-10-2020 15:03:25.923961,Saludable · Desayunos,Re.al Alimentos Reales,18900,4000,22900
5181,5182,21-10-2020 15:03:26.144244,Internacional,La Esquina con Sabor Parrilla,53400,3000,56400
5182,5183,21-10-2020 15:03:26.314739,Desayunos · Típica,Papadió - Colombianas,35000,5700,40700
5183,5184,21-10-2020 15:03:26.635334,Desayunos · Panadería,Siena Café,23000,3700,26700
5184,5185,21-10-2020 15:03:26.855627,Saludable,Hanai - Bowls Saludables,23000,5900,28900
5185,5186,21-10-2020 15:03:27.075778,Pollo · Sánduches,Pollos Century,23000,3000,26000
5186,5187,21-10-2020 15:03:27.446230,Postres · Desayunos,Vivalight Market.,11870,6500,18370
5187,5188,21-10-2020 15:03:27.667024,Café · Helados,Sofia heladería y café,65000,5800,70800
5188,5189,21-10-2020 15:03:27.838507,Saludable · Jugos y Batidos,Berdes Drinks & Salads,34500,3500,38000
5189,5190,21-10-2020 15:03:28.209053,Desayunos,Sunny Breakfast Brunch,18900,4300,23200
5190,5191,21-10-2020 15:03:28.479253,Panadería,Boul,24200,3100,27300
5191,5192,21-10-2020 15:03:28.749458,Desayunos · Típica,Desayunadero de la 42,18900,5900,24800
5192,5193,21-10-2020 15:03:28.969642,Pollo · Sánduches,Pollos Century,8900,3000,11900
5193,5194,21-10-2020 15:03:29.139499,Postres · Desayunos,Protein Bakes,15000,5900,20900
5194,5195,21-10-2020 15:03:29.309554,Postres,Beiked,37900,4000,41900
5195,5196,21-10-2020 15:03:29.679925,Saludable,Hanai - Bowls Saludables,31800,5900,37700
5196,5197,21-10-2020 15:03:29.950333,Desayunos,Bagel Shop,23000,3200,26200
5197,5198,21-10-2020 15:03:30.170373,Típica,Sabrosito,53400,4000,57400
5198,5199,21-10-2020 15:03:30.440559,Mexicana,La leyenda mexican kitchen,23000,3200,26200
5199,5200,21-10-2020 15:03:30.710841,Jugos y Batidos,Pomponio,13600,3600,17200
5200,5201,21-10-2020 15:03:30.881418,Desayunos · Típica,La Frijolada,13600,4500,18100
5201,5202,21-10-2020 15:03:31.051915,Parrilla · Café,Figaro Café/ Restaurante Argentino,35000,5800,40800
5202,5203,21-10-2020 15:03:31.172439,Desayunos · Panadería,Ficchi Panadería,34500,3100,37600
5203,5204,21-10-2020 15:03:31.393004,Desayunos · Panadería,Siena Café,24300,3700,28000
5204,5205,21-10-2020 15:03:31.513444,Desayunos · Típica,Rojo Gourmet,10700,4700,15400
5205,5206,21-10-2020 15:03:31.834031,Postres · Panadería,RIGHT AWAY FOODS,35000,6600,41600
5206,5207,21-10-2020 15:03:31.954240,Postres,Toledo Pastelería,10700,6800,17500
5207,5208,21-10-2020 15:03:32.324784,Desayunos · Jugos y Batidos,Frutiwow,11870,4100,15970
5208,5209,21-10-2020 15:03:32.444749,Desayunos · Internacional,Camilia,18900,3900,22800
5209,5210,21-10-2020 15:03:32.815248,Desayunos · Café,Norma's Ice Cream Café,23000,6300,29300
5210,5211,21-10-2020 15:03:33.186817,Desayunos,Sunny Breakfast Brunch,70000,4300,74300
5211,5212,21-10-2020 15:03:33.357165,Desayunos · Panadería,Pasteleite,23000,5900,28900
5212,5213,21-10-2020 15:03:33.577634,Sushi · Asiática,Tu Sushi,24200,6400,30600
5213,5214,21-10-2020 15:03:33.798016,Postres · Saludable,Ana Rebana,37900,6300,44200
5214,5215,21-10-2020 15:03:33.918269,Típica,Lo Nuestro,23000,3100,26100
5215,5216,21-10-2020 15:03:34.088525,Desayunos · Mexicana,La Mera Mera - Mexicana,23000,3100,26100
5216,5217,21-10-2020 15:03:34.358678,Café · Helados,Sofia heladería y café,23000,5800,28800
5217,5218,21-10-2020 15:03:34.678862,Típica,Carbón & Mondongos,29500,6400,35900
5218,5219,21-10-2020 15:03:34.799014,Postres · Desayunos,Maltihelado,37900,4500,42400
5219,5220,21-10-2020 15:03:35.019658,Desayunos · Típica,La Frijolada,35000,4500,39500
5220,5221,21-10-2020 15:03:35.390441,Parrilla,Restaurante Bar Mi Ranchito,13000,5200,18200
5221,5222,21-10-2020 15:03:35.661031,Hamburguesas · Alitas,Beer,31800,6600,38400
5222,5223,21-10-2020 15:03:35.931930,Pollo,Oliva Va,29500,5600,35100
5223,5224,21-10-2020 15:03:36.302785,Típica · Pescados y Mariscos,La Vitualla,34500,6300,40800
5224,5225,21-10-2020 15:03:36.523192,Peruana · Internacional,La Chifería,17800,6600,24400
5225,5226,21-10-2020 15:03:36.693669,Desayunos · Típica,La Frijolada,18900,4500,23400
5226,5227,21-10-2020 15:03:37.064289,Parrilla,Beraca Parrilla Bbq,9000,5600,14600
5227,5228,21-10-2020 15:03:37.334651,Crepes,San Crepes,9000,4900,13900
5228,5229,21-10-2020 15:03:37.555231,Pollo · Saludable,Tremenda Sal y Dulce,11870,6500,18370
5229,5230,21-10-2020 15:03:37.725622,Desayunos · Café,El Gualilo,11870,6200,18070
5230,5231,21-10-2020 15:03:37.995752,Típica · Parrilla,La Parilla de David,70000,3100,73100
5231,5232,21-10-2020 15:03:38.165943,Postres,La Tertulia,53900,3400,57300
5232,5233,21-10-2020 15:03:38.487283,Pollo,Oliva Va,17800,5600,23400
5233,5234,21-10-2020 15:03:38.607815,Desayunos · Típica,D'Porco - Lechona,27800,6300,34100
5234,5235,21-10-2020 15:03:38.728306,Postres · Desayunos,Sharmus,10700,6100,16800
5235,5236,21-10-2020 15:03:38.848638,Pizza · Italiana,Pisapore - Pizza,53400,6600,60000
5236,5237,21-10-2020 15:03:39.019035,Desayunos,Bagel Shop,18900,3200,22100
5237,5238,21-10-2020 15:03:39.339811,Hamburguesas,Gofi Burger,15600,5100,20700
5238,5239,21-10-2020 15:03:39.660342,Desayunos · Típica,Criollomania,18900,5200,24100
5239,5240,21-10-2020 15:03:40.030881,Hamburguesas · Desayunos,El Inglés Gastro Pub,23000,6600,29600
5240,5241,21-10-2020 15:03:40.151337,Pollo,Señor Fantástico,12500,4700,17200
5241,5242,21-10-2020 15:03:40.372220,Pizza · Italiana,Pisapore - Pizza,39700,6600,46300
5242,5243,21-10-2020 15:03:40.542598,Hamburguesas,Gofi Burger,18900,5100,24000
5243,5244,21-10-2020 15:03:40.762787,Pizza,pizza andante,24300,4200,28500
5244,5245,21-10-2020 15:03:40.933191,Típica · Parrilla,Mi Ranchito Parrilla,53900,4400,58300
5245,5246,21-10-2020 15:03:41.053497,Desayunos · Típica,Fogón Sangileño,18900,5000,23900
5246,5247,21-10-2020 15:03:41.323903,Desayunos · Panadería,Limarys,11870,6500,18370
5247,5248,21-10-2020 15:03:41.494315,Peruana,Masivo,35000,5800,40800
5248,5249,21-10-2020 15:03:41.664464,Pollo · Sánduches,Pollos Century,65000,3000,68000
5249,5250,21-10-2020 15:03:41.785715,Típica,Baondish,53900,5800,59700
5250,5251,21-10-2020 15:03:41.956643,Desayunos · Pescados y Mariscos,Luzí­a - Mediterranea,53400,5700,59100
5251,5252,21-10-2020 15:03:42.077477,Jugos y Batidos,Pomponio,23000,3600,26600
5252,5253,21-10-2020 15:03:42.349162,Asiática,TeT,27800,5900,33700
5253,5254,21-10-2020 15:03:42.619865,Típica · Parrilla,Toya,45800,4200,50000
5254,5255,21-10-2020 15:03:42.740269,Pollo · Saludable,Yerbabuena,35000,3900,38900
5255,5256,21-10-2020 15:03:42.961727,Desayunos,Bagel Shop,65000,3200,68200
5256,5257,21-10-2020 15:03:43.182193,Típica · Pescados y Mariscos,La Vitualla,15000,6300,21300
5257,5258,21-10-2020 15:03:43.352456,Postres · Saludable,Ana Rebana,12500,6300,18800
5258,5259,21-10-2020 15:03:43.574813,Postres · Desayunos,BagBog Bagels,29500,6400,35900
5259,5260,21-10-2020 15:03:43.795609,Postres · Desayunos,Restaurante Cornelia,45800,5500,51300
5260,5261,21-10-2020 15:03:44.116589,Sushi · Desayunos,Maki Roll,53900,4300,58200
5261,5262,21-10-2020 15:03:44.337903,Desayunos · Típica,Criollomania,23000,5200,28200
5262,5263,21-10-2020 15:03:44.708696,Desayunos,Archies Desayunos,65000,3100,68100
5263,5264,21-10-2020 15:03:45.079387,Desayunos · Café,Norma's Ice Cream Café,11870,6300,18170
5264,5265,21-10-2020 15:03:45.451103,Saludable · Desayunos,Básico y Elemental,12500,5900,18400
5265,5266,21-10-2020 15:03:45.772115,Postres · Desayunos,Maltihelados,53400,6200,59600
5266,5267,21-10-2020 15:03:46.043596,Saludable,The Good Rice Bowls,70000,3500,73500
5267,5268,21-10-2020 15:03:46.165063,Saludable,Ventura Soup y Salad,11870,3800,15670
5268,5269,21-10-2020 15:03:46.486064,Mexicana,Mexicanachos,29500,3900,33400
5269,5270,21-10-2020 15:03:46.806949,Pollo · Sánduches,Pollos Century,23000,3000,26000
5270,5271,21-10-2020 15:03:46.978313,Alta Cocina · Italiana,Trattoria de la Plaza,65000,6000,71000
5271,5272,21-10-2020 15:03:47.199235,Postres · Helados,Mahé,35000,6000,41000
5272,5273,21-10-2020 15:03:47.370167,Desayunos · Panadería,Decofruta,11870,4700,16570
5273,5274,21-10-2020 15:03:47.591726,Desayunos,La Frijolada Desayunos,65000,4400,69400
5274,5275,21-10-2020 15:03:47.863240,Desayunos · Típica,Papadió - Colombianas,17800,5700,23500
5275,5276,21-10-2020 15:03:48.133953,Saludable · Desayunos,Bon Eat - Saludable,8900,4800,13700
5276,5277,21-10-2020 15:03:48.455302,Típica,La Herencia,12500,5900,18400
5277,5278,21-10-2020 15:03:48.727069,Típica · Parrilla,Mi Ranchito Parrilla,10700,4400,15100
5278,5279,21-10-2020 15:03:48.898122,Postres · Café,Celestino Café,15600,5900,21500
5279,5280,21-10-2020 15:03:49.019364,Desayunos · Panadería,Limarys,35000,6500,41500
5280,5281,21-10-2020 15:03:49.240467,Saludable · Desayunos,Distrito Gourmet,53900,3700,57600
5281,5282,21-10-2020 15:03:49.461223,Sánduches · China,Peru Mix,34500,5900,40400
5282,5283,21-10-2020 15:03:49.682537,Pescados y Mariscos,Fish Place - Del Mar,29500,5400,34900
5283,5284,21-10-2020 15:03:50.002992,Saludable · Desayunos,Fresh Co,24200,5600,29800
5284,5285,21-10-2020 15:03:50.123619,Sushi,Sushi Reel,70000,4700,74700
5285,5286,21-10-2020 15:03:50.245007,Saludable · Desayunos,Fresh Co,70000,5600,75600
5286,5287,21-10-2020 15:03:50.415972,Hamburguesas · Panadería,NYC Burgers,12500,6200,18700
5287,5288,21-10-2020 15:03:50.536604,Parrilla,OAK Ahumado y Brebajes,34500,6000,40500
5288,5289,21-10-2020 15:03:50.808155,Poke,Poke Go,35000,4600,39600
5289,5290,21-10-2020 15:03:51.129043,Desayunos · Pescados y Mariscos,Luzí­a - Mediterranea,45800,5700,51500
5290,5291,21-10-2020 15:03:51.349969,Saludable · Desayunos,Libre de Culpa,70000,4000,74000
5291,5292,21-10-2020 15:03:51.721465,Desayunos · Típica,La Frijolada,35000,4500,39500
5292,5293,21-10-2020 15:03:51.992201,China,China Food Col,39700,3600,43300
5293,5294,21-10-2020 15:03:52.262857,Desayunos · Internacional,Camilia,15000,3900,18900
5294,5295,21-10-2020 15:03:52.434477,Desayunos · Panadería,Ficchi Panadería,15000,3100,18100
5295,5296,21-10-2020 15:03:52.755316,Internacional,La Esquina con Sabor Parrilla,7500,3000,10500
5296,5297,21-10-2020 15:03:53.126472,Pollo · Desayunos,Piaf,70000,6500,76500
5297,5298,21-10-2020 15:03:53.497956,Típica,Salsig,31800,5600,37400
5298,5299,21-10-2020 15:03:53.820213,Sánduches · Pescados y Mariscos,Pacific Comida de Mar,13600,4000,17600
5299,5300,21-10-2020 15:03:54.091197,Desayunos · Café,Matchacha,13600,5900,19500
5300,5301,21-10-2020 15:03:54.312952,Típica,Baondish,45800,5800,51600
5301,5302,21-10-2020 15:03:54.633996,Postres · Desayunos,Maltihelados,15000,6200,21200
5302,5303,21-10-2020 15:03:55.005307,Saludable · Típica,Saludable Mrg,18900,5800,24700
5303,5304,21-10-2020 15:03:55.176774,Postres · Desayunos,Aury Postres - Comidas & Picadas,45800,4700,50500
5304,5305,21-10-2020 15:03:55.497638,Postres,La Galeta,53400,3000,56400
5305,5306,21-10-2020 15:03:55.718129,Pollo · Típica,Auyama,65000,3900,68900
5306,5307,21-10-2020 15:03:55.839457,Saludable,Amor Propio saludable,17800,4000,21800
5307,5308,21-10-2020 15:03:56.160187,Pollo · Desayunos,Workzone,48750,3100,51850
5308,5309,21-10-2020 15:03:56.280819,Típica,Cazuelitas 93,8900,3900,12800
5309,5310,21-10-2020 15:03:56.451965,Desayunos,Jacinta Arepas de Huevo,70000,4000,74000
5310,5311,21-10-2020 15:03:56.773413,Alta Cocina · Parrilla,Criterión,12500,6000,18500
5311,5312,21-10-2020 15:03:56.893873,Típica · Parrilla,Parrilla Farandula Gourmet,8900,5100,14000
5312,5313,21-10-2020 15:03:57.065467,Internacional,La Esquina con Sabor Parrilla,53400,3000,56400
5313,5314,21-10-2020 15:03:57.386526,Pescados y Mariscos,Fish Place - Del Mar,10700,5400,16100
5314,5315,21-10-2020 15:03:57.557507,Típica,Sabrosito,17800,4000,21800
5315,5316,21-10-2020 15:03:57.679189,Desayunos · Panadería,Siena Café,27800,3700,31500
5316,5317,21-10-2020 15:03:57.850238,Desayunos,Sr Buñuelo,18900,6400,25300
5317,5318,21-10-2020 15:03:58.221603,Italiana,Bocatto Di Passo,12500,5000,17500
5318,5319,21-10-2020 15:03:58.343030,Saludable · Jugos y Batidos,Berdes Drinks & Salads,35000,3500,38500
5319,5320,21-10-2020 15:03:58.463897,Sánduches,Submarin,8900,3800,12700
5320,5321,21-10-2020 15:03:58.735005,Desayunos,La Frijolada Desayunos,10700,4400,15100
5321,5322,21-10-2020 15:03:59.007668,Postres · Desayunos,Aury Postres - Comidas & Picadas,31800,4700,36500
5322,5323,21-10-2020 15:03:59.228914,Desayunos · Panadería,Juliana Restaurante,24200,6100,30300
5323,5324,21-10-2020 15:03:59.550360,Desayunos · Típica,Rojo Gourmet,29500,4700,34200
5324,5325,21-10-2020 15:03:59.671499,Pizza,18 Scalini,24300,4300,28600
5325,5326,21-10-2020 15:03:59.842839,Saludable · Desayunos,Libre de Culpa,53400,4000,57400
5326,5327,21-10-2020 15:04:00.014060,Pollo · Sánduches,Pollos Century,53900,3000,56900
5327,5328,21-10-2020 15:04:00.285507,Sushi,Sushi Reel,9000,4700,13700
5328,5329,21-10-2020 15:04:00.506490,Típica · Pescados y Mariscos,Arroces Mrg,35000,4300,39300
5329,5330,21-10-2020 15:04:00.678121,Saludable · Desayunos,Agua Dulce,27800,3700,31500
5330,5331,21-10-2020 15:04:00.949468,Parrilla,Coquitas,12500,5600,18100
5331,5332,21-10-2020 15:04:01.321324,Desayunos,Don Leo,35000,6000,41000
5332,5333,21-10-2020 15:04:01.492166,Desayunos · Parrilla,Mi Patria,53400,4600,58000
5333,5334,21-10-2020 15:04:01.663760,Postres · Desayunos,Aury Postres - Comidas & Picadas,27800,4700,32500
5334,5335,21-10-2020 15:04:01.784960,Postres · Helados,Mahé,18900,6000,24900
5335,5336,21-10-2020 15:04:02.106954,Postres,La Galeta,37900,3000,40900
5336,5337,21-10-2020 15:04:02.227766,Sánduches · Pescados y Mariscos,Pacific Comida de Mar,39700,4000,43700
5337,5338,21-10-2020 15:04:02.449416,Saludable · Desayunos,Distrito Gourmet,15600,3700,19300
5338,5339,21-10-2020 15:04:02.770643,Pollo · Desayunos,Candelina,12500,5300,17800
5339,5340,21-10-2020 15:04:02.992314,Típica,La Olla de Barro,45800,5300,51100
5340,5341,21-10-2020 15:04:03.313742,Desayunos · Típica,Criollomania,39700,5200,44900
5341,5342,21-10-2020 15:04:03.535567,Saludable · Jugos y Batidos,Berdes Drinks & Salads,15000,3500,18500
5342,5343,21-10-2020 15:04:03.906995,Saludable · Desayunos,Agua Dulce,9000,3700,12700
5343,5344,21-10-2020 15:04:04.229016,Pescados y Mariscos,La Gran Cazuela,17800,3200,21000
5344,5345,21-10-2020 15:04:04.400203,Desayunos,Don Leo,27800,6000,33800
5345,5346,21-10-2020 15:04:04.721917,Desayunos · Helados,San Giorgio Gelateria,35000,3100,38100
5346,5347,21-10-2020 15:04:05.043273,Desayunos,Jacinta Arepas de Huevo,24300,4000,28300
5347,5348,21-10-2020 15:04:05.264728,Saludable · Desayunos,Malú,10700,3700,14400
5348,5349,21-10-2020 15:04:05.536099,Desayunos · Café,Norma's Ice Cream Café,23000,6300,29300
5349,5350,21-10-2020 15:04:05.657825,Pescados y Mariscos,Fish Place - Del Mar,34500,5400,39900
5350,5351,21-10-2020 15:04:05.929378,Sushi,Kim Pop,10700,5400,16100
5351,5352,21-10-2020 15:04:06.201753,Pollo · China,China Tao,24300,3500,27800
5352,5353,21-10-2020 15:04:06.373293,Asiática,TeT,31800,5900,37700
5353,5354,21-10-2020 15:04:06.694754,Saludable · Desayunos,La Cesta,18900,4700,23600
5354,5355,21-10-2020 15:04:06.866119,Desayunos,Desayunos en Bogotá,29500,3400,32900
5355,5356,21-10-2020 15:04:06.987435,Postres · Desayunos,Amelie Helados,37900,6400,44300
5356,5357,21-10-2020 15:04:07.258519,Sushi · Asiática,Tu Sushi,13600,6400,20000
5357,5358,21-10-2020 15:04:07.580495,Italiana,F*cking Good Pizza,24200,4200,28400
5358,5359,21-10-2020 15:04:07.801653,Desayunos · Mexicana,La Mera Mera - Mexicana,7500,3100,10600
5359,5360,21-10-2020 15:04:08.123153,Pizza,Pizza Andante,10700,6300,17000
5360,5361,21-10-2020 15:04:08.394652,Típica · Parrilla,La Parilla de David,11870,3100,14970
5361,5362,21-10-2020 15:04:08.616585,Desayunos · Panadería,Ficchi Panadería,11870,3100,14970
5362,5363,21-10-2020 15:04:08.788108,Típica · Parrilla,La Parilla de David,15000,3100,18100
5363,5364,21-10-2020 15:04:08.959825,Postres · Desayunos,Gelateria Da Favola,65000,6500,71500
5364,5365,21-10-2020 15:04:09.282332,Pizza · Parrilla,Urban Lunch,37900,4000,41900
5365,5366,21-10-2020 15:04:09.404018,Desayunos,La Frijolada Desayunos,24300,4400,28700
5366,5367,21-10-2020 15:04:09.725786,Sushi,Kim Pop,70000,5400,75400
5367,5368,21-10-2020 15:04:09.947602,Peruana,Uma Cantina Peruana,35000,3200,38200
5368,5369,21-10-2020 15:04:10.119122,Desayunos · Panadería,Decofruta,23000,4700,27700
5369,5370,21-10-2020 15:04:10.391101,Postres · Desayunos,Protein Bakes,18900,5900,24800
5370,5371,21-10-2020 15:04:10.662335,Desayunos · Café,Libertario Coffee Roasters,15000,4600,19600
5371,5372,21-10-2020 15:04:10.834094,Saludable · Desayunos,Fresh Co,23000,5600,28600
5372,5373,21-10-2020 15:04:11.205636,Desayunos · Café,Moramia,53400,4700,58100
5373,5374,21-10-2020 15:04:11.577413,Hamburguesas · Saludable,Restaurant Inn,53900,6100,60000
5374,5375,21-10-2020 15:04:11.898667,Pollo · Pescados y Mariscos,Bang Bang Rice,24300,3400,27700
5375,5376,21-10-2020 15:04:12.070458,Jugos y Batidos,Pomponio,65000,3600,68600
5376,5377,21-10-2020 15:04:12.241826,Crepes,San Crepes,13000,4900,17900
5377,5378,21-10-2020 15:04:12.513832,Hamburguesas · Pescados y Mariscos,El Velero,23000,6500,29500
5378,5379,21-10-2020 15:04:12.885291,Saludable · Desayunos,Distrito Gourmet,70000,3700,73700
5379,5380,21-10-2020 15:04:13.006540,Desayunos · Empanadas,Empanadas Doraditas.com,35000,3000,38000
5380,5381,21-10-2020 15:04:13.277897,Saludable · Desayunos,Agua Dulce,15000,3700,18700
5381,5382,21-10-2020 15:04:13.399509,Saludable,A2manos,35000,4200,39200
5382,5383,21-10-2020 15:04:13.771202,Saludable · Desayunos,Distrito Gourmet,65000,3700,68700
5383,5384,21-10-2020 15:04:13.993169,Saludable · Parrilla,The Angels Grill and Drinks,15600,6200,21800
5384,5385,21-10-2020 15:04:14.214639,Saludable · Desayunos,Copacabana Açai Bowls,15000,3000,18000
5385,5386,21-10-2020 15:04:14.437735,Postres · Desayunos,Maria Luisa - Postres,18900,4300,23200
5386,5387,21-10-2020 15:04:14.659252,Helados,Buon Gelato,11870,4400,16270
5387,5388,21-10-2020 15:04:14.830955,Hamburguesas,Monchis - Hamburguesa,27800,4300,32100
5388,5389,21-10-2020 15:04:15.052428,Italiana,Bocatto Di Passo,15600,5000,20600
5389,5390,21-10-2020 15:04:15.424431,Desayunos,Señor Desayuno,31800,6800,38600
5390,5391,21-10-2020 15:04:15.645906,Pollo,Chicken House,7500,4200,11700
5391,5392,21-10-2020 15:04:15.967993,Desayunos,Desayunos en Bogotá,65000,3400,68400
5392,5393,21-10-2020 15:04:16.089257,Saludable · Parrilla,Box,11870,3700,15570
5393,5394,21-10-2020 15:04:16.211482,Hamburguesas,Bendito Cordero,31800,5800,37600
5394,5395,21-10-2020 15:04:16.383327,Pescados y Mariscos,Fish Place - Del Mar,70000,5400,75400
5395,5396,21-10-2020 15:04:16.655420,Pollo · Saludable,Tremenda Sal y Dulce,13600,6500,20100
5396,5397,21-10-2020 15:04:17.027095,China,China Food Col,8900,3600,12500
5397,5398,21-10-2020 15:04:17.148794,Sushi,Sushi Reel,31800,4700,36500
5398,5399,21-10-2020 15:04:17.470103,Parrilla,Parrilla Pimentón,13600,3400,17000
5399,5400,21-10-2020 15:04:17.742072,Desayunos · Panadería,Ficchi Panadería,45800,3100,48900
5400,5401,21-10-2020 15:04:17.913697,Desayunos · Típica,Peninsula Calentados y Parrilla,53400,3400,56800
5401,5402,21-10-2020 15:04:18.085483,China,China Food Col,10700,3600,14300
5402,5403,21-10-2020 15:04:18.456818,Italiana,F*cking Good Pizza,34500,4200,38700
5403,5404,21-10-2020 15:04:18.578264,Pollo · Desayunos,Workzone,11870,3100,14970
5404,5405,21-10-2020 15:04:18.699523,Típica,La Olla de Barro,45800,5300,51100
5405,5406,21-10-2020 15:04:18.871164,Desayunos · Comida Rápida,La Veneca,10700,6300,17000
5406,5407,21-10-2020 15:04:18.992383,Hamburguesas · Desayunos,El Inglés Gastro Pub,9000,6600,15600
5407,5408,21-10-2020 15:04:19.264328,Desayunos · Panadería,Juliana Restaurante,12500,6100,18600
5408,5409,21-10-2020 15:04:19.385951,Pollo · Desayunos,Abasto,9000,3600,12600
5409,5410,21-10-2020 15:04:19.559172,Saludable,Amor Propio saludable,9000,4000,13000
5410,5411,21-10-2020 15:04:19.731119,Desayunos · Italiana,Rceta By Rausch,13600,3600,17200
5411,5412,21-10-2020 15:04:19.952923,Parrilla · Café,Gaira Café,10700,4400,15100
5412,5413,21-10-2020 15:04:20.174301,Pollo · Pescados y Mariscos,Bang Bang Rice,35000,3400,38400
5413,5414,21-10-2020 15:04:20.546356,Desayunos · Empanadas,Empanadas Doraditas.com,9000,3000,12000
5414,5415,21-10-2020 15:04:20.867975,Desayunos · Típica,Papadió - Colombianas,31800,5700,37500
5415,5416,21-10-2020 15:04:21.189898,Postres · Desayunos,Aury Postres - Comidas & Picadas,8900,4700,13600
5416,5417,21-10-2020 15:04:21.461001,Sushi,Umi,37900,5600,43500
5417,5418,21-10-2020 15:04:21.582484,China,China Food Col,9000,3600,12600
5418,5419,21-10-2020 15:04:21.703925,Desayunos · Típica,Criollomania,48750,5200,53950
5419,5420,21-10-2020 15:04:21.825655,Pescados y Mariscos,La Gran Cazuela,24300,3200,27500
5420,5421,21-10-2020 15:04:21.996648,Típica,La Herencia,31800,5900,37700
5421,5422,21-10-2020 15:04:22.218466,Desayunos · Café,Frambas,45800,3400,49200
5422,5423,21-10-2020 15:04:22.390100,Típica,Cabrito Santandereano,7500,6600,14100
5423,5424,21-10-2020 15:04:22.562080,Perros Calientes,Dog Shop - Rapida,15600,4900,20500
5424,5425,21-10-2020 15:04:22.733610,Saludable,Amor Propio saludable,39700,4000,43700
5425,5426,21-10-2020 15:04:23.105794,Pescados y Mariscos,Pescadero Héroes del Mar,18900,6600,25500
5426,5427,21-10-2020 15:04:23.277165,Crepes,San Crepes,23000,4900,27900
5427,5428,21-10-2020 15:04:23.599187,Hamburguesas,Monchis - Hamburguesa,24300,4300,28600
5428,5429,21-10-2020 15:04:23.972453,Desayunos · Típica,Criollomania,53900,5200,59100
5429,5430,21-10-2020 15:04:24.344362,Desayunos,Cafetería el Kippe,53900,3200,57100
5430,5431,21-10-2020 15:04:24.667157,Desayunos · Jugos y Batidos,Kuriwaji,8900,6300,15200
5431,5432,21-10-2020 15:04:24.839118,Sánduches · China,Peru Mix,11870,5900,17770
5432,5433,21-10-2020 15:04:25.060653,Postres · Desayunos,La Folie - Postres,34500,3300,37800
5433,5434,21-10-2020 15:04:25.382763,Típica,Sabores De Mi Tierra,10700,5400,16100
5434,5435,21-10-2020 15:04:25.654590,Pollo,Heart & Cooking,15000,5000,20000
5435,5436,21-10-2020 15:04:26.026617,Típica,Juan Chorizo,11870,3900,15770
5436,5437,21-10-2020 15:04:26.198079,Típica,El Mondongo y Mucho Mas,29500,5600,35100
5437,5438,21-10-2020 15:04:26.420107,Típica,Sabores De Mi Tierra,31800,5400,37200
5438,5439,21-10-2020 15:04:26.691639,Saludable · Parrilla,The Angels Grill and Drinks,12500,6200,18700
5439,5440,21-10-2020 15:04:27.063823,Pollo · Desayunos,Candelina,27800,5300,33100
5440,5441,21-10-2020 15:04:27.435254,Parrilla,Arepaisa de Medellín,23000,5600,28600
5441,5442,21-10-2020 15:04:27.610220,Típica,Sabrosito,7500,4000,11500
5442,5443,21-10-2020 15:04:27.933248,Poke,Poke Go,27800,4600,32400
5443,5444,21-10-2020 15:04:28.156689,Sushi · Desayunos,Maki Roll,70000,4300,74300
5444,5445,21-10-2020 15:04:28.328358,Desayunos,Sunny Breakfast Brunch,8900,4300,13200
5445,5446,21-10-2020 15:04:28.450112,Pizza · Italiana,Pisapore - Pizza,24300,6600,30900
5446,5447,21-10-2020 15:04:28.621616,Postres · Desayunos,Sharmus,7500,6100,13600
5447,5448,21-10-2020 15:04:28.793075,Comida Rápida · Perros Calientes,Similoa - Comida Rapida,9000,3700,12700
5448,5449,21-10-2020 15:04:28.964208,Desayunos · Café,vereda central calle 99,24300,5700,30000
5449,5450,21-10-2020 15:04:29.085746,Italiana,Bocatto Di Passo,9000,5000,14000
5450,5451,21-10-2020 15:04:29.257262,Saludable,Hanai - Bowls Saludables,53900,5900,59800
5451,5452,21-10-2020 15:04:29.379086,Desayunos · Típica,Alce,31800,4900,36700
5452,5453,21-10-2020 15:04:29.702401,Desayunos,Señor Desayuno,13600,6800,20400
5453,5454,21-10-2020 15:04:30.075522,Hamburguesas · Desayunos,El Inglés Gastro Pub,27800,6600,34400
5454,5455,21-10-2020 15:04:30.296988,Saludable · Desayunos,Copacabana Açai Bowls,35000,3000,38000
5455,5456,21-10-2020 15:04:30.418537,Típica,El Cucharón - Tipica,9000,4400,13400
5456,5457,21-10-2020 15:04:30.640246,Desayunos · Panadería,El Pan de Phillippe,12500,4600,17100
5457,5458,21-10-2020 15:04:30.912277,Desayunos · Panadería,Premium Break Bakery,9000,3700,12700
5458,5459,21-10-2020 15:04:31.183877,Alta Cocina · Italiana,Trattoria de la Plaza,18900,6000,24900
5459,5460,21-10-2020 15:04:31.456123,Desayunos · Mexicana,La Mera Mera - Mexicana,23000,3100,26100
5460,5461,21-10-2020 15:04:31.677941,Sushi,Sushi Reel,45800,4700,50500
5461,5462,21-10-2020 15:04:31.900052,Desayunos · Sánduches,Frutos del Bosque,23000,3500,26500
5462,5463,21-10-2020 15:04:32.271634,Típica,Campo Victoria,35000,3000,38000
5463,5464,21-10-2020 15:04:32.393584,Saludable · Desayunos,Re.al Alimentos Reales,35000,4000,39000
5464,5465,21-10-2020 15:04:32.614948,Hamburguesas,Burger Society,34500,4100,38600
5465,5466,21-10-2020 15:04:32.937080,Desayunos,Desayunos en Bogotá,37900,3400,41300
5466,5467,21-10-2020 15:04:33.108337,Desayunos · Pescados y Mariscos,Luzí­a - Mediterranea,24200,5700,29900
5467,5468,21-10-2020 15:04:33.430554,Saludable,Puro Verde,48750,5700,54450
5468,5469,21-10-2020 15:04:33.802202,Parrilla,OAK Ahumado y Brebajes,35000,6000,41000
5469,5470,21-10-2020 15:04:34.024082,Parrilla · Café,Figaro Café/ Restaurante Argentino,23000,5800,28800
5470,5471,21-10-2020 15:04:34.295739,Típica,Juan Chorizo,34500,3900,38400
5471,5472,21-10-2020 15:04:34.617658,Desayunos,Sr Buñuelo,12500,6400,18900
5472,5473,21-10-2020 15:04:34.840466,Típica,Campo Victoria,7500,3000,10500
5473,5474,21-10-2020 15:04:34.962484,Desayunos · Típica,90 Calentados,35000,3700,38700
5474,5475,21-10-2020 15:04:35.284242,Saludable,The Good Rice Bowls,13600,3500,17100
5475,5476,21-10-2020 15:04:35.406284,Pescados y Mariscos,La Gran Cazuela,17800,3200,21000
5476,5477,21-10-2020 15:04:35.527904,Desayunos · Típica,Cochon,35000,3300,38300
5477,5478,21-10-2020 15:04:35.649878,Parrilla,Antojo a Domicilio,35000,5000,40000
5478,5479,21-10-2020 15:04:36.021414,Típica,Salsig,35000,5600,40600
5479,5480,21-10-2020 15:04:36.343221,Internacional,Rio Sabores y Experiencias,10700,4100,14800
5480,5481,21-10-2020 15:04:36.714975,Típica · Pescados y Mariscos,Arroces Mrg,31800,4300,36100
5481,5482,21-10-2020 15:04:37.087219,Desayunos,Don Leo,12500,6000,18500
5482,5483,21-10-2020 15:04:37.258972,Típica,El Cucharón - Tipica,17800,4400,22200
5483,5484,21-10-2020 15:04:37.581295,Típica,Cabrito Santandereano,65000,6600,71600
5484,5485,21-10-2020 15:04:37.802904,Sánduches · China,Peru Mix,24300,5900,30200
5485,5486,21-10-2020 15:04:37.924747,Desayunos,Sunny Breakfast Brunch,23000,4300,27300
5486,5487,21-10-2020 15:04:38.096375,Pollo · Sánduches,Pollos Century,24300,3000,27300
5487,5488,21-10-2020 15:04:38.419197,Típica,El Mondongo y Mucho Mas,34500,5600,40100
5488,5489,21-10-2020 15:04:38.591335,Típica,Sabores De Mi Tierra,65000,5400,70400
5489,5490,21-10-2020 15:04:38.813469,Pizza,pizza andante,15600,4200,19800
5490,5491,21-10-2020 15:04:38.934873,Sushi,Sushi Reel,35000,4700,39700
5491,5492,21-10-2020 15:04:39.206766,Desayunos · Árabe,Boniato Sabores Vivos,53400,5300,58700
5492,5493,21-10-2020 15:04:39.478591,Saludable · Desayunos,Básico y elemental,13600,5000,18600
5493,5494,21-10-2020 15:04:39.650203,Desayunos,Sr Buñuelo,17800,6400,24200
5494,5495,21-10-2020 15:04:39.771447,Típica · Parrilla,El Santandereano,37900,5200,43100
5495,5496,21-10-2020 15:04:40.044193,Hamburguesas,Bendito Cordero,15600,5800,21400
5496,5497,21-10-2020 15:04:40.215672,Desayunos · Panadería,Santa Juana Food Bar,9000,5900,14900
5497,5498,21-10-2020 15:04:40.337821,Postres · Desayunos,Sweet Tale,65000,5800,70800
5498,5499,21-10-2020 15:04:40.459478,Desayunos · Panadería,Siena Café,31800,3700,35500
5499,5500,21-10-2020 15:04:40.731605,Parrilla,Arepaisa de Medellín,15600,5600,21200
5500,5501,21-10-2020 15:04:40.853296,Desayunos,Cafetería el Kippe,23000,3200,26200
5501,5502,21-10-2020 15:04:41.225942,Peruana · Internacional,La Chifería,13600,6600,20200
5502,5503,21-10-2020 15:04:41.597859,Desayunos,Butter,27800,6700,34500
5503,5504,21-10-2020 15:04:41.970090,Desayunos · Panadería,Decofruta,48750,4700,53450
5504,5505,21-10-2020 15:04:42.191531,Saludable · Desayunos,Bon Eat - Saludable,23000,4800,27800
5505,5506,21-10-2020 15:04:42.513910,Saludable · Desayunos,Maracuyá,12500,6700,19200
5506,5507,21-10-2020 15:04:42.635510,Postres · Helados,Mahé,70000,6000,76000
5507,5508,21-10-2020 15:04:42.957697,Postres · Panadería,RIGHT AWAY FOODS,53400,6600,60000
5508,5509,21-10-2020 15:04:43.329348,Hamburguesas · Desayunos,El Inglés Gastro Pub,53400,6600,60000
5509,5510,21-10-2020 15:04:43.651632,Postres · Desayunos,Protein Bakes,17800,5900,23700
5510,5511,21-10-2020 15:04:43.823202,Saludable,The Good Rice Bowls,45800,3500,49300
5511,5512,21-10-2020 15:04:43.945255,Sushi · Desayunos,Maki Roll,12500,4300,16800
5512,5513,21-10-2020 15:04:44.316651,Desayunos · Helados,San Giorgio Gelateria,18900,3100,22000
5513,5514,21-10-2020 15:04:44.438498,Desayunos · Típica,Cochon,27800,3300,31100
5514,5515,21-10-2020 15:04:44.760330,Saludable · Típica,Saludable Mrg,23000,5800,28800
5515,5516,21-10-2020 15:04:45.134264,Parrilla,Rústico Picadería,8900,3800,12700
5516,5517,21-10-2020 15:04:45.305987,Típica · Parrilla,La Ternera Parrilla,31800,5200,37000
5517,5518,21-10-2020 15:04:45.428073,Desayunos,Archies Desayunos,10700,3100,13800
5518,5519,21-10-2020 15:04:45.599976,Postres · Desayunos,BagBog Bagels,53400,6400,59800
5519,5520,21-10-2020 15:04:45.772486,Sushi · Asiática,Arigato,13600,5300,18900
5520,5521,21-10-2020 15:04:45.894176,Típica,El Mondongo y Mucho Mas,45800,5600,51400
5521,5522,21-10-2020 15:04:46.116397,Típica · Parrilla,La Parilla de David,8900,3100,12000
5522,5523,21-10-2020 15:04:46.338080,Hamburguesas · Panadería,NYC Burgers,35000,6200,41200
5523,5524,21-10-2020 15:04:46.560260,Saludable,Hanai - Bowls Saludables,29500,5900,35400
5524,5525,21-10-2020 15:04:46.732451,Comida Rápida,Fiesta Digital Andrés,24200,3100,27300
5525,5526,21-10-2020 15:04:46.854659,Pizza · Italiana,Pisapore - Pizza,70000,6600,76600
5526,5527,21-10-2020 15:04:47.026497,Perros Calientes,Dog Shop - Rapida,35000,4900,39900
5527,5528,21-10-2020 15:04:47.399079,Postres · Desayunos,Maria Luisa - Postres,24200,4300,28500
5528,5529,21-10-2020 15:04:47.721412,Pollo · Desayunos,Piaf,70000,6500,76500
5529,5530,21-10-2020 15:04:47.943591,Pizza · Parrilla,Urban Lunch,39700,4000,43700
5530,5531,21-10-2020 15:04:48.165570,Típica · Parrilla,Typykos,23000,6000,29000
5531,5532,21-10-2020 15:04:48.287400,Crepes,La Chabatta,34500,5900,40400
5532,5533,21-10-2020 15:04:48.509209,Desayunos · Típica,Papadió - Colombianas,35000,5700,40700
5533,5534,21-10-2020 15:04:48.681562,China,China Food Col,34500,3600,38100
5534,5535,21-10-2020 15:04:49.003272,Pollo,Heart & Cooking,37900,5000,42900
5535,5536,21-10-2020 15:04:49.225530,Pollo · Desayunos,Candelina,70000,5300,75300
5536,5537,21-10-2020 15:04:49.447386,Típica,Sabores De Mi Tierra,39700,5400,45100
5537,5538,21-10-2020 15:04:49.619610,Típica,Sabrosito,53900,4000,57900
5538,5539,21-10-2020 15:04:49.791411,Desayunos · Jugos y Batidos,Frutiwow,7500,4100,11600
5539,5540,21-10-2020 15:04:50.165073,Parrilla,Arepaisa de Medellín,13000,5600,18600
5540,5541,21-10-2020 15:04:50.387709,Pizza,pizza andante,53900,4200,58100
5541,5542,21-10-2020 15:04:50.710198,Típica · Pescados y Mariscos,La Vitualla,24300,6300,30600
5542,5543,21-10-2020 15:04:50.881915,Pizza,Pastas Laurentina,11870,4800,16670
5543,5544,21-10-2020 15:04:51.204368,Desayunos,Cafetería el Kippe,24300,3200,27500
5544,5545,21-10-2020 15:04:51.576889,Jugos y Batidos,Pomponio,10700,3600,14300
5545,5546,21-10-2020 15:04:51.899234,Hamburguesas,Gofi Burger,8900,5100,14000
5546,5547,21-10-2020 15:04:52.121375,Saludable · Desayunos,La Estampilla,34500,6000,40500
5547,5548,21-10-2020 15:04:52.343341,Postres · Desayunos,Sharmus,53400,6100,59500
5548,5549,21-10-2020 15:04:52.464742,Postres · Desayunos,Maltihelado,39700,4500,44200
5549,5550,21-10-2020 15:04:52.737179,Mexicana,Hidalgo Taquería,23000,4900,27900
5550,5551,21-10-2020 15:04:53.008895,Desayunos · Típica,D´Porco,27800,3900,31700
5551,5552,21-10-2020 15:04:53.381885,Desayunos · Panadería,Premium Break Bakery,37900,3700,41600
5552,5553,21-10-2020 15:04:53.503947,Postres · Desayunos,BagBog Bagels,29500,6400,35900
5553,5554,21-10-2020 15:04:53.626444,Desayunos · Árabe,Boniato Sabores Vivos,34500,5300,39800
5554,5555,21-10-2020 15:04:53.748092,Sushi · Asiática,Arigato,24200,5300,29500
5555,5556,21-10-2020 15:04:54.120618,Italiana,Bocatto Di Passo,53400,5000,58400
5556,5557,21-10-2020 15:04:54.342467,Desayunos,El Corral - Desayunos,24200,5000,29200
5557,5558,21-10-2020 15:04:54.514656,Pescados y Mariscos,Fish Place - Del Mar,27800,5400,33200
5558,5559,21-10-2020 15:04:54.736622,Desayunos · Panadería,Ficchi Panadería,13000,3100,16100
5559,5560,21-10-2020 15:04:55.059052,Pollo · Desayunos,Workzone,45800,3100,48900
5560,5561,21-10-2020 15:04:55.181813,Típica · Pescados y Mariscos,Arroces Mrg,65000,4300,69300
5561,5562,21-10-2020 15:04:55.504219,Postres · Panadería,RIGHT AWAY FOODS,29500,6600,36100
5562,5563,21-10-2020 15:04:55.776091,Pollo · Desayunos,Candelina,23000,5300,28300
5563,5564,21-10-2020 15:04:56.048416,Desayunos,Sunny Breakfast Brunch,12500,4300,16800
5564,5565,21-10-2020 15:04:56.270208,Saludable,The Good Rice Bowls,10700,3500,14200
5565,5566,21-10-2020 15:04:56.492462,Pollo · China,China Tao,24300,3500,27800
5566,5567,21-10-2020 15:04:56.764327,Postres · Desayunos,Maltihelados,27800,6200,34000
5567,5568,21-10-2020 15:04:56.936364,Mexicana,Mexicanachos,8900,3900,12800
5568,5569,21-10-2020 15:04:57.208391,Sánduches · Pescados y Mariscos,Pacific Comida de Mar,12500,4000,16500
5569,5570,21-10-2020 15:04:57.481115,Saludable · Desayunos,Maracuyá,27800,6700,34500
5570,5571,21-10-2020 15:04:57.702639,Postres · Desayunos,Café Quindio,24300,5700,30000
5571,5572,21-10-2020 15:04:58.024756,Desayunos · Panadería,Decofruta,11870,4700,16570
5572,5573,21-10-2020 15:04:58.246713,Hamburguesas,Gofi Burger,10700,5100,15800
5573,5574,21-10-2020 15:04:58.369217,Parrilla,Beraca Parrilla Bbq,10700,5600,16300
5574,5575,21-10-2020 15:04:58.491310,Desayunos · Panadería,Premium Break Bakery,37900,3700,41600
5575,5576,21-10-2020 15:04:58.613908,Asiática,TeT,9000,5900,14900
5576,5577,21-10-2020 15:04:58.986153,Saludable · Desayunos,Bon Eat - Saludable,13600,4800,18400
5577,5578,21-10-2020 15:04:59.308665,Saludable · Típica,Sopas Mrg,15000,3100,18100
5578,5579,21-10-2020 15:04:59.530681,Desayunos · Típica,Casa Vieja,7500,6000,13500
5579,5580,21-10-2020 15:04:59.653162,Parrilla,Beraca Parrilla Bbq,15600,5600,21200
5580,5581,21-10-2020 15:04:59.875011,Desayunos,Jacinta Arepas de Huevo,15000,4000,19000
5581,5582,21-10-2020 15:05:00.047272,Saludable · Desayunos,Maracuyá,65000,6700,71700
5582,5583,21-10-2020 15:05:00.270119,Sushi,Umi,24200,5600,29800
5583,5584,21-10-2020 15:05:00.442620,Típica,El Cucharón - Tipica,53400,4400,57800
5584,5585,21-10-2020 15:05:00.564741,Típica · Pescados y Mariscos,Arroces Mrg,8900,4300,13200
5585,5586,21-10-2020 15:05:00.937428,Desayunos · Típica,D'Porco - Lechona,53900,6300,60200
5586,5587,21-10-2020 15:05:01.209703,Sushi,Canoa To Go,65000,5900,70900
5587,5588,21-10-2020 15:05:01.432154,Desayunos · Panadería,Choclofee,23000,4700,27700
5588,5589,21-10-2020 15:05:01.804141,Típica · Parrilla,Parrilla Farandula Gourmet,23000,5100,28100
5589,5590,21-10-2020 15:05:02.126896,Comida Rápida,Fiesta Digital Andrés,53400,3100,56500
5590,5591,21-10-2020 15:05:02.249056,Típica · Parrilla,Parrilla Farandula Gourmet,13600,5100,18700
5591,5592,21-10-2020 15:05:02.371159,Típica · Parrilla,Parrilla Farandula Gourmet,35000,5100,40100
5592,5593,21-10-2020 15:05:02.643440,Hamburguesas,Monchis - Hamburguesa,23000,4300,27300
5593,5594,21-10-2020 15:05:02.816247,Sushi,Canoa To Go,37900,5900,43800
5594,5595,21-10-2020 15:05:02.938200,Saludable,MIMA,65000,3700,68700
5595,5596,21-10-2020 15:05:03.110744,Saludable · Desayunos,La Cesta,15600,4700,20300
5596,5597,21-10-2020 15:05:03.382865,Perros Calientes,Dog Shop - Rapida,65000,4900,69900
5597,5598,21-10-2020 15:05:03.655479,Saludable · Desayunos,Libre de Culpa,17800,4000,21800
5598,5599,21-10-2020 15:05:03.877522,Saludable · Desayunos,Básico y elemental,34500,5000,39500
5599,5600,21-10-2020 15:05:04.000046,Sánduches · Pescados y Mariscos,Pacific Comida de Mar,10700,4000,14700
5600,5601,21-10-2020 15:05:04.122364,Hamburguesas,Bendito Cordero,53900,5800,59700
5601,5602,21-10-2020 15:05:04.395129,Pizza · Italiana,Piatto - Pizza,29500,6600,36100
5602,5603,21-10-2020 15:05:04.767415,Parrilla,Rústico Picadería,53400,3800,57200
5603,5604,21-10-2020 15:05:05.040235,Desayunos · Típica,Parrilla Farandula Típico,18900,5900,24800
5604,5605,21-10-2020 15:05:05.213394,Parrilla,Beraca Parrilla Bbq,12500,5600,18100
5605,5606,21-10-2020 15:05:05.337700,Parrilla,Beraca Parrilla Bbq,7500,5600,13100
5606,5607,21-10-2020 15:05:05.560383,Pollo · Saludable,Gratina,13000,4200,17200
5607,5608,21-10-2020 15:05:05.834124,Pollo,Heart & Cooking,18900,5000,23900
5608,5609,21-10-2020 15:05:06.056842,Parrilla,Rústico Picadería,35000,3800,38800
5609,5610,21-10-2020 15:05:06.280686,Poke,Poke Go,53400,4600,58000
5610,5611,21-10-2020 15:05:06.653975,Típica,Cabrito Santandereano,48750,6600,55350
5611,5612,21-10-2020 15:05:06.777214,Desayunos · Pescados y Mariscos,Luzí­a - Mediterranea,23000,5700,28700
5612,5613,21-10-2020 15:05:07.049820,Típica,Cazuelitas 93,35000,3900,38900
5613,5614,21-10-2020 15:05:07.423904,Pollo,Chicken House,31800,4200,36000
5614,5615,21-10-2020 15:05:07.797210,Perros Calientes,Dog Shop - Rapida,65000,4900,69900
5615,5616,21-10-2020 15:05:07.970517,Parrilla,Restaurante Bar Mi Ranchito,9000,5200,14200
5616,5617,21-10-2020 15:05:08.093959,Postres,Levelma,12500,6200,18700
5617,5618,21-10-2020 15:05:08.266501,Hamburguesas · Pescados y Mariscos,El Velero,70000,6500,76500
5618,5619,21-10-2020 15:05:08.439187,Parrilla,Restaurante Bar Mi Ranchito,65000,5200,70200
5619,5620,21-10-2020 15:05:08.811879,Crepes,San Crepes,9000,4900,13900
5620,5621,21-10-2020 15:05:08.984850,Postres · Desayunos,Restaurante Cornelia,9000,5500,14500
5621,5622,21-10-2020 15:05:09.157496,Sánduches · China,Peru Mix,23000,5900,28900
5622,5623,21-10-2020 15:05:09.531109,Desayunos · Panadería,Siena Café,70000,3700,73700
5623,5624,21-10-2020 15:05:09.903831,Típica,La Herencia,23000,5900,28900
5624,5625,21-10-2020 15:05:10.026818,Peruana,Uma Cantina Peruana,12500,3200,15700
5625,5626,21-10-2020 15:05:10.350077,Típica,Baondish,18900,5800,24700
5626,5627,21-10-2020 15:05:10.622103,Típica,Salsig,48750,5600,54350
5627,5628,21-10-2020 15:05:10.944323,Alta Cocina · Postres,La Pinta,70000,4500,74500
5628,5629,21-10-2020 15:05:11.316332,Postres · Saludable,Ana Rebana,8900,6300,15200
5629,5630,21-10-2020 15:05:11.588719,Típica · Pescados y Mariscos,La Vitualla,65000,6300,71300
5630,5631,21-10-2020 15:05:11.760403,Desayunos · Panadería,Santa Juana Food Bar,10700,5900,16600
5631,5632,21-10-2020 15:05:11.982813,Desayunos · Típica,Peninsula Calentados y Parrilla,23000,3400,26400
5632,5633,21-10-2020 15:05:12.354929,Parrilla,Beraca Parrilla Bbq,13600,5600,19200
5633,5634,21-10-2020 15:05:12.677335,Postres,La Tertulia,48750,3400,52150
5634,5635,21-10-2020 15:05:12.799167,Panadería,Boul,7500,3100,10600
5635,5636,21-10-2020 15:05:13.121810,Saludable,Puro Verde,70000,5700,75700
5636,5637,21-10-2020 15:05:13.293502,Saludable · Desayunos,Fresh Co,34500,5600,40100
5637,5638,21-10-2020 15:05:13.515975,Desayunos · Panadería,Choclofee,37900,4700,42600
5638,5639,21-10-2020 15:05:13.888223,Desayunos · Panadería,Siena Café,17800,3700,21500
5639,5640,21-10-2020 15:05:14.211167,Pollo · Saludable,Yerbabuena,31800,3900,35700
5640,5641,21-10-2020 15:05:14.333270,Hamburguesas,Gofi Burger,48750,5100,53850
5641,5642,21-10-2020 15:05:14.505886,Postres · Desayunos,Café Quindio,24200,5700,29900
5642,5643,21-10-2020 15:05:14.827980,Parrilla,Campocina,35000,4600,39600
5643,5644,21-10-2020 15:05:15.100554,Postres · Desayunos,Protein Bakes,24300,5900,30200
5644,5645,21-10-2020 15:05:15.423955,Café · Helados,Sofia heladería y café,35000,5800,40800
5645,5646,21-10-2020 15:05:15.646477,Postres · Saludable,Ana Rebana,11870,6300,18170
5646,5647,21-10-2020 15:05:15.918573,Sushi · Asiática,Arigato,35000,5300,40300
5647,5648,21-10-2020 15:05:16.140594,Saludable · Desayunos,Malú,24300,3700,28000
5648,5649,21-10-2020 15:05:16.412648,Asiática,Thai Station,15600,6000,21600
5649,5650,21-10-2020 15:05:16.535066,Sushi · Asiática,Tu Sushi,8900,6400,15300
5650,5651,21-10-2020 15:05:16.707155,China,China Food Col,10700,3600,14300
5651,5652,21-10-2020 15:05:16.929857,Desayunos · Café,Norma's Ice Cream Café,18900,6300,25200
5652,5653,21-10-2020 15:05:17.302299,Típica · Parrilla,El Santandereano,12500,5200,17700
5653,5654,21-10-2020 15:05:17.574884,Desayunos · Pescados y Mariscos,Gypsy Bistro,70000,4500,74500
5654,5655,21-10-2020 15:05:17.696449,Desayunos · Comida Rápida,La Veneca,24300,6300,30600
5655,5656,21-10-2020 15:05:18.069108,Típica · Pescados y Mariscos,La Vitualla,23000,6300,29300
5656,5657,21-10-2020 15:05:18.241224,Típica · Parrilla,Mi Ranchito Parrilla,7500,4400,11900
5657,5658,21-10-2020 15:05:18.413868,Postres · Desayunos,La Folie - Postres,53400,3300,56700
5658,5659,21-10-2020 15:05:18.786339,Típica,La Cocina,24300,4600,28900
5659,5660,21-10-2020 15:05:19.058760,Desayunos · Panadería,Artesanos,27800,4300,32100
5660,5661,21-10-2020 15:05:19.380939,Sánduches · Pescados y Mariscos,Pacific Comida de Mar,11870,4000,15870
5661,5662,21-10-2020 15:05:19.503169,Postres · Café,Celestino Café,18900,5900,24800
5662,5663,21-10-2020 15:05:19.675208,Postres · Desayunos,Vivalight Market.,7500,6500,14000
5663,5664,21-10-2020 15:05:19.897708,Desayunos · Árabe,Boniato Sabores Vivos,45800,5300,51100
5664,5665,21-10-2020 15:05:20.219976,Desayunos,Archies Desayunos,34500,3100,37600
5665,5666,21-10-2020 15:05:20.392505,Alta Cocina · Parrilla,Criterión,15600,6000,21600
5666,5667,21-10-2020 15:05:20.665346,Desayunos · Típica,Desayunadero de la 42,12500,5900,18400
5667,5668,21-10-2020 15:05:20.837905,Desayunos,Sr Buñuelo,37900,6400,44300
5668,5669,21-10-2020 15:05:21.059965,Típica,Cazuelitas 93,53400,3900,57300
5669,5670,21-10-2020 15:05:21.282411,Pizza,Pizza Andante,31800,6300,38100
5670,5671,21-10-2020 15:05:21.554415,Desayunos,Señor Desayuno,23000,6800,29800
5671,5672,21-10-2020 15:05:21.926847,Sushi · Asiática,Tu Sushi,53900,6400,60300
5672,5673,21-10-2020 15:05:22.148806,Desayunos,Don Leo,35000,6000,41000
5673,5674,21-10-2020 15:05:22.321310,Mexicana,Mexicanachos,48750,3900,52650
5674,5675,21-10-2020 15:05:22.643504,Típica,El Cucharón - Tipica,31800,4400,36200
5675,5676,21-10-2020 15:05:22.916185,Hamburguesas · Desayunos,El Inglés Gastro Pub,10700,6600,17300
5676,5677,21-10-2020 15:05:23.238630,Comida Rápida,Fiesta Digital Andrés,23000,3100,26100
5677,5678,21-10-2020 15:05:23.462519,Sushi · Asiática,Arigato,17800,5300,23100
5678,5679,21-10-2020 15:05:23.835033,Sushi,Canoa To Go,24200,5900,30100
5679,5680,21-10-2020 15:05:24.007434,China,China Food Col,45800,3600,49400
5680,5681,21-10-2020 15:05:24.129514,Desayunos · Panadería,Le Pain Quotidien,34500,3900,38400
5681,5682,21-10-2020 15:05:24.351719,Pollo · China,China Tao,24300,3500,27800
5682,5683,21-10-2020 15:05:24.673975,Saludable · Parrilla,The Angels Grill and Drinks,35000,6200,41200
5683,5684,21-10-2020 15:05:24.896236,Desayunos · Café,Matchacha,8900,5900,14800
5684,5685,21-10-2020 15:05:25.268599,Asiática,Thai Station,18900,6000,24900
5685,5686,21-10-2020 15:05:25.491328,Desayunos · Panadería,Siena Café,15000,3700,18700
5686,5687,21-10-2020 15:05:25.715168,Postres,La Galeta,15600,3000,18600
5687,5688,21-10-2020 15:05:25.837912,Saludable,Hanai - Bowls Saludables,9000,5900,14900
5688,5689,21-10-2020 15:05:26.160088,Saludable · Desayunos,Libre de Culpa,11870,4000,15870
5689,5690,21-10-2020 15:05:26.482634,Postres · Desayunos,Sweet Tale,27800,5800,33600
5690,5691,21-10-2020 15:05:26.854924,Desayunos · Típica,Fogón Sangileño,34500,5000,39500
5691,5692,21-10-2020 15:05:27.077587,Desayunos · Café,Matchacha,34500,5900,40400
5692,5693,21-10-2020 15:05:27.449938,Desayunos,Sr Buñuelo,9000,6400,15400
5693,5694,21-10-2020 15:05:27.572427,Desayunos · Panadería,Le Pain Quotidien,15000,3900,18900
5694,5695,21-10-2020 15:05:27.694377,Saludable · Parrilla,The Angels Grill and Drinks,15600,6200,21800
5695,5696,21-10-2020 15:05:28.066902,Parrilla,Arepaisa de Medellín,48750,5600,54350
5696,5697,21-10-2020 15:05:28.389362,Desayunos · Panadería,Premium Break Bakery,8900,3700,12600
5697,5698,21-10-2020 15:05:28.711546,Saludable · Desayunos,Agua Dulce,8900,3700,12600
5698,5699,21-10-2020 15:05:29.083913,Típica · Pescados y Mariscos,La Vitualla,12500,6300,18800
5699,5700,21-10-2020 15:05:29.306347,Desayunos · Empanadas,Mis Delicias,29500,3200,32700
5700,5701,21-10-2020 15:05:29.678350,Pollo,Heart & Cooking,13600,5000,18600
5701,5702,21-10-2020 15:05:29.851147,Desayunos · Comida Rápida,La Veneca,65000,6300,71300
5702,5703,21-10-2020 15:05:30.073474,Poke,Poke Go,12500,4600,17100
5703,5704,21-10-2020 15:05:30.245667,Postres · Desayunos,Sweet Tale,12500,5800,18300
5704,5705,21-10-2020 15:05:30.617955,Desayunos · Panadería,El Pan de Phillippe,15000,4600,19600
5705,5706,21-10-2020 15:05:30.891613,Desayunos · Panadería,Premium Break Bakery,12500,3700,16200
5706,5707,21-10-2020 15:05:31.163976,Postres,Beiked,34500,4000,38500
5707,5708,21-10-2020 15:05:31.336379,Típica,Juan Chorizo,13000,3900,16900
5708,5709,21-10-2020 15:05:31.458608,Postres · Desayunos,Cosmo Cookies,35000,5900,40900
5709,5710,21-10-2020 15:05:31.731349,Saludable,Puro Verde,13000,5700,18700
5710,5711,21-10-2020 15:05:32.003848,Saludable,Ventura Soup y Salad,39700,3800,43500
5711,5712,21-10-2020 15:05:32.226734,Postres,La Galeta,17800,3000,20800
5712,5713,21-10-2020 15:05:32.399172,Desayunos · Café,Aromacafé el Placer de Compartir,13600,5000,18600
5713,5714,21-10-2020 15:05:32.521581,Desayunos · Café,Matchacha,18900,5900,24800
5714,5715,21-10-2020 15:05:32.693817,Alta Cocina · Postres,La Pinta,27800,4500,32300
5715,5716,21-10-2020 15:05:32.866312,Desayunos · Café,Frambas,18900,3400,22300
5716,5717,21-10-2020 15:05:33.138699,Pizza · Parrilla,Urban Lunch,35000,4000,39000
5717,5718,21-10-2020 15:05:33.511428,Típica · Parrilla,La Parilla de David,24200,3100,27300
5718,5719,21-10-2020 15:05:33.833938,Desayunos,Butter,31800,6700,38500
5719,5720,21-10-2020 15:05:33.956477,Pollo · Desayunos,Workzone,35000,3100,38100
5720,5721,21-10-2020 15:05:34.229065,Saludable · Desayunos,La Estampilla,12500,6000,18500
5721,5722,21-10-2020 15:05:34.451740,Pollo · Desayunos,Workzone,65000,3100,68100
5722,5723,21-10-2020 15:05:34.774218,Pizza,Pizza Andante,23000,6300,29300
5723,5724,21-10-2020 15:05:34.946855,Saludable · Desayunos,La Estampilla,23000,6000,29000
5724,5725,21-10-2020 15:05:35.169397,Típica,El Mondongo y Mucho Mas,29500,5600,35100
5725,5726,21-10-2020 15:05:35.341873,Típica,Sabrosito,15000,4000,19000
5726,5727,21-10-2020 15:05:35.464134,Postres · Desayunos,KOKOA & co.,23000,4700,27700
5727,5728,21-10-2020 15:05:35.786837,Desayunos · Panadería,Pasteleite,27800,5900,33700
5728,5729,21-10-2020 15:05:36.159163,Desayunos,El Fogón Castellano,31800,3200,35000
5729,5730,21-10-2020 15:05:36.281701,Mexicana,Mexicanachos,53400,3900,57300
5730,5731,21-10-2020 15:05:36.403680,Perros Calientes,Dog Shop - Rapida,34500,4900,39400
5731,5732,21-10-2020 15:05:36.776568,Desayunos,La Frijolada Desayunos,11870,4400,16270
5732,5733,21-10-2020 15:05:36.999007,Desayunos · Panadería,Choclofee,45800,4700,50500
5733,5734,21-10-2020 15:05:37.171837,Desayunos · Panadería,Le Pain Quotidien,37900,3900,41800
5734,5735,21-10-2020 15:05:37.544370,Típica · Pescados y Mariscos,La Vitualla,17800,6300,24100
5735,5736,21-10-2020 15:05:37.816759,Desayunos · Café,vereda central calle 99,12500,5700,18200
5736,5737,21-10-2020 15:05:37.988645,Desayunos · Típica,D'Porco - Lechona,13600,6300,19900
5737,5738,21-10-2020 15:05:38.361232,Desayunos · Mexicana,La Mera Mera - Mexicana,70000,3100,73100
5738,5739,21-10-2020 15:05:38.583531,Postres · Desayunos,Maltihelados,24300,6200,30500
5739,5740,21-10-2020 15:05:38.957437,Saludable · Desayunos,Guadalupe - Fruteria,23000,5900,28900
5740,5741,21-10-2020 15:05:39.279931,Helados,Buon Gelato,13000,4400,17400
5741,5742,21-10-2020 15:05:39.602598,Crepes,La Chabatta,24300,5900,30200
5742,5743,21-10-2020 15:05:39.774873,Desayunos · Café,Libertario Coffee Roasters,18900,4600,23500
5743,5744,21-10-2020 15:05:39.947602,Desayunos · Comida Rápida,La Veneca,13600,6300,19900
5744,5745,21-10-2020 15:05:40.070040,Desayunos · Panadería,Artesanos,15600,4300,19900
5745,5746,21-10-2020 15:05:40.292959,Alta Cocina · Parrilla,Criterión,27800,6000,33800
5746,5747,21-10-2020 15:05:40.615553,Poke,Poke Go,65000,4600,69600
5747,5748,21-10-2020 15:05:40.738183,Postres · Desayunos,Café Quindio,45800,5700,51500
5748,5749,21-10-2020 15:05:41.010463,Desayunos · Panadería,Pasteleite,24300,5900,30200
5749,5750,21-10-2020 15:05:41.284471,Típica · Pescados y Mariscos,La Vitualla,70000,6300,76300
5750,5751,21-10-2020 15:05:41.556790,Desayunos · Café,El Gualilo,10700,6200,16900
5751,5752,21-10-2020 15:05:41.879550,Saludable · Parrilla,The Angels Grill and Drinks,35000,6200,41200
5752,5753,21-10-2020 15:05:42.252163,Saludable · Desayunos,Distrito Gourmet,31800,3700,35500
5753,5754,21-10-2020 15:05:42.524972,Pizza,18 Scalini,17800,4300,22100
5754,5755,21-10-2020 15:05:42.647199,Parrilla · Café,Gaira Café,34500,4400,38900
5755,5756,21-10-2020 15:05:42.970148,Típica,Bendita S,31800,4600,36400
5756,5757,21-10-2020 15:05:43.342639,Desayunos · Sánduches,Frutos del Bosque,15000,3500,18500
5757,5758,21-10-2020 15:05:43.665342,Desayunos · Café,Libertario Coffee Roasters,31800,4600,36400
5758,5759,21-10-2020 15:05:43.937214,Sushi · Asiática,Arigato,11870,5300,17170
5759,5760,21-10-2020 15:05:44.109813,Internacional,La Esquina con Sabor Parrilla,53400,3000,56400
5760,5761,21-10-2020 15:05:44.482120,Postres,Toledo Pastelería,15000,6800,21800
5761,5762,21-10-2020 15:05:44.854493,Desayunos · Café,Norma's Ice Cream Café,35000,6300,41300
5762,5763,21-10-2020 15:05:45.126772,Pollo · Pescados y Mariscos,Bang Bang Rice,29500,3400,32900
5763,5764,21-10-2020 15:05:45.499186,Saludable · Desayunos,La Cesta,29500,4700,34200
5764,5765,21-10-2020 15:05:45.671179,Helados,Buon Gelato,29500,4400,33900
5765,5766,21-10-2020 15:05:45.943590,Típica · Parrilla,Typykos,9000,6000,15000
5766,5767,21-10-2020 15:05:46.317220,Desayunos · Mexicana,La Mera Mera - Mexicana,24300,3100,27400
5767,5768,21-10-2020 15:05:46.539666,Desayunos · Panadería,Ficchi Panadería,35000,3100,38100
5768,5769,21-10-2020 15:05:46.912037,Desayunos,Archies Desayunos,23000,3100,26100
5769,5770,21-10-2020 15:05:47.285387,Parrilla · Café,Gaira Café,8900,4400,13300
5770,5771,21-10-2020 15:05:47.407505,Parrilla,Restaurante Bar Mi Ranchito,15000,5200,20200
5771,5772,21-10-2020 15:05:47.780515,Parrilla,Arepaisa de Medellín,23000,5600,28600
5772,5773,21-10-2020 15:05:48.103046,Peruana,Uma Cantina Peruana,35000,3200,38200
5773,5774,21-10-2020 15:05:48.325990,Desayunos · Típica,Papadió - Colombianas,11870,5700,17570
5774,5775,21-10-2020 15:05:48.598436,Desayunos · Panadería,Choclofee,35000,4700,39700
5775,5776,21-10-2020 15:05:48.971342,Desayunos · Típica,Criollomania,34500,5200,39700
5776,5777,21-10-2020 15:05:49.243652,Desayunos · Típica,D'Porco - Lechona,31800,6300,38100
5777,5778,21-10-2020 15:05:49.416285,Saludable · Desayunos,Básico y elemental,45800,5000,50800
5778,5779,21-10-2020 15:05:49.588283,Desayunos · Típica,Parrilla Farandula Típico,15600,5900,21500
5779,5780,21-10-2020 15:05:49.911052,Pollo,Oliva Va,23000,5600,28600
5780,5781,21-10-2020 15:05:50.233452,Mexicana,Mexicanachos,65000,3900,68900
5781,5782,21-10-2020 15:05:50.556586,Postres · Helados,Mahé,34500,6000,40500
5782,5783,21-10-2020 15:05:50.729513,Pescados y Mariscos,Fish Place - Del Mar,24200,5400,29600
5783,5784,21-10-2020 15:05:51.102468,Típica,La Olla de Barro,24300,5300,29600
5784,5785,21-10-2020 15:05:51.274937,Mexicana,Mexicanachos,53900,3900,57800
5785,5786,21-10-2020 15:05:51.549244,Postres · Desayunos,Protein Bakes,27800,5900,33700
5786,5787,21-10-2020 15:05:51.922062,Hamburguesas · Desayunos,El Inglés Gastro Pub,65000,6600,71600
5787,5788,21-10-2020 15:05:52.044746,Sushi,Umi,35000,5600,40600
5788,5789,21-10-2020 15:05:52.367133,Parrilla,Parrilla Pimentón,35000,3400,38400
5789,5790,21-10-2020 15:05:52.640110,Típica,Cazuelitas 93,35000,3900,38900
5790,5791,21-10-2020 15:05:53.012906,Desayunos · Panadería,Premium Break Bakery,34500,3700,38200
5791,5792,21-10-2020 15:05:53.185840,Poke,Poke Go,70000,4600,74600
5792,5793,21-10-2020 15:05:53.308120,Desayunos · Helados,San Giorgio Gelateria,48750,3100,51850
5793,5794,21-10-2020 15:05:53.580921,Típica · Parrilla,Typykos,10700,6000,16700
5794,5795,21-10-2020 15:05:53.703486,Alta Cocina · Italiana,Trattoria de la Plaza,15000,6000,21000
5795,5796,21-10-2020 15:05:54.076490,Desayunos · Panadería,Siena Café,29500,3700,33200
5796,5797,21-10-2020 15:05:54.249072,Pizza,18 Scalini,65000,4300,69300
5797,5798,21-10-2020 15:05:54.371770,Desayunos · Jugos y Batidos,Kuriwaji,15000,6300,21300
5798,5799,21-10-2020 15:05:54.644715,Alta Cocina · Postres,La Pinta,13600,4500,18100
5799,5800,21-10-2020 15:05:54.967850,Parrilla · Café,Gaira Café,24300,4400,28700
5800,5801,21-10-2020 15:05:55.240685,Típica · Parrilla,El Santandereano,53900,5200,59100
5801,5802,21-10-2020 15:05:55.514152,Saludable · Desayunos,Copacabana Açai Bowls,13600,3000,16600
5802,5803,21-10-2020 15:05:55.786893,Desayunos · Café,Frambas,24200,3400,27600
5803,5804,21-10-2020 15:05:55.909560,Asiática,Thai Station,23000,6000,29000
5804,5805,21-10-2020 15:05:56.132209,Típica,Sopitas y Más,53400,4200,57600
5805,5806,21-10-2020 15:05:56.354865,Saludable · Típica,Saludable Mrg,7500,5800,13300
5806,5807,21-10-2020 15:05:56.477102,Desayunos,Sr Buñuelo,34500,6400,40900
5807,5808,21-10-2020 15:05:56.750786,Postres · Café,Loló Coffee & Snacks,39700,4600,44300
5808,5809,21-10-2020 15:05:57.023112,Comida Rápida,Fiesta Digital Andrés,10700,3100,13800
5809,5810,21-10-2020 15:05:57.396137,Pollo,Oliva Va,23000,5600,28600
5810,5811,21-10-2020 15:05:57.618513,Postres · Desayunos,Protein Bakes,45800,5900,51700
5811,5812,21-10-2020 15:05:57.941337,Mexicana,Mexicanachos,35000,3900,38900
5812,5813,21-10-2020 15:05:58.063859,Postres · Saludable,Ana Rebana,9000,6300,15300
5813,5814,21-10-2020 15:05:58.186558,Alta Cocina · Parrilla,Criterión,17800,6000,23800
5814,5815,21-10-2020 15:05:58.559219,Comida Rápida · Perros Calientes,Similoa - Comida Rapida,12500,3700,16200
5815,5816,21-10-2020 15:05:58.682282,Alta Cocina · Postres,La Pinta,29500,4500,34000
5816,5817,21-10-2020 15:05:59.005030,Postres · Desayunos,La Folie - Postres,23000,3300,26300
5817,5818,21-10-2020 15:05:59.378077,Poke,Poke Go,70000,4600,74600
5818,5819,21-10-2020 15:05:59.550404,Desayunos · Sánduches,Danilo Colombia,48750,3300,52050
5819,5820,21-10-2020 15:05:59.823108,Desayunos · Panadería,Limarys,65000,6500,71500
5820,5821,21-10-2020 15:05:59.945572,Desayunos · Café,Norma's Ice Cream Café,18900,6300,25200
5821,5822,21-10-2020 15:06:00.118352,Desayunos · Árabe,Boniato Sabores Vivos,13000,5300,18300
5822,5823,21-10-2020 15:06:00.240971,Hamburguesas · Saludable,Restaurant Inn,12500,6100,18600
5823,5824,21-10-2020 15:06:00.464039,Postres · Desayunos,Aury Postres - Comidas & Picadas,23000,4700,27700
5824,5825,21-10-2020 15:06:00.736786,Pollo · Desayunos,Candelina,7500,5300,12800
5825,5826,21-10-2020 15:06:01.059880,Postres · Desayunos,Maltihelado,7500,4500,12000
5826,5827,21-10-2020 15:06:01.432530,Saludable · Desayunos,Bawana - Sandwich,70000,3400,73400
5827,5828,21-10-2020 15:06:01.806582,Desayunos,Don Leo,65000,6000,71000
5828,5829,21-10-2020 15:06:02.129725,Parrilla,Coquitas,12500,5600,18100
5829,5830,21-10-2020 15:06:02.502864,Parrilla,Coquitas,29500,5600,35100
5830,5831,21-10-2020 15:06:02.625254,Pollo · Sánduches,Pollos Century,48750,3000,51750
5831,5832,21-10-2020 15:06:02.898226,Saludable · Jugos y Batidos,Berdes Drinks & Salads,23000,3500,26500
5832,5833,21-10-2020 15:06:03.271124,Desayunos · Helados,San Giorgio Gelateria,13000,3100,16100
5833,5834,21-10-2020 15:06:03.644072,Saludable · Jugos y Batidos,Berdes Drinks & Salads,8900,3500,12400
5834,5835,21-10-2020 15:06:03.816380,Hamburguesas,Burger Society,35000,4100,39100
5835,5836,21-10-2020 15:06:03.989195,Mexicana,Cantina La 15,12500,4300,16800
5836,5837,21-10-2020 15:06:04.111691,Típica,La Herencia,53900,5900,59800
5837,5838,21-10-2020 15:06:04.284420,Café · Helados,Sofia heladería y café,45800,5800,51600
5838,5839,21-10-2020 15:06:04.506957,Típica · Parrilla,Toya,70000,4200,74200
5839,5840,21-10-2020 15:06:04.880071,Parrilla · Café,Gaira Café,35000,4400,39400
5840,5841,21-10-2020 15:06:05.252658,Sushi,Sushi Reel,27800,4700,32500
5841,5842,21-10-2020 15:06:05.575406,Postres · Panadería,RIGHT AWAY FOODS,37900,6600,44500
5842,5843,21-10-2020 15:06:05.897863,Sánduches · Pescados y Mariscos,Pacific Comida de Mar,11870,4000,15870
5843,5844,21-10-2020 15:06:06.020679,Hamburguesas · Alitas,Beer,13600,6600,20200
5844,5845,21-10-2020 15:06:06.192863,Pollo,Heart & Cooking,15600,5000,20600
5845,5846,21-10-2020 15:06:06.365726,Desayunos · Típica,Peninsula Calentados y Parrilla,12500,3400,15900
5846,5847,21-10-2020 15:06:06.538425,Mexicana,La leyenda mexican kitchen,45800,3200,49000
5847,5848,21-10-2020 15:06:06.761576,Desayunos · Típica,Criollomania,31800,5200,37000
5848,5849,21-10-2020 15:06:06.985359,Típica,Sabores De Mi Tierra,24200,5400,29600
5849,5850,21-10-2020 15:06:07.358366,Hamburguesas · Alitas,Beer,10700,6600,17300
5850,5851,21-10-2020 15:06:07.531048,Pollo · Desayunos,Abasto,12500,3600,16100
5851,5852,21-10-2020 15:06:07.654055,Parrilla,Parrilla Pimentón,53400,3400,56800
5852,5853,21-10-2020 15:06:07.926682,Desayunos · Panadería,Le Pain Quotidien,31800,3900,35700
5853,5854,21-10-2020 15:06:08.250052,Sushi · Asiática,Tu Sushi,35000,6400,41400
5854,5855,21-10-2020 15:06:08.522915,Desayunos,Desayunos en Bogotá,15600,3400,19000
5855,5856,21-10-2020 15:06:08.646036,Parrilla · Internacional,Taperia de la Plaza,65000,5700,70700
5856,5857,21-10-2020 15:06:08.968793,Peruana · Internacional,La Chifería,31800,6600,38400
5857,5858,21-10-2020 15:06:09.241613,Saludable · Desayunos,Copacabana Açai Bowls,17800,3000,20800
5858,5859,21-10-2020 15:06:09.413924,Parrilla,OAK Ahumado y Brebajes,34500,6000,40500
5859,5860,21-10-2020 15:06:09.786927,Parrilla · Café,Gaira Café,24300,4400,28700
5860,5861,21-10-2020 15:06:09.959094,Sushi · Desayunos,Maki Roll,45800,4300,50100
5861,5862,21-10-2020 15:06:10.081880,Pollo · Pescados y Mariscos,Bang Bang Rice,23000,3400,26400
5862,5863,21-10-2020 15:06:10.254465,Sushi,Sushi Reel,65000,4700,69700
5863,5864,21-10-2020 15:06:10.377489,Desayunos · Italiana,Rceta By Rausch,65000,3600,68600
5864,5865,21-10-2020 15:06:10.700282,Desayunos · Italiana,Rceta By Rausch,70000,3600,73600
5865,5866,21-10-2020 15:06:10.973460,Postres · Desayunos,La Folie - Postres,23000,3300,26300
5866,5867,21-10-2020 15:06:11.096044,Postres · Desayunos,Sharmus,15600,6100,21700
5867,5868,21-10-2020 15:06:11.369221,Pollo · Sánduches,Pollos Century,53400,3000,56400
5868,5869,21-10-2020 15:06:11.692071,Saludable · Desayunos,Libre de Culpa,29500,4000,33500
5869,5870,21-10-2020 15:06:11.965270,Típica,Bandejas Mrg,35000,3800,38800
5870,5871,21-10-2020 15:06:12.190108,Desayunos · Panadería,Le Pain Quotidien,45800,3900,49700
5871,5872,21-10-2020 15:06:12.413342,Postres · Desayunos,Aury Postres - Comidas & Picadas,53900,4700,58600
5872,5873,21-10-2020 15:06:12.535634,Saludable,MIMA,24200,3700,27900
5873,5874,21-10-2020 15:06:12.808712,Desayunos · Café,Libertario Coffee Roasters,65000,4600,69600
5874,5875,21-10-2020 15:06:12.981342,Pollo · Desayunos,Abasto,15600,3600,19200
5875,5876,21-10-2020 15:06:13.154438,Saludable · Desayunos,Bon Eat - Saludable,7500,4800,12300
5876,5877,21-10-2020 15:06:13.327380,Pescados y Mariscos,Pescadero Héroes del Mar,65000,6600,71600
5877,5878,21-10-2020 15:06:13.501168,Saludable,A2manos,35000,4200,39200
5878,5879,21-10-2020 15:06:13.874699,Pollo · Desayunos,Caserito Gourmet,35000,6700,41700
5879,5880,21-10-2020 15:06:14.097653,Desayunos · Panadería,Premium Break Bakery,8900,3700,12600
5880,5881,21-10-2020 15:06:14.420085,Pollo,Señor Fantástico,24300,4700,29000
5881,5882,21-10-2020 15:06:14.692919,Desayunos,Fratelli - Desayunos,45800,4600,50400
5882,5883,21-10-2020 15:06:14.915479,Pizza,Pastas Laurentina,48750,4800,53550
5883,5884,21-10-2020 15:06:15.088333,Hamburguesas · Saludable,Restaurant Inn,11870,6100,17970
5884,5885,21-10-2020 15:06:15.411260,Desayunos · Comida Rápida,Chocolatto,70000,3400,73400
5885,5886,21-10-2020 15:06:15.534015,Sushi · Asiática,Tu Sushi,29500,6400,35900
5886,5887,21-10-2020 15:06:15.656366,Postres · Desayunos,Sweet Tale,10700,5800,16500
5887,5888,21-10-2020 15:06:15.929489,Desayunos · Panadería,Ficchi Panadería,13000,3100,16100
5888,5889,21-10-2020 15:06:16.252305,Desayunos · Café,Aromacafé el Placer de Compartir,8900,5000,13900
5889,5890,21-10-2020 15:06:16.375883,Pollo,Heart & Cooking,8900,5000,13900
5890,5891,21-10-2020 15:06:16.599071,Desayunos · Panadería,Pasteleite,23000,5900,28900
5891,5892,21-10-2020 15:06:16.722196,Saludable · Desayunos,Re.al Alimentos Reales,8900,4000,12900
5892,5893,21-10-2020 15:06:17.095094,Pollo · Desayunos,Abasto,9000,3600,12600
5893,5894,21-10-2020 15:06:17.319400,Desayunos · Típica,Fogón Sangileño,15600,5000,20600
5894,5895,21-10-2020 15:06:17.642332,Postres · Desayunos,Maria Luisa - Postres,27800,4300,32100
5895,5896,21-10-2020 15:06:17.765457,Postres · Desayunos,Restaurante Cornelia,48750,5500,54250
5896,5897,21-10-2020 15:06:18.037852,Típica · Parrilla,Parrilla Farandula Gourmet,65000,5100,70100
5897,5898,21-10-2020 15:06:18.211020,Saludable · Desayunos,Raices Bienestar Gourmet,70000,6600,76600
5898,5899,21-10-2020 15:06:18.533909,Desayunos · Sánduches,Danilo Colombia,53900,3300,57200
5899,5900,21-10-2020 15:06:18.756833,Pollo,Oliva Va,23000,5600,28600
5900,5901,21-10-2020 15:06:18.980066,Hamburguesas,Burger Society,35000,4100,39100
5901,5902,21-10-2020 15:06:19.303851,Desayunos,Sr Buñuelo,35000,6400,41400
5902,5903,21-10-2020 15:06:19.677559,Desayunos,Butter,37900,6700,44600
5903,5904,21-10-2020 15:06:19.800749,Desayunos · Típica,90 Calentados,24300,3700,28000
5904,5905,21-10-2020 15:06:20.173843,Saludable · Desayunos,Maracuyá,65000,6700,71700
5905,5906,21-10-2020 15:06:20.346952,Postres · Desayunos,Restaurante Cornelia,35000,5500,40500
5906,5907,21-10-2020 15:06:20.620028,Pollo · Saludable,Gratina,34500,4200,38700
5907,5908,21-10-2020 15:06:20.743477,Típica,Salsig,11870,5600,17470
5908,5909,21-10-2020 15:06:20.966079,Sánduches · China,Peru Mix,9000,5900,14900
5909,5910,21-10-2020 15:06:21.088867,Parrilla,Coquitas,8900,5600,14500
5910,5911,21-10-2020 15:06:21.311696,Típica,Bandejas Mrg,24200,3800,28000
5911,5912,21-10-2020 15:06:21.635095,Peruana,Uma Cantina Peruana,70000,3200,73200
5912,5913,21-10-2020 15:06:21.957717,Pollo · Desayunos,Caserito Gourmet,7500,6700,14200
5913,5914,21-10-2020 15:06:22.281432,Parrilla,Arepaisa de Medellín,15000,5600,20600
5914,5915,21-10-2020 15:06:22.605763,Pizza,Pastas Laurentina,37900,4800,42700
5915,5916,21-10-2020 15:06:22.828750,Pollo · Saludable,Tremenda Sal y Dulce,27800,6500,34300
5916,5917,21-10-2020 15:06:23.101864,Parrilla,El Tambor,29500,6800,36300
5917,5918,21-10-2020 15:06:23.424941,Asiática,Thai Station,39700,6000,45700
5918,5919,21-10-2020 15:06:23.747837,Desayunos,Butter,13000,6700,19700
5919,5920,21-10-2020 15:06:24.071215,Desayunos · Típica,Peninsula Calentados y Parrilla,15600,3400,19000
5920,5921,21-10-2020 15:06:24.343710,Parrilla,Coquitas,35000,5600,40600
5921,5922,21-10-2020 15:06:24.566871,Desayunos,El Fogón Castellano,12500,3200,15700
5922,5923,21-10-2020 15:06:24.939934,Saludable · Desayunos,Agua Dulce,35000,3700,38700
5923,5924,21-10-2020 15:06:25.263168,Saludable · Desayunos,Libre de Culpa,53400,4000,57400
5924,5925,21-10-2020 15:06:25.485732,Peruana,Uma Cantina Peruana,35000,3200,38200
5925,5926,21-10-2020 15:06:25.658824,Desayunos,Sunny Breakfast Brunch,53900,4300,58200
5926,5927,21-10-2020 15:06:26.032097,Desayunos · Panadería,Artesanos,53400,4300,57700
5927,5928,21-10-2020 15:06:26.255411,Postres,La Tertulia,29500,3400,32900
5928,5929,21-10-2020 15:06:26.428304,Saludable · Típica,Sopas Mrg,48750,3100,51850
5929,5930,21-10-2020 15:06:26.601555,Desayunos · Jugos y Batidos,Dont Be Hungry,27800,5600,33400
5930,5931,21-10-2020 15:06:26.824536,Alta Cocina · Parrilla,Criterión,24300,6000,30300
5931,5932,21-10-2020 15:06:27.047822,Pollo · Desayunos,Abasto,11870,3600,15470
5932,5933,21-10-2020 15:06:27.170549,Postres · Desayunos,Cosmo Cookies,35000,5900,40900
5933,5934,21-10-2020 15:06:27.494061,Desayunos · Típica,Parrilla Farandula Típico,13000,5900,18900
5934,5935,21-10-2020 15:06:27.668009,Desayunos · Típica,Parrilla Farandula Típico,8900,5900,14800
5935,5936,21-10-2020 15:06:27.791099,Saludable · Desayunos,Re.al Alimentos Reales,15600,4000,19600
5936,5937,21-10-2020 15:06:27.913444,Saludable · Desayunos,Re.al Alimentos Reales,35000,4000,39000
5937,5938,21-10-2020 15:06:28.286966,Pizza,Pizza Andante,45800,6300,52100
5938,5939,21-10-2020 15:06:28.409711,Desayunos · Típica,Casa Vieja,39700,6000,45700
5939,5940,21-10-2020 15:06:28.532854,Saludable · Desayunos,Bawana - Sandwich,45800,3400,49200
5940,5941,21-10-2020 15:06:28.756034,Típica · Parrilla,La Parilla de David,17800,3100,20900
5941,5942,21-10-2020 15:06:28.879502,Pollo · Desayunos,Workzone,70000,3100,73100
5942,5943,21-10-2020 15:06:29.253726,Hamburguesas,Gofi Burger,48750,5100,53850
5943,5944,21-10-2020 15:06:29.627169,Italiana,F*cking Good Pizza,13000,4200,17200
5944,5945,21-10-2020 15:06:29.850452,Saludable · Desayunos,Guadalupe - Fruteria,13600,5900,19500
5945,5946,21-10-2020 15:06:30.224174,Hamburguesas · Saludable,Restaurant Inn,9000,6100,15100
5946,5947,21-10-2020 15:06:30.397240,Postres,Beiked,34500,4000,38500
5947,5948,21-10-2020 15:06:30.771057,Desayunos,El Fogón Castellano,37900,3200,41100
5948,5949,21-10-2020 15:06:30.894059,Pollo · Desayunos,Abasto,27800,3600,31400
5949,5950,21-10-2020 15:06:31.217475,Pizza · Italiana,Pisapore - Pizza,13000,6600,19600
5950,5951,21-10-2020 15:06:31.591124,Típica,Cabrito Santandereano,12500,6600,19100
5951,5952,21-10-2020 15:06:31.715224,Parrilla,Beraca Parrilla Bbq,35000,5600,40600
5952,5953,21-10-2020 15:06:32.089247,Saludable,MIMA,24300,3700,28000
5953,5954,21-10-2020 15:06:32.263595,Hamburguesas,Bendito Cordero,53400,5800,59200
5954,5955,21-10-2020 15:06:32.587691,Postres · Desayunos,Maltihelados,15600,6200,21800
5955,5956,21-10-2020 15:06:32.962495,Crepes,San Crepes,24300,4900,29200
5956,5957,21-10-2020 15:06:33.085514,Desayunos,Sr Buñuelo,12500,6400,18900
5957,5958,21-10-2020 15:06:33.459428,Postres · Desayunos,Maltihelados,37900,6200,44100
5958,5959,21-10-2020 15:06:33.782463,Postres · Desayunos,Sweet Tale,23000,5800,28800
5959,5960,21-10-2020 15:06:34.056092,Comida Rápida,Fiesta Digital Andrés,24300,3100,27400
5960,5961,21-10-2020 15:06:34.179102,Desayunos · Típica,Casa Vieja,70000,6000,76000
5961,5962,21-10-2020 15:06:34.452894,Desayunos · Café,Moramia,11870,4700,16570
5962,5963,21-10-2020 15:06:34.575649,Típica,Bandejas Mrg,37900,3800,41700
5963,5964,21-10-2020 15:06:34.849558,Postres,Levelma,31800,6200,38000
5964,5965,21-10-2020 15:06:35.172579,Típica,Sopitas y Más,15000,4200,19200
5965,5966,21-10-2020 15:06:35.496620,Hamburguesas,Gofi Burger,10700,5100,15800
5966,5967,21-10-2020 15:06:35.870110,Desayunos · Típica,Cochon,24200,3300,27500
5967,5968,21-10-2020 15:06:36.243489,Sushi · Asiática,Arigato,29500,5300,34800
5968,5969,21-10-2020 15:06:36.616691,Desayunos · Comida Rápida,Chocolatto,13000,3400,16400
5969,5970,21-10-2020 15:06:36.941348,Saludable,A2manos,39700,4200,43900
5970,5971,21-10-2020 15:06:37.164270,Desayunos,Don Leo,11870,6000,17870
5971,5972,21-10-2020 15:06:37.287351,Pollo · Saludable,Tremenda Sal y Dulce,29500,6500,36000
5972,5973,21-10-2020 15:06:37.510585,Hamburguesas · Desayunos,El Inglés Gastro Pub,31800,6600,38400
5973,5974,21-10-2020 15:06:37.683875,Saludable · Desayunos,Guadalupe - Fruteria,48750,5900,54650
5974,5975,21-10-2020 15:06:38.058076,Pizza,Pizza Andante,17800,6300,24100
5975,5976,21-10-2020 15:06:38.381804,Típica,Bandejas Mrg,24200,3800,28000
5976,5977,21-10-2020 15:06:38.504593,Desayunos · Típica,Criollomania,29500,5200,34700
5977,5978,21-10-2020 15:06:38.727832,Típica,Sopitas y Más,11870,4200,16070
5978,5979,21-10-2020 15:06:39.101590,Parrilla,Carnes la Zarza,35000,4900,39900
5979,5980,21-10-2020 15:06:39.375159,Desayunos · Típica,Papadió - Colombianas,13600,5700,19300
5980,5981,21-10-2020 15:06:39.598440,Desayunos · Típica,Desayunadero de la 42,15000,5900,20900
5981,5982,21-10-2020 15:06:39.772540,Desayunos · Jugos y Batidos,Frutiwow,53400,4100,57500
5982,5983,21-10-2020 15:06:40.096267,Saludable,Puro Verde,34500,5700,40200
5983,5984,21-10-2020 15:06:40.220039,Postres · Desayunos,Jacques Pastelería,15000,5900,20900
5984,5985,21-10-2020 15:06:40.443602,Desayunos · Típica,Criollomania,24200,5200,29400
5985,5986,21-10-2020 15:06:40.667200,Típica · Parrilla,El Portal de la Antigua,9000,5600,14600
5986,5987,21-10-2020 15:06:40.940823,Saludable,The Good Rice Bowls,24200,3500,27700
5987,5988,21-10-2020 15:06:41.314918,Desayunos,El Corral - Desayunos,24300,5000,29300
5988,5989,21-10-2020 15:06:41.487857,China,China Food Col,18900,3600,22500
5989,5990,21-10-2020 15:06:41.811848,Típica,Sopitas y Más,13600,4200,17800
5990,5991,21-10-2020 15:06:42.084892,Desayunos · Café,Libertario Coffee Roasters,11870,4600,16470
5991,5992,21-10-2020 15:06:42.308187,Parrilla,Beraca Parrilla Bbq,29500,5600,35100
5992,5993,21-10-2020 15:06:42.631255,Comida Rápida,Fiesta Digital Andrés,48750,3100,51850
5993,5994,21-10-2020 15:06:42.904687,Pescados y Mariscos,Pescadero Héroes del Mar,8900,6600,15500
5994,5995,21-10-2020 15:06:43.027653,Pollo · Desayunos,Caserito Gourmet,29500,6700,36200
5995,5996,21-10-2020 15:06:43.152053,Desayunos · Sánduches,Frutos del Bosque,29500,3500,33000
5996,5997,21-10-2020 15:06:43.475732,Típica,Campo Victoria,53400,3000,56400
5997,5998,21-10-2020 15:06:43.648924,Parrilla,Parrilla Pimentón,53900,3400,57300
5998,5999,21-10-2020 15:06:43.821741,Desayunos · Panadería,Pasteleite,35000,5900,40900
5999,6000,21-10-2020 15:06:44.095382,Pollo · Desayunos,Piaf,15600,6500,22100
6000,6001,21-10-2020 15:06:44.318867,Desayunos,Archies Desayunos,45800,3100,48900
6001,6002,21-10-2020 15:06:44.592458,Saludable · Desayunos,Guadalupe - Fruteria,23000,5900,28900
6002,6003,21-10-2020 15:06:44.765339,Parrilla,Parrilla Pimentón,70000,3400,73400
6003,6004,21-10-2020 15:06:44.938795,Desayunos · Jugos y Batidos,Dont Be Hungry,35000,5600,40600
6004,6005,21-10-2020 15:06:45.111706,Saludable · Desayunos,Distrito Gourmet,53900,3700,57600
6005,6006,21-10-2020 15:06:45.235496,Saludable · Desayunos,Maracuyá,37900,6700,44600
6006,6007,21-10-2020 15:06:45.509114,Helados,Orso To Go,9000,6800,15800
6007,6008,21-10-2020 15:06:45.685328,Desayunos · Parrilla,Mi Patria,15600,4600,20200
6008,6009,21-10-2020 15:06:46.061073,Típica · Parrilla,Toya,27800,4200,32000
6009,6010,21-10-2020 15:06:46.434969,Pizza,Pastas Laurentina,9000,4800,13800
6010,6011,21-10-2020 15:06:46.608115,Típica,La Herencia,35000,5900,40900
6011,6012,21-10-2020 15:06:46.731558,Pollo · Desayunos,Abasto,27800,3600,31400
6012,6013,21-10-2020 15:06:46.904768,Desayunos · Panadería,Pasteleite,23000,5900,28900
6013,6014,21-10-2020 15:06:47.077941,Desayunos,Desayunos en Bogotá,65000,3400,68400
6014,6015,21-10-2020 15:06:47.400970,Parrilla,Carnes la Zarza,24200,4900,29100
6015,6016,21-10-2020 15:06:47.775252,Saludable · Desayunos,La Estampilla,45800,6000,51800
6016,6017,21-10-2020 15:06:48.098359,Sánduches,Submarin,9000,3800,12800
6017,6018,21-10-2020 15:06:48.223761,Pizza · Parrilla,Urban Lunch,29500,4000,33500
6018,6019,21-10-2020 15:06:48.497440,Asiática,TeT,12500,5900,18400
6019,6020,21-10-2020 15:06:48.871245,Parrilla,Parrilla Pimentón,31800,3400,35200
6020,6021,21-10-2020 15:06:49.044515,Desayunos · Jugos y Batidos,Frutiwow,34500,4100,38600
6021,6022,21-10-2020 15:06:49.368986,Pollo · Desayunos,Piaf,8900,6500,15400
6022,6023,21-10-2020 15:06:49.692277,Desayunos · Típica,Calentao Express,17800,6000,23800
6023,6024,21-10-2020 15:06:49.967228,Desayunos,Don Leo,8900,6000,14900
6024,6025,21-10-2020 15:06:50.341225,Mexicana,La leyenda mexican kitchen,12500,3200,15700
6025,6026,21-10-2020 15:06:50.514575,Desayunos · Café,Libertario Coffee Roasters,8900,4600,13500
6026,6027,21-10-2020 15:06:50.737753,Pollo,Oliva Va,23000,5600,28600
6027,6028,21-10-2020 15:06:50.861582,Pizza · Parrilla,Urban Lunch,23000,4000,27000
6028,6029,21-10-2020 15:06:51.134583,Pollo,Oliva Va,45800,5600,51400
6029,6030,21-10-2020 15:06:51.408364,Pescados y Mariscos,La Gran Cazuela,7500,3200,10700
6030,6031,21-10-2020 15:06:51.581904,Pollo,Oliva Va,18900,5600,24500
6031,6032,21-10-2020 15:06:51.805484,Saludable · Desayunos,La Cesta,24300,4700,29000
6032,6033,21-10-2020 15:06:52.078640,Desayunos · Panadería,Siena Café,12500,3700,16200
6033,6034,21-10-2020 15:06:52.302812,Hamburguesas · Desayunos,El Inglés Gastro Pub,17800,6600,24400
6034,6035,21-10-2020 15:06:52.626226,Desayunos · Panadería,El Pan de Phillippe,17800,4600,22400
6035,6036,21-10-2020 15:06:52.749874,Desayunos · Típica,Desayunadero de la 42,70000,5900,75900
6036,6037,21-10-2020 15:06:52.923084,Desayunos · Café,El Gualilo,48750,6200,54950
6037,6038,21-10-2020 15:06:53.298174,Sánduches · China,Peru Mix,8900,5900,14800
6038,6039,21-10-2020 15:06:53.571349,Postres · Panadería,RIGHT AWAY FOODS,12500,6600,19100
6039,6040,21-10-2020 15:06:53.845592,Pollo · Desayunos,Caserito Gourmet,35000,6700,41700
6040,6041,21-10-2020 15:06:54.169627,Típica,La Herencia,13000,5900,18900
6041,6042,21-10-2020 15:06:54.544157,Parrilla · Internacional,Taperia de la Plaza,17800,5700,23500
6042,6043,21-10-2020 15:06:54.767118,Desayunos · Panadería,El Pan de Phillippe,24200,4600,28800
6043,6044,21-10-2020 15:06:54.941057,Mexicana,Hidalgo Taquería,8900,4900,13800
6044,6045,21-10-2020 15:06:55.264570,Pollo · Típica,Auyama,13000,3900,16900
6045,6046,21-10-2020 15:06:55.588424,Parrilla · Café,Figaro Café/ Restaurante Argentino,11870,5800,17670
6046,6047,21-10-2020 15:06:55.961365,Postres · Desayunos,Maltihelados,31800,6200,38000
6047,6048,21-10-2020 15:06:56.084741,Postres · Desayunos,Sweet Tale,9000,5800,14800
6048,6049,21-10-2020 15:06:56.257879,China,China Food Col,15000,3600,18600
6049,6050,21-10-2020 15:06:56.581659,Parrilla,Rústico Picadería,70000,3800,73800
6050,6051,21-10-2020 15:06:56.704726,Desayunos · Típica,Fogón Sangileño,23000,5000,28000
6051,6052,21-10-2020 15:06:57.028860,Desayunos,Butter,15600,6700,22300
6052,6053,21-10-2020 15:06:57.352103,Desayunos · Panadería,Santa Juana Food Bar,13000,5900,18900
6053,6054,21-10-2020 15:06:57.725626,Desayunos · Helados,San Giorgio Gelateria,12500,3100,15600
6054,6055,21-10-2020 15:06:57.948460,Saludable,Puro Verde,45800,5700,51500
6055,6056,21-10-2020 15:06:58.222021,Desayunos,Señor Desayuno,23000,6800,29800
6056,6057,21-10-2020 15:06:58.595729,Pollo · Saludable,Yerbabuena,23000,3900,26900
6057,6058,21-10-2020 15:06:58.868786,Panadería,Boul,24200,3100,27300
6058,6059,21-10-2020 15:06:59.141976,Desayunos · Sánduches,Garnish,53400,5200,58600
6059,6060,21-10-2020 15:06:59.415076,Pollo,Oliva Va,11870,5600,17470
6060,6061,21-10-2020 15:06:59.687988,Desayunos · Café,vereda central calle 99,65000,5700,70700
6061,6062,21-10-2020 15:07:00.061796,Típica,La Cocina,31800,4600,36400
6062,6063,21-10-2020 15:07:00.184183,Desayunos · Típica,Cochon,53400,3300,56700
6063,6064,21-10-2020 15:07:00.408221,Internacional,Rio Sabores y Experiencias,35000,4100,39100
6064,6065,21-10-2020 15:07:00.681910,Desayunos · Típica,Desayunadero de la 42,27800,5900,33700
6065,6066,21-10-2020 15:07:00.955000,Desayunos · Típica,Fogón Sangileño,23000,5000,28000
6066,6067,21-10-2020 15:07:01.077787,Desayunos · Café,Norma's Ice Cream Café,37900,6300,44200
6067,6068,21-10-2020 15:07:01.201267,Postres,Beiked,31800,4000,35800
6068,6069,21-10-2020 15:07:01.374163,Típica,Sabrosito,35000,4000,39000
6069,6070,21-10-2020 15:07:01.747509,Saludable,Amor Propio saludable,53900,4000,57900
6070,6071,21-10-2020 15:07:01.970737,Helados,Buon Gelato,10700,4400,15100
6071,6072,21-10-2020 15:07:02.244172,Desayunos · Sánduches,Frutos del Bosque,15600,3500,19100
6072,6073,21-10-2020 15:07:02.517263,Postres · Desayunos,Maltihelados,39700,6200,45900
6073,6074,21-10-2020 15:07:02.691298,Mexicana,La leyenda mexican kitchen,65000,3200,68200
6074,6075,21-10-2020 15:07:02.813808,Hamburguesas,Burger Society,35000,4100,39100
6075,6076,21-10-2020 15:07:02.987099,Postres · Desayunos,Cosmo Cookies,70000,5900,75900
6076,6077,21-10-2020 15:07:03.261099,Pollo,Señor Fantástico,7500,4700,12200
6077,6078,21-10-2020 15:07:03.384413,Pizza · Parrilla,Urban Lunch,48750,4000,52750
6078,6079,21-10-2020 15:07:03.658793,Desayunos · Panadería,Limarys,37900,6500,44400
6079,6080,21-10-2020 15:07:03.982504,Postres · Café,Celestino Café,45800,5900,51700
6080,6081,21-10-2020 15:07:04.155130,Típica,Bandejas Mrg,13600,3800,17400
6081,6082,21-10-2020 15:07:04.278499,Postres · Helados,Mahé,35000,6000,41000
6082,6083,21-10-2020 15:07:04.451814,Desayunos,Butter,8900,6700,15600
6083,6084,21-10-2020 15:07:04.575029,Pollo,Heart & Cooking,24300,5000,29300
6084,6085,21-10-2020 15:07:04.697675,Pollo,Señor Fantástico,35000,4700,39700
6085,6086,21-10-2020 15:07:04.871235,Típica,Carbón & Mondongos,35000,6400,41400
6086,6087,21-10-2020 15:07:04.993712,Postres · Café,Celestino Café,23000,5900,28900
6087,6088,21-10-2020 15:07:05.167016,Pizza,Pizza Andante,15000,6300,21300
6088,6089,21-10-2020 15:07:05.440410,Postres · Desayunos,Cosmo Cookies,53900,5900,59800
6089,6090,21-10-2020 15:07:05.663965,Mexicana,La leyenda mexican kitchen,23000,3200,26200
6090,6091,21-10-2020 15:07:05.987614,Pollo · Sánduches,Pollos Century,34500,3000,37500
6091,6092,21-10-2020 15:07:06.311107,Parrilla,Carnes la Zarza,24200,4900,29100
6092,6093,21-10-2020 15:07:06.534394,Café · Helados,Sofia heladería y café,13000,5800,18800
6093,6094,21-10-2020 15:07:06.907917,Pollo · Desayunos,Candelina,13600,5300,18900
6094,6095,21-10-2020 15:07:07.031257,Postres · Desayunos,Amelie Helados,37900,6400,44300
6095,6096,21-10-2020 15:07:07.405186,Saludable · Parrilla,Box,23000,3700,26700
6096,6097,21-10-2020 15:07:07.528404,Sushi,Canoa To Go,31800,5900,37700
6097,6098,21-10-2020 15:07:07.802287,Postres · Desayunos,Maltihelados,35000,6200,41200
6098,6099,21-10-2020 15:07:08.076206,Desayunos,Bagel Shop,7500,3200,10700
6099,6100,21-10-2020 15:07:08.350262,Pollo · Pescados y Mariscos,Bang Bang Rice,53900,3400,57300
6100,6101,21-10-2020 15:07:08.624053,Saludable · Típica,Saludable Mrg,34500,5800,40300
6101,6102,21-10-2020 15:07:08.749317,Desayunos · Mexicana,La Mera Mera - Mexicana,17800,3100,20900
6102,6103,21-10-2020 15:07:09.072532,Desayunos,El Fogón Castellano,17800,3200,21000
6103,6104,21-10-2020 15:07:09.346042,Alta Cocina · Postres,La Pinta,13600,4500,18100
6104,6105,21-10-2020 15:07:09.719184,Italiana,F*cking Good Pizza,15600,4200,19800
6105,6106,21-10-2020 15:07:09.992531,Parrilla,Rústico Picadería,27800,3800,31600
6106,6107,21-10-2020 15:07:10.265645,Desayunos · Empanadas,Mis Delicias,65000,3200,68200
6107,6108,21-10-2020 15:07:10.489430,Saludable · Desayunos,Agua Dulce,27800,3700,31500
6108,6109,21-10-2020 15:07:10.812519,Pollo · China,China Tao,18900,3500,22400
6109,6110,21-10-2020 15:07:10.986085,Saludable · Jugos y Batidos,Berdes Drinks & Salads,9000,3500,12500
6110,6111,21-10-2020 15:07:11.259223,Saludable · Desayunos,Bawana - Sandwich,53400,3400,56800
6111,6112,21-10-2020 15:07:11.433068,Desayunos · Panadería,Le Pain Quotidien,45800,3900,49700
6112,6113,21-10-2020 15:07:11.806527,Pizza,Pastas Laurentina,31800,4800,36600
6113,6114,21-10-2020 15:07:12.030198,Sushi · Asiática,Arigato,39700,5300,45000
6114,6115,21-10-2020 15:07:12.404016,Típica,Sopitas y Más,11870,4200,16070
6115,6116,21-10-2020 15:07:12.528035,Helados,Buon Gelato,13600,4400,18000
6116,6117,21-10-2020 15:07:12.651039,Parrilla,El Tambor,35000,6800,41800
6117,6118,21-10-2020 15:07:12.974909,Sushi · Asiática,Arigato,53900,5300,59200
6118,6119,21-10-2020 15:07:13.248066,Desayunos · Mexicana,La Mera Mera - Mexicana,24300,3100,27400
6119,6120,21-10-2020 15:07:13.522005,Parrilla,OAK Ahumado y Brebajes,8900,6000,14900
6120,6121,21-10-2020 15:07:13.695177,Típica · Parrilla,El Portal de la Antigua,24300,5600,29900
6121,6122,21-10-2020 15:07:13.870086,Saludable · Típica,Sopas Mrg,39700,3100,42800
6122,6123,21-10-2020 15:07:14.043177,Desayunos · Panadería,Limarys,24300,6500,30800
6123,6124,21-10-2020 15:07:14.417215,Pizza · Italiana,Piatto - Pizza,27800,6600,34400
6124,6125,21-10-2020 15:07:14.740639,Saludable · Desayunos,Re.al Alimentos Reales,18900,4000,22900
6125,6126,21-10-2020 15:07:14.914058,Desayunos,Cafetería el Kippe,13600,3200,16800
6126,6127,21-10-2020 15:07:15.237479,Postres · Desayunos,KOKOA & co.,18900,4700,23600
6127,6128,21-10-2020 15:07:15.511044,Asiática,Thai Station,15000,6000,21000
6128,6129,21-10-2020 15:07:15.684255,Saludable · Desayunos,Raices Bienestar Gourmet,24300,6600,30900
6129,6130,21-10-2020 15:07:15.908235,Postres · Desayunos,Vivalight Market.,11870,6500,18370
6130,6131,21-10-2020 15:07:16.031315,Sánduches · Pescados y Mariscos,Pacific Comida de Mar,34500,4000,38500
6131,6132,21-10-2020 15:07:16.355254,Desayunos · Típica,Cochon,35000,3300,38300
6132,6133,21-10-2020 15:07:16.728648,Asiática,TeT,31800,5900,37700
6133,6134,21-10-2020 15:07:16.852205,Desayunos · Pescados y Mariscos,Gypsy Bistro,8900,4500,13400
6134,6135,21-10-2020 15:07:17.175190,Parrilla,El Tambor,70000,6800,76800
6135,6136,21-10-2020 15:07:17.498950,Desayunos · Café,Aromacafé el Placer de Compartir,15000,5000,20000
6136,6137,21-10-2020 15:07:17.772222,Desayunos · Panadería,El Pan de Phillippe,53900,4600,58500
6137,6138,21-10-2020 15:07:18.045719,Típica,Lo Nuestro,35000,3100,38100
6138,6139,21-10-2020 15:07:18.168674,Hamburguesas · Pescados y Mariscos,El Velero,23000,6500,29500
6139,6140,21-10-2020 15:07:18.342238,Desayunos · Internacional,Camilia,53900,3900,57800
6140,6141,21-10-2020 15:07:18.665454,Pollo · Sánduches,Pollos Century,9000,3000,12000
6141,6142,21-10-2020 15:07:18.940121,Saludable · Desayunos,Copacabana Açai Bowls,48750,3000,51750
6142,6143,21-10-2020 15:07:19.313229,Desayunos · Árabe,Boniato Sabores Vivos,34500,5300,39800
6143,6144,21-10-2020 15:07:19.436686,Típica · Parrilla,La Ternera Parrilla,15000,5200,20200
6144,6145,21-10-2020 15:07:19.760264,Pescados y Mariscos,Fish Place - Del Mar,17800,5400,23200
6145,6146,21-10-2020 15:07:19.983858,Saludable,Puro Verde,65000,5700,70700
6146,6147,21-10-2020 15:07:20.106813,Saludable · Desayunos,Malú,27800,3700,31500
6147,6148,21-10-2020 15:07:20.380943,Mexicana,Cantina La 15,65000,4300,69300
6148,6149,21-10-2020 15:07:20.604223,Desayunos · Típica,Papadió - Colombianas,70000,5700,75700
6149,6150,21-10-2020 15:07:20.828028,Desayunos · Panadería,Decofruta,37900,4700,42600
6150,6151,21-10-2020 15:07:21.001201,Pizza · Italiana,Piatto - Pizza,8900,6600,15500
6151,6152,21-10-2020 15:07:21.275216,Sánduches · China,Peru Mix,39700,5900,45600
6152,6153,21-10-2020 15:07:21.448410,Postres · Saludable,Ana Rebana,31800,6300,38100
6153,6154,21-10-2020 15:07:21.771952,Postres · Desayunos,Sweet Tale,11870,5800,17670
6154,6155,21-10-2020 15:07:22.145728,Pescados y Mariscos,La Gran Cazuela,70000,3200,73200
6155,6156,21-10-2020 15:07:22.369163,Típica,Juan Chorizo,15000,3900,18900
6156,6157,21-10-2020 15:07:22.491958,Saludable · Desayunos,Agua Dulce,13000,3700,16700
6157,6158,21-10-2020 15:07:22.715954,Saludable · Desayunos,Maracuyá,31800,6700,38500
6158,6159,21-10-2020 15:07:23.039193,Desayunos · Sánduches,Danilo Colombia,48750,3300,52050
6159,6160,21-10-2020 15:07:23.312640,Típica,El Mondongo y Mucho Mas,53900,5600,59500
6160,6161,21-10-2020 15:07:23.536062,Desayunos,Butter,70000,6700,76700
6161,6162,21-10-2020 15:07:23.709615,Italiana,Bocatto Di Passo,23000,5000,28000
6162,6163,21-10-2020 15:07:23.983837,Saludable · Desayunos,La Cesta,13000,4700,17700
6163,6164,21-10-2020 15:07:24.107783,Desayunos · Típica,La Parrilla Dorada Polo,31800,6600,38400
6164,6165,21-10-2020 15:07:24.280708,Pizza,Pastas Laurentina,15000,4800,19800
6165,6166,21-10-2020 15:07:24.404073,Típica · Parrilla,El Portal de la Antigua,11870,5600,17470
6166,6167,21-10-2020 15:07:24.527300,Desayunos · Café,Aromacafé el Placer de Compartir,8900,5000,13900
6167,6168,21-10-2020 15:07:24.850764,Jugos y Batidos,Pomponio,17800,3600,21400
6168,6169,21-10-2020 15:07:25.023370,Saludable · Desayunos,Maracuyá,45800,6700,52500
6169,6170,21-10-2020 15:07:25.397980,Peruana,Masivo,11870,5800,17670
6170,6171,21-10-2020 15:07:25.570631,Desayunos · Comida Rápida,La Veneca,8900,6300,15200
6171,6172,21-10-2020 15:07:25.843924,Pollo · Saludable,Tremenda Sal y Dulce,11870,6500,18370
6172,6173,21-10-2020 15:07:26.117404,Desayunos,El Corral - Desayunos,11870,5000,16870
6173,6174,21-10-2020 15:07:26.390800,Postres · Café,Celestino Café,35000,5900,40900
6174,6175,21-10-2020 15:07:26.614255,Postres · Helados,Mahé,37900,6000,43900
6175,6176,21-10-2020 15:07:26.988071,Desayunos · Café,Frambas,15600,3400,19000
6176,6177,21-10-2020 15:07:27.311110,Pollo · Típica,Auyama,18900,3900,22800
6177,6178,21-10-2020 15:07:27.684728,Desayunos · Panadería,Ficchi Panadería,34500,3100,37600
6178,6179,21-10-2020 15:07:27.858051,Pollo · Desayunos,Abasto,24200,3600,27800
6179,6180,21-10-2020 15:07:28.131352,Saludable,A2manos,7500,4200,11700
6180,6181,21-10-2020 15:07:28.304132,Helados,Buon Gelato,17800,4400,22200
6181,6182,21-10-2020 15:07:28.528046,Pizza,Pastas Laurentina,17800,4800,22600
6182,6183,21-10-2020 15:07:28.751021,Desayunos · Típica,La Parrilla Dorada Polo,34500,6600,41100
6183,6184,21-10-2020 15:07:29.025622,Hamburguesas,Burger Society,7500,4100,11600
6184,6185,21-10-2020 15:07:29.249115,Parrilla,OAK Ahumado y Brebajes,23000,6000,29000
6185,6186,21-10-2020 15:07:29.622993,Hamburguesas · Panadería,NYC Burgers,23000,6200,29200
6186,6187,21-10-2020 15:07:29.946555,Hamburguesas · Saludable,Restaurant Inn,8900,6100,15000
6187,6188,21-10-2020 15:07:30.220645,Desayunos · Comida Rápida,La Veneca,34500,6300,40800
6188,6189,21-10-2020 15:07:30.394226,Pizza · Parrilla,Urban Lunch,53900,4000,57900
6189,6190,21-10-2020 15:07:30.718207,Jugos y Batidos,Pomponio,53900,3600,57500
6190,6191,21-10-2020 15:07:30.941395,Mexicana,Mexicanachos,39700,3900,43600
6191,6192,21-10-2020 15:07:31.115031,Desayunos · Comida Rápida,La Veneca,17800,6300,24100
6192,6193,21-10-2020 15:07:31.288173,Parrilla,Rústico Picadería,12500,3800,16300
6193,6194,21-10-2020 15:07:31.662070,Sánduches,Submarin,24300,3800,28100
6194,6195,21-10-2020 15:07:32.035183,Desayunos · Mexicana,La Mera Mera - Mexicana,15000,3100,18100
6195,6196,21-10-2020 15:07:32.258838,Saludable · Desayunos,Maracuyá,53900,6700,60600
6196,6197,21-10-2020 15:07:32.583122,Típica · Parrilla,Toya,65000,4200,69200
6197,6198,21-10-2020 15:07:32.756828,Típica,Bandejas Mrg,10700,3800,14500
6198,6199,21-10-2020 15:07:33.030191,Postres · Desayunos,La Folie - Postres,18900,3300,22200
6199,6200,21-10-2020 15:07:33.303810,Parrilla,Carnes la Zarza,29500,4900,34400
6200,6201,21-10-2020 15:07:33.627194,Pescados y Mariscos,Pescadero Héroes del Mar,10700,6600,17300
6201,6202,21-10-2020 15:07:33.851049,Internacional,Rio Sabores y Experiencias,35000,4100,39100
6202,6203,21-10-2020 15:07:34.125717,Helados,Buon Gelato,23000,4400,27400
6203,6204,21-10-2020 15:07:34.449457,Internacional,Rio Sabores y Experiencias,9000,4100,13100
6204,6205,21-10-2020 15:07:34.572217,Saludable,A2manos,18900,4200,23100
6205,6206,21-10-2020 15:07:34.745944,Saludable · Desayunos,Maracuyá,13600,6700,20300
6206,6207,21-10-2020 15:07:35.119116,Pizza · Italiana,Piatto - Pizza,15600,6600,22200
6207,6208,21-10-2020 15:07:35.242676,Parrilla · Café,Figaro Café/ Restaurante Argentino,24300,5800,30100
6208,6209,21-10-2020 15:07:35.365484,Pizza,pizza andante,29500,4200,33700
6209,6210,21-10-2020 15:07:35.689023,Saludable · Típica,Sopas Mrg,24300,3100,27400
6210,6211,21-10-2020 15:07:36.062302,Desayunos · Café,Aromacafé el Placer de Compartir,31800,5000,36800
6211,6212,21-10-2020 15:07:36.386166,Desayunos · Panadería,Santa Juana Food Bar,34500,5900,40400
6212,6213,21-10-2020 15:07:36.759468,Desayunos · Panadería,Le Pain Quotidien,24300,3900,28200
6213,6214,21-10-2020 15:07:36.883260,Postres · Desayunos,Maria Luisa - Postres,24200,4300,28500
6214,6215,21-10-2020 15:07:37.006365,Típica · Parrilla,El Portal de la Antigua,15600,5600,21200
6215,6216,21-10-2020 15:07:37.280066,Pescados y Mariscos,Fish Place - Del Mar,35000,5400,40400
6216,6217,21-10-2020 15:07:37.503325,Desayunos · Típica,Papadió - Colombianas,39700,5700,45400
6217,6218,21-10-2020 15:07:37.827372,Típica · Parrilla,La Ternera Parrilla,7500,5200,12700
6218,6219,21-10-2020 15:07:38.051075,Crepes,La Chabatta,35000,5900,40900
6219,6220,21-10-2020 15:07:38.425333,Pescados y Mariscos,Fish Place - Del Mar,65000,5400,70400
6220,6221,21-10-2020 15:07:38.798612,Pizza,Pizza Andante,27800,6300,34100
6221,6222,21-10-2020 15:07:38.972292,Típica,Juan Chorizo,8900,3900,12800
6222,6223,21-10-2020 15:07:39.146990,Típica · Parrilla,El Santandereano,48750,5200,53950
6223,6224,21-10-2020 15:07:39.272525,Postres · Desayunos,Restaurante Cornelia,18900,5500,24400
6224,6225,21-10-2020 15:07:39.546230,Sánduches · Pescados y Mariscos,Pacific Comida de Mar,53900,4000,57900
6225,6226,21-10-2020 15:07:39.869949,Comida Rápida · Perros Calientes,Similoa - Comida Rapida,34500,3700,38200
6226,6227,21-10-2020 15:07:40.092758,Desayunos · Típica,La Parrilla Dorada Polo,9000,6600,15600
6227,6228,21-10-2020 15:07:40.466348,Sushi · Asiática,Tu Sushi,70000,6400,76400
6228,6229,21-10-2020 15:07:40.639286,Parrilla,Carnes la Zarza,39700,4900,44600
6229,6230,21-10-2020 15:07:40.862821,Pollo,Oliva Va,23000,5600,28600
6230,6231,21-10-2020 15:07:41.185841,Desayunos,La Frijolada Desayunos,8900,4400,13300
6231,6232,21-10-2020 15:07:41.359265,Parrilla · Internacional,Taperia de la Plaza,34500,5700,40200
6232,6233,21-10-2020 15:07:41.482350,Típica,La Herencia,24300,5900,30200
6233,6234,21-10-2020 15:07:41.655769,Desayunos · Café,vereda central calle 99,10700,5700,16400
6234,6235,21-10-2020 15:07:41.828907,Parrilla,Rústico Picadería,10700,3800,14500
6235,6236,21-10-2020 15:07:41.952265,Desayunos · Sánduches,Danilo Colombia,27800,3300,31100
6236,6237,21-10-2020 15:07:42.125275,Postres · Desayunos,BagBog Bagels,27800,6400,34200
6237,6238,21-10-2020 15:07:42.398992,Pizza · Italiana,Piatto - Pizza,15000,6600,21600
6238,6239,21-10-2020 15:07:42.572096,Postres · Saludable,Ana Rebana,65000,6300,71300
6239,6240,21-10-2020 15:07:42.845578,Desayunos · Comida Rápida,La Veneca,53400,6300,59700
6240,6241,21-10-2020 15:07:43.168662,Crepes,La Chabatta,18900,5900,24800
6241,6242,21-10-2020 15:07:43.442216,Pollo · Desayunos,Workzone,34500,3100,37600
6242,6243,21-10-2020 15:07:43.615276,Saludable · Parrilla,The Angels Grill and Drinks,53400,6200,59600
6243,6244,21-10-2020 15:07:43.938982,Desayunos,El Corral - Desayunos,17800,5000,22800
6244,6245,21-10-2020 15:07:44.163091,Saludable · Desayunos,Malú,23000,3700,26700
6245,6246,21-10-2020 15:07:44.486625,Mexicana,La leyenda mexican kitchen,15000,3200,18200
6246,6247,21-10-2020 15:07:44.709677,Desayunos · Panadería,Artesanos,10700,4300,15000
6247,6248,21-10-2020 15:07:45.083220,Parrilla,Carnes la Zarza,23000,4900,27900
6248,6249,21-10-2020 15:07:45.256166,Postres · Desayunos,Maltihelados,34500,6200,40700
6249,6250,21-10-2020 15:07:45.430017,Desayunos · Café,Moramia,13000,4700,17700
6250,6251,21-10-2020 15:07:45.653349,Saludable · Desayunos,Raices Bienestar Gourmet,23000,6600,29600
6251,6252,21-10-2020 15:07:45.977050,Desayunos · Panadería,Ficchi Panadería,70000,3100,73100
6252,6253,21-10-2020 15:07:46.300430,Desayunos · Árabe,Boniato Sabores Vivos,35000,5300,40300
6253,6254,21-10-2020 15:07:46.624246,Postres · Desayunos,Café Quindio,35000,5700,40700
6254,6255,21-10-2020 15:07:46.947498,Desayunos · Panadería,Juliana Restaurante,11870,6100,17970
6255,6256,21-10-2020 15:07:47.271248,Pollo · Desayunos,Workzone,7500,3100,10600
6256,6257,21-10-2020 15:07:47.594551,Desayunos,Fratelli - Desayunos,70000,4600,74600
6257,6258,21-10-2020 15:07:47.718136,Postres · Desayunos,La Folie - Postres,53400,3300,56700
6258,6259,21-10-2020 15:07:47.841189,Hamburguesas,Monchis - Hamburguesa,65000,4300,69300
6259,6260,21-10-2020 15:07:48.214804,Parrilla · Café,Figaro Café/ Restaurante Argentino,48750,5800,54550
6260,6261,21-10-2020 15:07:48.337732,Desayunos · Típica,90 Calentados,11870,3700,15570
6261,6262,21-10-2020 15:07:48.711343,Internacional,La Esquina con Sabor Parrilla,29500,3000,32500
6262,6263,21-10-2020 15:07:48.884270,Desayunos · Italiana,Rceta By Rausch,34500,3600,38100
6263,6264,21-10-2020 15:07:49.159341,Típica,Bendita S,11870,4600,16470
6264,6265,21-10-2020 15:07:49.332475,Saludable · Desayunos,Bon Eat - Saludable,65000,4800,69800
6265,6266,21-10-2020 15:07:49.506171,Desayunos,Cafetería el Kippe,24200,3200,27400
6266,6267,21-10-2020 15:07:49.679047,Desayunos · Italiana,Rceta By Rausch,31800,3600,35400
6267,6268,21-10-2020 15:07:50.002987,Saludable · Desayunos,La Cesta,11870,4700,16570
6268,6269,21-10-2020 15:07:50.326359,Saludable · Desayunos,Fresh Co,37900,5600,43500
6269,6270,21-10-2020 15:07:50.500043,China,China Food Col,10700,3600,14300
6270,6271,21-10-2020 15:07:50.672990,Crepes,San Crepes,23000,4900,27900
6271,6272,21-10-2020 15:07:50.996583,Hamburguesas · Alitas,Beer,29500,6600,36100
6272,6273,21-10-2020 15:07:51.119389,Desayunos · Café,Matchacha,27800,5900,33700
6273,6274,21-10-2020 15:07:51.343152,Mexicana,Hidalgo Taquería,11870,4900,16770
6274,6275,21-10-2020 15:07:51.716749,Comida Rápida · Perros Calientes,Similoa - Comida Rapida,29500,3700,33200
6275,6276,21-10-2020 15:07:51.940432,Desayunos · Jugos y Batidos,Frutiwow,15600,4100,19700
6276,6277,21-10-2020 15:07:52.163584,Postres · Desayunos,Maltihelado,18900,4500,23400
6277,6278,21-10-2020 15:07:52.387297,Desayunos · Café,Moramia,12500,4700,17200
6278,6279,21-10-2020 15:07:52.710785,Típica,Salsig,17800,5600,23400
6279,6280,21-10-2020 15:07:52.984540,Saludable · Desayunos,Bawana - Sandwich,70000,3400,73400
6280,6281,21-10-2020 15:07:53.107712,Hamburguesas · Pescados y Mariscos,El Velero,29500,6500,36000
6281,6282,21-10-2020 15:07:53.381480,Desayunos · Panadería,Juliana Restaurante,23000,6100,29100
6282,6283,21-10-2020 15:07:53.504464,Comida Rápida · Perros Calientes,Similoa - Comida Rapida,11870,3700,15570
6283,6284,21-10-2020 15:07:53.778764,Desayunos · Típica,Cochon,29500,3300,32800
6284,6285,21-10-2020 15:07:54.051967,Asiática,Thai Station,10700,6000,16700
6285,6286,21-10-2020 15:07:54.176606,Hamburguesas · Saludable,Restaurant Inn,29500,6100,35600
6286,6287,21-10-2020 15:07:54.400160,Sushi · Desayunos,Maki Roll,7500,4300,11800
6287,6288,21-10-2020 15:07:54.573924,Desayunos · Panadería,Pasteleite,24300,5900,30200
6288,6289,21-10-2020 15:07:54.947288,Hamburguesas · Desayunos,El Inglés Gastro Pub,15600,6600,22200
6289,6290,21-10-2020 15:07:55.221374,Postres · Helados,Mahé,23000,6000,29000
6290,6291,21-10-2020 15:07:55.344434,Hamburguesas,Gofi Burger,37900,5100,43000
6291,6292,21-10-2020 15:07:55.518083,Típica,Bandejas Mrg,13600,3800,17400
6292,6293,21-10-2020 15:07:55.641286,Postres · Desayunos,Café Quindio,29500,5700,35200
6293,6294,21-10-2020 15:07:55.964887,Típica · Parrilla,Toya,53400,4200,57600
6294,6295,21-10-2020 15:07:56.288165,Postres · Desayunos,Sweet Tale,13000,5800,18800
6295,6296,21-10-2020 15:07:56.561681,Saludable · Desayunos,Raices Bienestar Gourmet,23000,6600,29600
6296,6297,21-10-2020 15:07:56.734649,Saludable · Desayunos,Básico y elemental,34500,5000,39500
6297,6298,21-10-2020 15:07:57.008815,Desayunos · Pescados y Mariscos,Luzí­a - Mediterranea,24200,5700,29900
6298,6299,21-10-2020 15:07:57.232143,Saludable · Típica,Saludable Mrg,45800,5800,51600
6299,6300,21-10-2020 15:07:57.355849,Saludable · Desayunos,La Cesta,13600,4700,18300
6300,6301,21-10-2020 15:07:57.729424,Típica · Pescados y Mariscos,La Vitualla,13000,6300,19300
6301,6302,21-10-2020 15:07:57.903360,Desayunos,Butter,23000,6700,29700
6302,6303,21-10-2020 15:07:58.026861,Desayunos · Panadería,Limarys,53900,6500,60400
6303,6304,21-10-2020 15:07:58.350524,Pizza,Pastas Laurentina,17800,4800,22600
6304,6305,21-10-2020 15:07:58.473960,Saludable · Parrilla,The Angels Grill and Drinks,23000,6200,29200
6305,6306,21-10-2020 15:07:58.847723,Postres,Beiked,13000,4000,17000
6306,6307,21-10-2020 15:07:59.222289,Desayunos · Panadería,Juliana Restaurante,37900,6100,44000
6307,6308,21-10-2020 15:07:59.596168,Saludable · Desayunos,Bawana - Sandwich,53900,3400,57300
6308,6309,21-10-2020 15:07:59.869510,Pollo · Saludable,Tremenda Sal y Dulce,34500,6500,41000
6309,6310,21-10-2020 15:08:00.143249,Hamburguesas,Gofi Burger,39700,5100,44800
6310,6311,21-10-2020 15:08:00.266457,Peruana,Masivo,13600,5800,19400
6311,6312,21-10-2020 15:08:00.540167,Postres · Desayunos,Aury Postres - Comidas & Picadas,53400,4700,58100
6312,6313,21-10-2020 15:08:00.863593,Parrilla,Carnes la Zarza,24300,4900,29200
6313,6314,21-10-2020 15:08:01.187649,Desayunos · Café,Aromacafé el Placer de Compartir,35000,5000,40000
6314,6315,21-10-2020 15:08:01.561015,Parrilla,Parrilla Pimentón,39700,3400,43100
6315,6316,21-10-2020 15:08:01.934988,Hamburguesas,Gofi Burger,13000,5100,18100
6316,6317,21-10-2020 15:08:02.308591,Desayunos · Sánduches,Frutos del Bosque,11870,3500,15370
6317,6318,21-10-2020 15:08:02.632701,Desayunos · Panadería,Juliana Restaurante,11870,6100,17970
6318,6319,21-10-2020 15:08:02.755839,Postres · Desayunos,BagBog Bagels,13600,6400,20000
6319,6320,21-10-2020 15:08:03.029615,Parrilla,OAK Ahumado y Brebajes,23000,6000,29000
6320,6321,21-10-2020 15:08:03.403356,Típica,Baondish,29500,5800,35300
6321,6322,21-10-2020 15:08:03.677187,Desayunos · Panadería,Le Pain Quotidien,15600,3900,19500
6322,6323,21-10-2020 15:08:03.850392,Desayunos · Típica,Peninsula Calentados y Parrilla,48750,3400,52150
6323,6324,21-10-2020 15:08:04.074186,Desayunos · Panadería,Juliana Restaurante,17800,6100,23900
6324,6325,21-10-2020 15:08:04.348685,Internacional,Rio Sabores y Experiencias,27800,4100,31900
6325,6326,21-10-2020 15:08:04.472563,Postres · Desayunos,Cosmo Cookies,65000,5900,70900
6326,6327,21-10-2020 15:08:04.595699,Saludable,MIMA,15600,3700,19300
6327,6328,21-10-2020 15:08:04.769590,Pizza,18 Scalini,35000,4300,39300
6328,6329,21-10-2020 15:08:04.892643,Parrilla,Arepaisa de Medellín,45800,5600,51400
6329,6330,21-10-2020 15:08:05.266650,Pollo · Desayunos,Workzone,35000,3100,38100
6330,6331,21-10-2020 15:08:05.540103,Desayunos · Internacional,Camilia,53400,3900,57300
6331,6332,21-10-2020 15:08:05.764107,Pescados y Mariscos,Fish Place - Del Mar,17800,5400,23200
6332,6333,21-10-2020 15:08:06.137753,Postres,La Galeta,9000,3000,12000
6333,6334,21-10-2020 15:08:06.512086,Pollo · Saludable,Yerbabuena,48750,3900,52650
6334,6335,21-10-2020 15:08:06.735636,Típica,Campo Victoria,13000,3000,16000
6335,6336,21-10-2020 15:08:07.109634,Típica,Bendita S,18900,4600,23500
6336,6337,21-10-2020 15:08:07.383184,Parrilla,Carnes la Zarza,11870,4900,16770
6337,6338,21-10-2020 15:08:07.757418,Postres · Desayunos,Vivalight Market.,24300,6500,30800
6338,6339,21-10-2020 15:08:08.081249,Postres · Desayunos,Café Quindio,13600,5700,19300
6339,6340,21-10-2020 15:08:08.255705,Sushi · Asiática,Arigato,53400,5300,58700
6340,6341,21-10-2020 15:08:08.379279,Desayunos · Típica,D'Porco - Lechona,53900,6300,60200
6341,6342,21-10-2020 15:08:08.653492,Típica,Sabores De Mi Tierra,23000,5400,28400
6342,6343,21-10-2020 15:08:09.027019,Postres,La Galeta,48750,3000,51750
6343,6344,21-10-2020 15:08:09.402620,Desayunos · Internacional,Camilia,13600,3900,17500
6344,6345,21-10-2020 15:08:09.726462,Típica,Sopitas y Más,13600,4200,17800
6345,6346,21-10-2020 15:08:10.100402,Sushi · Desayunos,Maki Roll,65000,4300,69300
6346,6347,21-10-2020 15:08:10.474343,Postres · Helados,Mahé,53900,6000,59900
6347,6348,21-10-2020 15:08:10.598448,Típica · Parrilla,La Ternera Parrilla,31800,5200,37000
6348,6349,21-10-2020 15:08:10.821986,Desayunos,El Corral - Desayunos,37900,5000,42900
6349,6350,21-10-2020 15:08:11.196065,Postres,Beiked,24200,4000,28200
6350,6351,21-10-2020 15:08:11.419802,Sánduches · Pescados y Mariscos,Pacific Comida de Mar,15000,4000,19000
6351,6352,21-10-2020 15:08:11.744199,Internacional,Rio Sabores y Experiencias,29500,4100,33600
6352,6353,21-10-2020 15:08:11.967412,Pollo · Saludable,Tremenda Sal y Dulce,10700,6500,17200
6353,6354,21-10-2020 15:08:12.241848,Pollo · China,China Tao,24300,3500,27800
6354,6355,21-10-2020 15:08:12.565412,Sushi,Sushi Reel,31800,4700,36500
6355,6356,21-10-2020 15:08:12.889589,Desayunos · Panadería,Limarys,24300,6500,30800
6356,6357,21-10-2020 15:08:13.112943,Desayunos,La Frijolada Desayunos,23000,4400,27400
6357,6358,21-10-2020 15:08:13.386915,Típica,Sabores De Mi Tierra,53900,5400,59300
6358,6359,21-10-2020 15:08:13.760688,Desayunos · Típica,Criollomania,39700,5200,44900
6359,6360,21-10-2020 15:08:13.884175,Pescados y Mariscos,La Gran Cazuela,13600,3200,16800
6360,6361,21-10-2020 15:08:14.007285,Desayunos · Panadería,Choclofee,53900,4700,58600
6361,6362,21-10-2020 15:08:14.131178,Saludable · Desayunos,Bon Eat - Saludable,37900,4800,42700
6362,6363,21-10-2020 15:08:14.505941,Típica,Campo Victoria,35000,3000,38000
6363,6364,21-10-2020 15:08:14.779952,Parrilla,OAK Ahumado y Brebajes,27800,6000,33800
6364,6365,21-10-2020 15:08:15.103631,Sushi · Asiática,Arigato,27800,5300,33100
6365,6366,21-10-2020 15:08:15.477981,Saludable · Desayunos,Básico y elemental,24200,5000,29200
6366,6367,21-10-2020 15:08:15.701476,Hamburguesas · Pescados y Mariscos,El Velero,17800,6500,24300
6367,6368,21-10-2020 15:08:15.975380,Postres · Desayunos,Aury Postres - Comidas & Picadas,24200,4700,28900
6368,6369,21-10-2020 15:08:16.248864,Postres · Desayunos,Maltihelado,65000,4500,69500
6369,6370,21-10-2020 15:08:16.523112,Helados,Orso To Go,8900,6800,15700
6370,6371,21-10-2020 15:08:16.896700,Helados,Buon Gelato,11870,4400,16270
6371,6372,21-10-2020 15:08:17.120654,Pizza · Italiana,Piatto - Pizza,17800,6600,24400
6372,6373,21-10-2020 15:08:17.444162,Desayunos · Jugos y Batidos,Kuriwaji,34500,6300,40800
6373,6374,21-10-2020 15:08:17.768317,Parrilla,Campocina,37900,4600,42500
6374,6375,21-10-2020 15:08:17.941512,Desayunos · Árabe,Boniato Sabores Vivos,48750,5300,54050
6375,6376,21-10-2020 15:08:18.165535,Crepes,San Crepes,24200,4900,29100
6376,6377,21-10-2020 15:08:18.388971,Desayunos · Café,Frambas,34500,3400,37900
6377,6378,21-10-2020 15:08:18.562674,Hamburguesas · Pescados y Mariscos,El Velero,70000,6500,76500
6378,6379,21-10-2020 15:08:18.886045,Saludable · Típica,Saludable Mrg,45800,5800,51600
6379,6380,21-10-2020 15:08:19.160015,Parrilla,Restaurante Bar Mi Ranchito,15600,5200,20800
6380,6381,21-10-2020 15:08:19.283250,Saludable · Desayunos,Básico y elemental,13000,5000,18000
6381,6382,21-10-2020 15:08:19.607264,Asiática,Thai Station,45800,6000,51800
6382,6383,21-10-2020 15:08:19.980904,Pollo · Desayunos,Candelina,35000,5300,40300
6383,6384,21-10-2020 15:08:20.355185,Desayunos · Pescados y Mariscos,Gypsy Bistro,65000,4500,69500
6384,6385,21-10-2020 15:08:20.678924,Desayunos · Panadería,Santa Juana Food Bar,39700,5900,45600
6385,6386,21-10-2020 15:08:20.902855,Sushi · Asiática,Tu Sushi,11870,6400,18270
6386,6387,21-10-2020 15:08:21.276353,Desayunos · Panadería,Choclofee,34500,4700,39200
6387,6388,21-10-2020 15:08:21.600414,Pizza · Italiana,Pisapore - Pizza,18900,6600,25500
6388,6389,21-10-2020 15:08:21.823708,Típica · Parrilla,La Ternera Parrilla,11870,5200,17070
6389,6390,21-10-2020 15:08:22.147786,Desayunos,Jacinta Arepas de Huevo,35000,4000,39000
6390,6391,21-10-2020 15:08:22.421256,Pollo · Desayunos,Candelina,39700,5300,45000
6391,6392,21-10-2020 15:08:22.695309,Saludable · Desayunos,Re.al Alimentos Reales,15000,4000,19000
6392,6393,21-10-2020 15:08:23.068994,Típica,Cazuelitas 93,10700,3900,14600
6393,6394,21-10-2020 15:08:23.192799,Desayunos · Panadería,Santa Juana Food Bar,23000,5900,28900
6394,6395,21-10-2020 15:08:23.366094,Típica · Parrilla,La Parilla de David,24200,3100,27300
6395,6396,21-10-2020 15:08:23.740160,Mexicana,La leyenda mexican kitchen,11870,3200,15070
6396,6397,21-10-2020 15:08:23.963990,Típica,Juan Chorizo,15000,3900,18900
6397,6398,21-10-2020 15:08:24.338328,Desayunos · Jugos y Batidos,Frutiwow,23000,4100,27100
6398,6399,21-10-2020 15:08:24.461755,Saludable · Parrilla,The Angels Grill and Drinks,7500,6200,13700
6399,6400,21-10-2020 15:08:24.785985,Saludable,Ventura Soup y Salad,35000,3800,38800
6400,6401,21-10-2020 15:08:25.059418,Parrilla · Café,Figaro Café/ Restaurante Argentino,13600,5800,19400
6401,6402,21-10-2020 15:08:25.433650,Postres · Helados,Mahé,31800,6000,37800
6402,6403,21-10-2020 15:08:25.607281,Postres · Desayunos,Maria Luisa - Postres,37900,4300,42200
6403,6404,21-10-2020 15:08:25.931555,Pescados y Mariscos,La Gran Cazuela,37900,3200,41100
6404,6405,21-10-2020 15:08:26.205162,Desayunos,Bagel Shop,15600,3200,18800
6405,6406,21-10-2020 15:08:26.579246,Crepes,La Chabatta,13000,5900,18900
6406,6407,21-10-2020 15:08:26.902805,Saludable,Amor Propio saludable,65000,4000,69000
6407,6408,21-10-2020 15:08:27.026494,Desayunos · Panadería,Ficchi Panadería,12500,3100,15600
6408,6409,21-10-2020 15:08:27.300074,Postres · Desayunos,Café Quindio,53900,5700,59600
6409,6410,21-10-2020 15:08:27.424138,Desayunos · Panadería,Choclofee,17800,4700,22500
6410,6411,21-10-2020 15:08:27.697635,Sánduches · Pescados y Mariscos,Pacific Comida de Mar,35000,4000,39000
6411,6412,21-10-2020 15:08:27.971496,Parrilla,El Tambor,15600,6800,22400
6412,6413,21-10-2020 15:08:28.346150,Saludable · Desayunos,Raices Bienestar Gourmet,35000,6600,41600
6413,6414,21-10-2020 15:08:28.470180,Desayunos · Café,El Gualilo,53400,6200,59600
6414,6415,21-10-2020 15:08:28.743582,Desayunos · Panadería,Santa Juana Food Bar,53900,5900,59800
6415,6416,21-10-2020 15:08:29.017445,Desayunos · Café,Libertario Coffee Roasters,53900,4600,58500
6416,6417,21-10-2020 15:08:29.290789,Postres · Desayunos,Sweet Tale,45800,5800,51600
6417,6418,21-10-2020 15:08:29.514666,Parrilla,Coquitas,23000,5600,28600
6418,6419,21-10-2020 15:08:29.638218,Desayunos · Café,Frambas,24300,3400,27700
6419,6420,21-10-2020 15:08:29.812187,Desayunos · Comida Rápida,Chocolatto,70000,3400,73400
6420,6421,21-10-2020 15:08:30.135891,Parrilla,Arepaisa de Medellín,48750,5600,54350
6421,6422,21-10-2020 15:08:30.260015,Postres · Desayunos,Restaurante Cornelia,24200,5500,29700
6422,6423,21-10-2020 15:08:30.633911,Helados,Orso To Go,48750,6800,55550
6423,6424,21-10-2020 15:08:30.908305,Parrilla,Rústico Picadería,35000,3800,38800
6424,6425,21-10-2020 15:08:31.131742,Parrilla,Coquitas,70000,5600,75600
6425,6426,21-10-2020 15:08:31.406317,Pollo · Desayunos,Candelina,53400,5300,58700
6426,6427,21-10-2020 15:08:31.529919,Sánduches · China,Peru Mix,13600,5900,19500
6427,6428,21-10-2020 15:08:31.904089,Parrilla,Campocina,24300,4600,28900
6428,6429,21-10-2020 15:08:32.127709,Sushi,Kim Pop,34500,5400,39900
6429,6430,21-10-2020 15:08:32.502023,Postres · Desayunos,Cosmo Cookies,7500,5900,13400
6430,6431,21-10-2020 15:08:32.675353,Desayunos · Panadería,Le Pain Quotidien,8900,3900,12800
6431,6432,21-10-2020 15:08:32.799125,Típica,Campo Victoria,10700,3000,13700
6432,6433,21-10-2020 15:08:32.972810,Desayunos · Internacional,Camilia,53900,3900,57800
6433,6434,21-10-2020 15:08:33.348095,Desayunos · Típica,Cochon,24300,3300,27600
6434,6435,21-10-2020 15:08:33.521923,Saludable · Desayunos,Libre de Culpa,53900,4000,57900
6435,6436,21-10-2020 15:08:33.896194,Desayunos · Típica,Alce,45800,4900,50700
6436,6437,21-10-2020 15:08:34.120048,Postres · Saludable,Ana Rebana,29500,6300,35800
6437,6438,21-10-2020 15:08:34.243998,Típica · Parrilla,Parrilla Farandula Gourmet,13600,5100,18700
6438,6439,21-10-2020 15:08:34.367390,Pollo · Desayunos,Piaf,11870,6500,18370
6439,6440,21-10-2020 15:08:34.491291,Desayunos · Café,El Gualilo,27800,6200,34000
6440,6441,21-10-2020 15:08:34.864824,Desayunos · Café,Norma's Ice Cream Café,7500,6300,13800
6441,6442,21-10-2020 15:08:35.188935,Parrilla,Arroces Maria Paula,13600,6800,20400
6442,6443,21-10-2020 15:08:35.512495,Típica · Parrilla,La Ternera Parrilla,9000,5200,14200
6443,6444,21-10-2020 15:08:35.686909,Postres · Desayunos,Buñuelos nacho,53900,6600,60500
6444,6445,21-10-2020 15:08:35.810190,Desayunos,Fratelli - Desayunos,31800,4600,36400
6445,6446,21-10-2020 15:08:36.034273,Saludable · Desayunos,Agua Dulce,65000,3700,68700
6446,6447,21-10-2020 15:08:36.357647,Saludable,Amor Propio saludable,23000,4000,27000
6447,6448,21-10-2020 15:08:36.630961,Desayunos · Típica,Rojo Gourmet,29500,4700,34200
6448,6449,21-10-2020 15:08:36.854339,Café · Helados,Sofia heladería y café,11870,5800,17670
6449,6450,21-10-2020 15:08:37.077305,Desayunos · Árabe,Boniato Sabores Vivos,12500,5300,17800
6450,6451,21-10-2020 15:08:37.250562,Helados,Buon Gelato,24200,4400,28600
6451,6452,21-10-2020 15:08:37.523695,Postres,Beiked,39700,4000,43700
6452,6453,21-10-2020 15:08:37.897486,Desayunos · Café,Moramia,24200,4700,28900
6453,6454,21-10-2020 15:08:38.170543,Típica · Parrilla,El Santandereano,15600,5200,20800
6454,6455,21-10-2020 15:08:38.343701,Desayunos,El Fogón Castellano,27800,3200,31000
6455,6456,21-10-2020 15:08:38.618037,Desayunos · Panadería,Choclofee,15000,4700,19700
6456,6457,21-10-2020 15:08:38.841246,Asiática,Thai Station,11870,6000,17870
6457,6458,21-10-2020 15:08:38.964169,Desayunos,Fratelli - Desayunos,39700,4600,44300
6458,6459,21-10-2020 15:08:39.187562,Típica · Parrilla,Toya,10700,4200,14900
6459,6460,21-10-2020 15:08:39.410693,Saludable · Desayunos,Maracuyá,35000,6700,41700
6460,6461,21-10-2020 15:08:39.784165,Saludable · Desayunos,Malú,53400,3700,57100
6461,6462,21-10-2020 15:08:40.157665,Típica · Parrilla,Mi Ranchito Parrilla,15600,4400,20000
6462,6463,21-10-2020 15:08:40.480858,Saludable · Desayunos,Bawana - Sandwich,15000,3400,18400
6463,6464,21-10-2020 15:08:40.604047,Típica,La Olla de Barro,10700,5300,16000
6464,6465,21-10-2020 15:08:40.727189,Postres · Café,Loló Coffee & Snacks,24300,4600,28900
6465,6466,21-10-2020 15:08:40.850316,Desayunos · Panadería,Choclofee,12500,4700,17200
6466,6467,21-10-2020 15:08:41.023380,Pollo · Sánduches,Pollos Century,17800,3000,20800
6467,6468,21-10-2020 15:08:41.296607,Típica · Parrilla,El Portal de la Antigua,65000,5600,70600
6468,6469,21-10-2020 15:08:41.419663,Mexicana,Cantina La 15,23000,4300,27300
6469,6470,21-10-2020 15:08:41.693011,Hamburguesas · Saludable,Restaurant Inn,34500,6100,40600
6470,6471,21-10-2020 15:08:41.816123,Típica · Parrilla,La Ternera Parrilla,31800,5200,37000
6471,6472,21-10-2020 15:08:42.139426,Postres · Desayunos,Maltihelados,35000,6200,41200
6472,6473,21-10-2020 15:08:42.312698,Desayunos · Típica,D'Porco - Lechona,23000,6300,29300
6473,6474,21-10-2020 15:08:42.535862,Hamburguesas · Desayunos,El Inglés Gastro Pub,39700,6600,46300
6474,6475,21-10-2020 15:08:42.809079,Desayunos · Típica,Fogón Sangileño,15600,5000,20600
6475,6476,21-10-2020 15:08:43.032304,Sánduches · Pescados y Mariscos,Pacific Comida de Mar,12500,4000,16500
6476,6477,21-10-2020 15:08:43.305800,Saludable · Desayunos,Libre de Culpa,18900,4000,22900
6477,6478,21-10-2020 15:08:43.529063,Parrilla,Restaurante Bar Mi Ranchito,65000,5200,70200
6478,6479,21-10-2020 15:08:43.753566,Desayunos · Jugos y Batidos,Kuriwaji,48750,6300,55050
6479,6480,21-10-2020 15:08:44.127114,Postres · Desayunos,KOKOA & co.,23000,4700,27700
6480,6481,21-10-2020 15:08:44.500780,Poke,Poke Go,34500,4600,39100
6481,6482,21-10-2020 15:08:44.624107,Desayunos · Italiana,Rceta By Rausch,17800,3600,21400
6482,6483,21-10-2020 15:08:44.997777,Sushi,Umi,23000,5600,28600
6483,6484,21-10-2020 15:08:45.171041,Parrilla,Rústico Picadería,53400,3800,57200
6484,6485,21-10-2020 15:08:45.344216,Postres,Beiked,34500,4000,38500
6485,6486,21-10-2020 15:08:45.567394,Mexicana,Hidalgo Taquería,27800,4900,32700
6486,6487,21-10-2020 15:08:45.690718,Desayunos · Panadería,Juliana Restaurante,11870,6100,17970
6487,6488,21-10-2020 15:08:45.813960,Hamburguesas,Gofi Burger,8900,5100,14000
6488,6489,21-10-2020 15:08:45.937014,Parrilla · Café,Figaro Café/ Restaurante Argentino,37900,5800,43700
6489,6490,21-10-2020 15:08:46.060513,Desayunos · Empanadas,Empanadas Doraditas.com,39700,3000,42700
6490,6491,21-10-2020 15:08:46.434213,Desayunos · Café,vereda central calle 99,65000,5700,70700
6491,6492,21-10-2020 15:08:46.607712,Desayunos · Árabe,Boniato Sabores Vivos,53400,5300,58700
6492,6493,21-10-2020 15:08:46.731053,Pollo,Heart & Cooking,11870,5000,16870
6493,6494,21-10-2020 15:08:46.904184,Típica,Cabrito Santandereano,53900,6600,60500
6494,6495,21-10-2020 15:08:47.127470,Poke,Poke Go,18900,4600,23500
6495,6496,21-10-2020 15:08:47.300710,Pizza,18 Scalini,23000,4300,27300
6496,6497,21-10-2020 15:08:47.524113,Desayunos · Comida Rápida,Chocolatto,65000,3400,68400
6497,6498,21-10-2020 15:08:47.647263,Pescados y Mariscos,La Gran Cazuela,12500,3200,15700
6498,6499,21-10-2020 15:08:47.870679,Peruana · Internacional,La Chifería,17800,6600,24400
6499,6500,21-10-2020 15:08:48.244361,Postres · Desayunos,Aury Postres - Comidas & Picadas,10700,4700,15400
6500,6501,21-10-2020 15:08:48.618124,Pollo,Heart & Cooking,53900,5000,58900
6501,6502,21-10-2020 15:08:48.741736,Saludable,MIMA,24200,3700,27900
6502,6503,21-10-2020 15:08:49.116625,Típica,Baondish,13000,5800,18800
6503,6504,21-10-2020 15:08:49.339936,Pizza,18 Scalini,24200,4300,28500
6504,6505,21-10-2020 15:08:49.663205,Típica,Cazuelitas 93,53400,3900,57300
6505,6506,21-10-2020 15:08:50.036557,Postres · Desayunos,Café Quindio,13600,5700,19300
6506,6507,21-10-2020 15:08:50.209911,Típica,Sabores De Mi Tierra,12500,5400,17900
6507,6508,21-10-2020 15:08:50.383096,Postres · Desayunos,Jacques Pastelería,17800,5900,23700
6508,6509,21-10-2020 15:08:50.506224,Postres · Café,Loló Coffee & Snacks,35000,4600,39600
6509,6510,21-10-2020 15:08:50.829500,Pollo · Saludable,Tremenda Sal y Dulce,10700,6500,17200
6510,6511,21-10-2020 15:08:51.203007,Postres · Saludable,Ana Rebana,45800,6300,52100
6511,6512,21-10-2020 15:08:51.576433,Postres,Levelma,45800,6200,52000
6512,6513,21-10-2020 15:08:51.799876,Desayunos · Internacional,Camilia,15600,3900,19500
6513,6514,21-10-2020 15:08:52.073341,Desayunos,Bagel Shop,48750,3200,51950
6514,6515,21-10-2020 15:08:52.346588,Desayunos · Típica,Fogón Sangileño,17800,5000,22800
6515,6516,21-10-2020 15:08:52.670179,Desayunos · Café,vereda central calle 99,37900,5700,43600
6516,6517,21-10-2020 15:08:52.943529,Postres,Levelma,17800,6200,24000
6517,6518,21-10-2020 15:08:53.066822,Saludable,Puro Verde,29500,5700,35200
6518,6519,21-10-2020 15:08:53.440542,Internacional,La Esquina con Sabor Parrilla,53900,3000,56900
6519,6520,21-10-2020 15:08:53.814334,Saludable · Típica,Sopas Mrg,31800,3100,34900
6520,6521,21-10-2020 15:08:53.937594,Postres,La Tertulia,23000,3400,26400
6521,6522,21-10-2020 15:08:54.162036,Asiática,Thai Station,53900,6000,59900
6522,6523,21-10-2020 15:08:54.535780,Alta Cocina · Postres,La Pinta,24300,4500,28800
6523,6524,21-10-2020 15:08:54.709422,Hamburguesas · Saludable,Restaurant Inn,11870,6100,17970
6524,6525,21-10-2020 15:08:55.033226,Parrilla · Café,Gaira Café,37900,4400,42300
6525,6526,21-10-2020 15:08:55.357372,Típica,Baondish,35000,5800,40800
6526,6527,21-10-2020 15:08:55.731217,Desayunos · Panadería,Artesanos,15600,4300,19900
6527,6528,21-10-2020 15:08:56.105080,Parrilla,Arepaisa de Medellín,39700,5600,45300
6528,6529,21-10-2020 15:08:56.429646,Desayunos · Comida Rápida,Chocolatto,18900,3400,22300
6529,6530,21-10-2020 15:08:56.603053,Postres · Desayunos,Buñuelos nacho,24200,6600,30800
6530,6531,21-10-2020 15:08:56.777385,Típica,Cazuelitas 93,8900,3900,12800
6531,6532,21-10-2020 15:08:57.150881,Desayunos · Típica,La Parrilla Dorada Polo,48750,6600,55350
6532,6533,21-10-2020 15:08:57.525215,Postres · Desayunos,BagBog Bagels,39700,6400,46100
6533,6534,21-10-2020 15:08:57.698732,Italiana,Bocatto Di Passo,13600,5000,18600
6534,6535,21-10-2020 15:08:57.922999,Parrilla · Café,Gaira Café,8900,4400,13300
6535,6536,21-10-2020 15:08:58.296605,Desayunos · Panadería,Ficchi Panadería,13600,3100,16700
6536,6537,21-10-2020 15:08:58.470683,Desayunos · Típica,Criollomania,7500,5200,12700
6537,6538,21-10-2020 15:08:58.644078,Desayunos,Fratelli - Desayunos,10700,4600,15300
6538,6539,21-10-2020 15:08:58.818181,Postres · Desayunos,Vivalight Market.,24200,6500,30700
6539,6540,21-10-2020 15:08:58.941453,Saludable,Puro Verde,13000,5700,18700
6540,6541,21-10-2020 15:08:59.215759,Postres · Helados,Mahé,18900,6000,24900
6541,6542,21-10-2020 15:08:59.589398,Típica,Carbón & Mondongos,15000,6400,21400
6542,6543,21-10-2020 15:08:59.962695,Desayunos · Típica,La Parrilla Dorada Polo,34500,6600,41100
6543,6544,21-10-2020 15:09:00.136027,Desayunos · Típica,Alce,8900,4900,13800
6544,6545,21-10-2020 15:09:00.359372,Alta Cocina · Parrilla,Criterión,10700,6000,16700
6545,6546,21-10-2020 15:09:00.732811,Saludable,A2manos,34500,4200,38700
6546,6547,21-10-2020 15:09:01.056140,Postres · Desayunos,Maltihelados,53900,6200,60100
6547,6548,21-10-2020 15:09:01.379677,Hamburguesas · Pescados y Mariscos,El Velero,9000,6500,15500
6548,6549,21-10-2020 15:09:01.603165,Saludable · Desayunos,Raices Bienestar Gourmet,18900,6600,25500
6549,6550,21-10-2020 15:09:01.776469,Desayunos · Empanadas,Mis Delicias,23000,3200,26200
6550,6551,21-10-2020 15:09:02.100090,Saludable,Puro Verde,37900,5700,43600
6551,6552,21-10-2020 15:09:02.474245,Típica,El Cucharón - Tipica,53900,4400,58300
6552,6553,21-10-2020 15:09:02.798267,Desayunos · Café,vereda central calle 99,7500,5700,13200
6553,6554,21-10-2020 15:09:03.171786,Desayunos · Sánduches,Garnish,53400,5200,58600
6554,6555,21-10-2020 15:09:03.294987,Pollo · Pescados y Mariscos,Bang Bang Rice,17800,3400,21200
6555,6556,21-10-2020 15:09:03.468367,Desayunos · Parrilla,Mi Patria,35000,4600,39600
6556,6557,21-10-2020 15:09:03.792035,Mexicana,Mexicanachos,23000,3900,26900
6557,6558,21-10-2020 15:09:03.915202,Sánduches · China,Peru Mix,35000,5900,40900
6558,6559,21-10-2020 15:09:04.289990,Desayunos,Señor Desayuno,37900,6800,44700
6559,6560,21-10-2020 15:09:04.663495,Comida Rápida · Perros Calientes,Similoa - Comida Rapida,53900,3700,57600
6560,6561,21-10-2020 15:09:04.837066,Desayunos · Café,vereda central calle 99,24300,5700,30000
6561,6562,21-10-2020 15:09:05.160532,Saludable,A2manos,24200,4200,28400
6562,6563,21-10-2020 15:09:05.484283,Pizza,18 Scalini,23000,4300,27300
6563,6564,21-10-2020 15:09:05.858097,Desayunos,Butter,35000,6700,41700
6564,6565,21-10-2020 15:09:06.231761,Desayunos · Panadería,Limarys,23000,6500,29500
6565,6566,21-10-2020 15:09:06.555330,Pizza,18 Scalini,29500,4300,33800
6566,6567,21-10-2020 15:09:06.828944,Postres,Levelma,18900,6200,25100
6567,6568,21-10-2020 15:09:07.102371,Postres · Saludable,Ana Rebana,15600,6300,21900
6568,6569,21-10-2020 15:09:07.226016,Típica,Cabrito Santandereano,53400,6600,60000
6569,6570,21-10-2020 15:09:07.499611,Pollo · Desayunos,Piaf,35000,6500,41500
6570,6571,21-10-2020 15:09:07.673205,Parrilla · Café,Figaro Café/ Restaurante Argentino,37900,5800,43700
6571,6572,21-10-2020 15:09:07.846790,Desayunos · Típica,90 Calentados,13000,3700,16700
6572,6573,21-10-2020 15:09:07.970299,Típica,Bendita S,7500,4600,12100
6573,6574,21-10-2020 15:09:08.243997,Desayunos · Sánduches,Garnish,13600,5200,18800
6574,6575,21-10-2020 15:09:08.618084,Pollo · Desayunos,Abasto,48750,3600,52350
6575,6576,21-10-2020 15:09:08.941949,Pizza,Pastas Laurentina,37900,4800,42700
6576,6577,21-10-2020 15:09:09.266255,Pollo · Saludable,Tremenda Sal y Dulce,31800,6500,38300
6577,6578,21-10-2020 15:09:09.391104,Desayunos · Panadería,Decofruta,27800,4700,32500
6578,6579,21-10-2020 15:09:09.615170,Desayunos · Panadería,Juliana Restaurante,15000,6100,21100
6579,6580,21-10-2020 15:09:09.788948,Crepes,La Chabatta,70000,5900,75900
6580,6581,21-10-2020 15:09:10.162544,Desayunos · Panadería,El Pan de Phillippe,12500,4600,17100
6581,6582,21-10-2020 15:09:10.486231,Parrilla,Antojo a Domicilio,45800,5000,50800
6582,6583,21-10-2020 15:09:10.609799,Desayunos · Café,Aromacafé el Placer de Compartir,15000,5000,20000
6583,6584,21-10-2020 15:09:10.983528,Desayunos,Bagel Shop,53400,3200,56600
6584,6585,21-10-2020 15:09:11.107121,Alta Cocina · Postres,La Pinta,34500,4500,39000
6585,6586,21-10-2020 15:09:11.380809,Desayunos · Café,Matchacha,24200,5900,30100
6586,6587,21-10-2020 15:09:11.704562,Pollo · Desayunos,Workzone,18900,3100,22000
6587,6588,21-10-2020 15:09:11.978273,Típica,La Cocina,53400,4600,58000
6588,6589,21-10-2020 15:09:12.152134,Sushi,Sushi Reel,24300,4700,29000
6589,6590,21-10-2020 15:09:12.375874,Pollo · Saludable,Tremenda Sal y Dulce,8900,6500,15400
6590,6591,21-10-2020 15:09:12.499282,Crepes,San Crepes,31800,4900,36700
6591,6592,21-10-2020 15:09:12.672867,Desayunos · Panadería,Ficchi Panadería,27800,3100,30900
6592,6593,21-10-2020 15:09:13.046616,Sushi · Asiática,Tu Sushi,10700,6400,17100
6593,6594,21-10-2020 15:09:13.220262,Saludable,Hanai - Bowls Saludables,24200,5900,30100
6594,6595,21-10-2020 15:09:13.444439,Pescados y Mariscos,La Gran Cazuela,23000,3200,26200
6595,6596,21-10-2020 15:09:13.818331,Pollo · Pescados y Mariscos,Bang Bang Rice,8900,3400,12300
6596,6597,21-10-2020 15:09:14.041977,Típica · Parrilla,Parrilla Farandula Gourmet,65000,5100,70100
6597,6598,21-10-2020 15:09:14.315395,Saludable · Desayunos,Fresh Co,53900,5600,59500
6598,6599,21-10-2020 15:09:14.640369,Hamburguesas · Saludable,Restaurant Inn,53900,6100,60000
6599,6600,21-10-2020 15:09:14.863972,Comida Rápida · Perros Calientes,Similoa - Comida Rapida,48750,3700,52450
6600,6601,21-10-2020 15:09:15.187761,Crepes,La Chabatta,29500,5900,35400
6601,6602,21-10-2020 15:09:15.361442,Postres,Toledo Pastelería,29500,6800,36300
6602,6603,21-10-2020 15:09:15.484894,Alta Cocina · Italiana,Trattoria de la Plaza,35000,6000,41000
6603,6604,21-10-2020 15:09:15.708436,Desayunos · Típica,Cochon,7500,3300,10800
6604,6605,21-10-2020 15:09:15.831799,Saludable,Puro Verde,18900,5700,24600
6605,6606,21-10-2020 15:09:16.205615,Típica · Parrilla,La Parilla de David,18900,3100,22000
6606,6607,21-10-2020 15:09:16.579364,Desayunos · Parrilla,Mi Patria,15000,4600,19600
6607,6608,21-10-2020 15:09:16.803056,Pollo,Heart & Cooking,65000,5000,70000
6608,6609,21-10-2020 15:09:17.026676,Desayunos · Típica,Rojo Gourmet,27800,4700,32500
6609,6610,21-10-2020 15:09:17.300309,Típica,El Cucharón - Tipica,18900,4400,23300
6610,6611,21-10-2020 15:09:17.423937,Hamburguesas · Desayunos,El Inglés Gastro Pub,29500,6600,36100
6611,6612,21-10-2020 15:09:17.697719,Pescados y Mariscos,Pescadero Héroes del Mar,13600,6600,20200
6612,6613,21-10-2020 15:09:17.921413,Típica,Carbón & Mondongos,35000,6400,41400
6613,6614,21-10-2020 15:09:18.295204,Desayunos · Panadería,El Pan de Phillippe,31800,4600,36400
6614,6615,21-10-2020 15:09:18.619280,Desayunos · Café,Matchacha,65000,5900,70900
6615,6616,21-10-2020 15:09:18.893054,Típica,Baondish,13000,5800,18800
6616,6617,21-10-2020 15:09:19.016678,Desayunos · Típica,Parrilla Farandula Típico,31800,5900,37700
6617,6618,21-10-2020 15:09:19.390649,Postres,La Tertulia,48750,3400,52150
6618,6619,21-10-2020 15:09:19.715611,Desayunos,Sunny Breakfast Brunch,15000,4300,19300
6619,6620,21-10-2020 15:09:19.839308,Postres · Desayunos,Buñuelos nacho,39700,6600,46300
6620,6621,21-10-2020 15:09:20.012908,Postres · Desayunos,Buñuelos nacho,24300,6600,30900
6621,6622,21-10-2020 15:09:20.136336,Sushi,Sushi Reel,70000,4700,74700
6622,6623,21-10-2020 15:09:20.460293,Pollo,Chicken House,12500,4200,16700
6623,6624,21-10-2020 15:09:20.684078,Asiática,Thai Station,8900,6000,14900
6624,6625,21-10-2020 15:09:20.907669,Típica,Salsig,53900,5600,59500
6625,6626,21-10-2020 15:09:21.081191,Postres · Desayunos,Maltihelados,24200,6200,30400
6626,6627,21-10-2020 15:09:21.455067,Pizza,Pastas Laurentina,17800,4800,22600
6627,6628,21-10-2020 15:09:21.728919,Desayunos · Panadería,Ficchi Panadería,53900,3100,57000
6628,6629,21-10-2020 15:09:22.052931,Pollo · Saludable,Gratina,37900,4200,42100
6629,6630,21-10-2020 15:09:22.326835,Saludable · Parrilla,Box,65000,3700,68700
6630,6631,21-10-2020 15:09:22.600718,Postres · Panadería,RIGHT AWAY FOODS,12500,6600,19100
6631,6632,21-10-2020 15:09:22.724204,Postres · Desayunos,La Folie - Postres,12500,3300,15800
6632,6633,21-10-2020 15:09:22.947827,Típica,Juan Chorizo,24200,3900,28100
6633,6634,21-10-2020 15:09:23.121496,Saludable · Desayunos,Copacabana Açai Bowls,9000,3000,12000
6634,6635,21-10-2020 15:09:23.345166,Parrilla · Internacional,Taperia de la Plaza,17800,5700,23500
6635,6636,21-10-2020 15:09:23.668832,Desayunos,Cafetería el Kippe,9000,3200,12200
6636,6637,21-10-2020 15:09:23.842547,Desayunos · Café,Moramia,23000,4700,27700
6637,6638,21-10-2020 15:09:24.016167,Helados,Buon Gelato,48750,4400,53150
6638,6639,21-10-2020 15:09:24.239972,Helados,Orso To Go,24200,6800,31000
6639,6640,21-10-2020 15:09:24.463890,Sushi,Sushi Reel,10700,4700,15400
6640,6641,21-10-2020 15:09:24.687630,Saludable · Desayunos,Libre de Culpa,34500,4000,38500
6641,6642,21-10-2020 15:09:24.962744,Comida Rápida · Perros Calientes,Similoa - Comida Rapida,15600,3700,19300
6642,6643,21-10-2020 15:09:25.286863,Desayunos,Jacinta Arepas de Huevo,65000,4000,69000
6643,6644,21-10-2020 15:09:25.660775,Saludable · Parrilla,Box,29500,3700,33200
6644,6645,21-10-2020 15:09:25.984432,Típica · Pescados y Mariscos,La Vitualla,17800,6300,24100
6645,6646,21-10-2020 15:09:26.108120,Típica,La Olla de Barro,15600,5300,20900
6646,6647,21-10-2020 15:09:26.431945,Parrilla · Internacional,Taperia de la Plaza,15000,5700,20700
6647,6648,21-10-2020 15:09:26.755878,Postres · Desayunos,Buñuelos nacho,23000,6600,29600
6648,6649,21-10-2020 15:09:27.130037,Pollo · Saludable,Gratina,10700,4200,14900
6649,6650,21-10-2020 15:09:27.303808,Pollo · Pescados y Mariscos,Bang Bang Rice,8900,3400,12300
6650,6651,21-10-2020 15:09:27.677714,Desayunos · Típica,Calentao Express,9000,6000,15000
6651,6652,21-10-2020 15:09:27.851354,Postres · Desayunos,KOKOA & co.,15000,4700,19700
6652,6653,21-10-2020 15:09:28.025185,Típica,Bandejas Mrg,31800,3800,35600
6653,6654,21-10-2020 15:09:28.198688,Mexicana,La leyenda mexican kitchen,53900,3200,57100
6654,6655,21-10-2020 15:09:28.322393,Postres · Desayunos,Cosmo Cookies,39700,5900,45600
6655,6656,21-10-2020 15:09:28.696364,Desayunos · Típica,D'Porco - Lechona,27800,6300,34100
6656,6657,21-10-2020 15:09:28.969993,Saludable,A2manos,39700,4200,43900
6657,6658,21-10-2020 15:09:29.343728,Desayunos · Panadería,Artesanos,24200,4300,28500
6658,6659,21-10-2020 15:09:29.617527,Pollo · Saludable,Gratina,45800,4200,50000
6659,6660,21-10-2020 15:09:29.841279,Desayunos · Típica,D´Porco,37900,3900,41800
6660,6661,21-10-2020 15:09:30.015721,Sushi · Desayunos,Maki Roll,15000,4300,19300
6661,6662,21-10-2020 15:09:30.189411,Desayunos · Panadería,Artesanos,12500,4300,16800
6662,6663,21-10-2020 15:09:30.312917,Pollo · Desayunos,Workzone,15000,3100,18100
6663,6664,21-10-2020 15:09:30.586598,Sushi · Asiática,Tu Sushi,8900,6400,15300
6664,6665,21-10-2020 15:09:30.810310,Pizza,Pastas Laurentina,13600,4800,18400
6665,6666,21-10-2020 15:09:30.933894,Desayunos · Panadería,Siena Café,65000,3700,68700
6666,6667,21-10-2020 15:09:31.057310,Típica,La Olla de Barro,9000,5300,14300
6667,6668,21-10-2020 15:09:31.381027,Café · Helados,Sofia heladería y café,23000,5800,28800
6668,6669,21-10-2020 15:09:31.655070,Desayunos · Café,Matchacha,17800,5900,23700
6669,6670,21-10-2020 15:09:31.828950,Típica,Salsig,34500,5600,40100
6670,6671,21-10-2020 15:09:32.152702,Desayunos · Internacional,Camilia,24300,3900,28200
6671,6672,21-10-2020 15:09:32.376298,Internacional,Rio Sabores y Experiencias,11870,4100,15970
6672,6673,21-10-2020 15:09:32.700354,Sushi · Asiática,Arigato,7500,5300,12800
6673,6674,21-10-2020 15:09:32.924207,Sánduches · Pescados y Mariscos,Pacific Comida de Mar,24300,4000,28300
6674,6675,21-10-2020 15:09:33.147917,Postres · Helados,Mahé,24300,6000,30300
6675,6676,21-10-2020 15:09:33.521889,Saludable · Típica,Saludable Mrg,53900,5800,59700
6676,6677,21-10-2020 15:09:33.745962,Desayunos · Panadería,Le Pain Quotidien,35000,3900,38900
6677,6678,21-10-2020 15:09:34.069946,Típica,La Herencia,11870,5900,17770
6678,6679,21-10-2020 15:09:34.193578,Desayunos · Típica,Parrilla Farandula Típico,15000,5900,20900
6679,6680,21-10-2020 15:09:34.517688,Postres,Levelma,27800,6200,34000
6680,6681,21-10-2020 15:09:34.742098,Desayunos · Típica,D'Porco - Lechona,13600,6300,19900
6681,6682,21-10-2020 15:09:35.117297,Postres · Desayunos,Gelateria Da Favola,23000,6500,29500
6682,6683,21-10-2020 15:09:35.491500,Saludable · Típica,Sopas Mrg,29500,3100,32600
6683,6684,21-10-2020 15:09:35.665609,Comida Rápida,Fiesta Digital Andrés,17800,3100,20900
6684,6685,21-10-2020 15:09:35.989627,Desayunos · Café,Aromacafé el Placer de Compartir,24300,5000,29300
6685,6686,21-10-2020 15:09:36.363831,Típica · Parrilla,La Parilla de David,13000,3100,16100
6686,6687,21-10-2020 15:09:36.687817,Desayunos,Cafetería el Kippe,18900,3200,22100
6687,6688,21-10-2020 15:09:37.012027,Mexicana,La leyenda mexican kitchen,39700,3200,42900
6688,6689,21-10-2020 15:09:37.286212,Típica,Bendita S,10700,4600,15300
6689,6690,21-10-2020 15:09:37.510334,Saludable,Amor Propio saludable,37900,4000,41900
6690,6691,21-10-2020 15:09:37.734253,Saludable · Típica,Sopas Mrg,27800,3100,30900
6691,6692,21-10-2020 15:09:37.861206,Desayunos · Típica,La Parrilla Dorada Polo,70000,6600,76600
6692,6693,21-10-2020 15:09:38.235010,Desayunos,Don Leo,29500,6000,35500
6693,6694,21-10-2020 15:09:38.458834,Parrilla,Antojo a Domicilio,13000,5000,18000
6694,6695,21-10-2020 15:09:38.632607,Pollo · Desayunos,Workzone,53400,3100,56500
6695,6696,21-10-2020 15:09:38.906429,Saludable · Desayunos,La Cesta,15000,4700,19700
6696,6697,21-10-2020 15:09:39.080007,Postres,Levelma,24200,6200,30400
6697,6698,21-10-2020 15:09:39.454052,Hamburguesas,Gofi Burger,53900,5100,59000
6698,6699,21-10-2020 15:09:39.778162,Mexicana,Hidalgo Taquería,29500,4900,34400
6699,6700,21-10-2020 15:09:40.002258,Pizza,Pastas Laurentina,53400,4800,58200
6700,6701,21-10-2020 15:09:40.177288,Postres · Desayunos,La Folie - Postres,23000,3300,26300
6701,6702,21-10-2020 15:09:40.401524,Sushi,Kim Pop,70000,5400,75400
6702,6703,21-10-2020 15:09:40.675624,Desayunos · Típica,Fogón Sangileño,39700,5000,44700
6703,6704,21-10-2020 15:09:41.049550,Saludable,Amor Propio saludable,37900,4000,41900
6704,6705,21-10-2020 15:09:41.373562,Sushi,Canoa To Go,35000,5900,40900
6705,6706,21-10-2020 15:09:41.547332,Saludable,MIMA,23000,3700,26700
6706,6707,21-10-2020 15:09:41.821027,Desayunos · Parrilla,Mi Patria,24300,4600,28900
6707,6708,21-10-2020 15:09:42.195089,Postres · Desayunos,La Folie - Postres,65000,3300,68300
6708,6709,21-10-2020 15:09:42.419265,Típica · Parrilla,El Portal de la Antigua,7500,5600,13100
6709,6710,21-10-2020 15:09:42.643355,Desayunos · Típica,Alce,24200,4900,29100
6710,6711,21-10-2020 15:09:42.917330,Crepes,La Chabatta,8900,5900,14800
6711,6712,21-10-2020 15:09:43.141326,Desayunos · Típica,Peninsula Calentados y Parrilla,35000,3400,38400
6712,6713,21-10-2020 15:09:43.465732,Sushi,Kim Pop,9000,5400,14400
6713,6714,21-10-2020 15:09:43.589495,Hamburguesas · Desayunos,El Inglés Gastro Pub,37900,6600,44500
6714,6715,21-10-2020 15:09:43.713116,Saludable,Hanai - Bowls Saludables,53400,5900,59300
6715,6716,21-10-2020 15:09:43.937024,Sushi · Asiática,Arigato,12500,5300,17800
6716,6717,21-10-2020 15:09:44.311188,Desayunos · Internacional,Camilia,7500,3900,11400
6717,6718,21-10-2020 15:09:44.435015,Hamburguesas · Saludable,Restaurant Inn,27800,6100,33900
6718,6719,21-10-2020 15:09:44.658909,Desayunos · Jugos y Batidos,Kuriwaji,53400,6300,59700
6719,6720,21-10-2020 15:09:45.032913,Saludable · Desayunos,Maracuyá,34500,6700,41200
6720,6721,21-10-2020 15:09:45.156805,Desayunos · Panadería,El Pan de Phillippe,12500,4600,17100
6721,6722,21-10-2020 15:09:45.482123,Pizza · Italiana,Piatto - Pizza,70000,6600,76600
6722,6723,21-10-2020 15:09:45.606136,Desayunos · Típica,Criollomania,70000,5200,75200
6723,6724,21-10-2020 15:09:45.880055,Pollo,Chicken House,37900,4200,42100
6724,6725,21-10-2020 15:09:46.204056,Postres · Desayunos,Maltihelados,53400,6200,59600
6725,6726,21-10-2020 15:09:46.478005,Desayunos,Butter,35000,6700,41700
6726,6727,21-10-2020 15:09:46.702120,Típica · Parrilla,Mi Ranchito Parrilla,35000,4400,39400
6727,6728,21-10-2020 15:09:46.826512,Típica · Parrilla,El Santandereano,18900,5200,24100
6728,6729,21-10-2020 15:09:47.150791,Asiática,Thai Station,53900,6000,59900
6729,6730,21-10-2020 15:09:47.474736,Saludable · Desayunos,Malú,35000,3700,38700
6730,6731,21-10-2020 15:09:47.748735,Pollo · Desayunos,Candelina,23000,5300,28300
6731,6732,21-10-2020 15:09:47.872321,Desayunos,Jacinta Arepas de Huevo,53900,4000,57900
6732,6733,21-10-2020 15:09:48.096057,Saludable · Desayunos,Guadalupe - Fruteria,10700,5900,16600
6733,6734,21-10-2020 15:09:48.319831,Postres · Desayunos,KOKOA & co.,15600,4700,20300
6734,6735,21-10-2020 15:09:48.443530,Postres · Desayunos,Sharmus,29500,6100,35600
6735,6736,21-10-2020 15:09:48.817546,Típica · Parrilla,Mi Ranchito Parrilla,48750,4400,53150
6736,6737,21-10-2020 15:09:48.941391,Parrilla · Internacional,Taperia de la Plaza,53400,5700,59100
6737,6738,21-10-2020 15:09:49.115241,Desayunos · Comida Rápida,La Veneca,15000,6300,21300
6738,6739,21-10-2020 15:09:49.439213,Hamburguesas,Bendito Cordero,53900,5800,59700
6739,6740,21-10-2020 15:09:49.663535,Pollo · China,China Tao,24300,3500,27800
6740,6741,21-10-2020 15:09:50.037500,Mexicana,La leyenda mexican kitchen,31800,3200,35000
6741,6742,21-10-2020 15:09:50.261585,Pollo · Saludable,Gratina,48750,4200,52950
6742,6743,21-10-2020 15:09:50.486640,Pizza,Pastas Laurentina,15600,4800,20400
6743,6744,21-10-2020 15:09:50.761013,Desayunos,Cafetería el Kippe,53400,3200,56600
6744,6745,21-10-2020 15:09:50.934709,Parrilla,Parrilla Pimentón,39700,3400,43100
6745,6746,21-10-2020 15:09:51.158574,Postres · Desayunos,Restaurante Cornelia,15600,5500,21100
6746,6747,21-10-2020 15:09:51.532677,Postres · Desayunos,Sharmus,53900,6100,60000
6747,6748,21-10-2020 15:09:51.856988,Saludable · Desayunos,Distrito Gourmet,18900,3700,22600
6748,6749,21-10-2020 15:09:52.181313,Parrilla · Internacional,Taperia de la Plaza,35000,5700,40700
6749,6750,21-10-2020 15:09:52.405431,Italiana,F*cking Good Pizza,48750,4200,52950
6750,6751,21-10-2020 15:09:52.529438,Típica · Parrilla,Mi Ranchito Parrilla,48750,4400,53150
6751,6752,21-10-2020 15:09:52.703564,Postres · Desayunos,Maria Luisa - Postres,12500,4300,16800
6752,6753,21-10-2020 15:09:53.028138,Hamburguesas · Alitas,Beer,13000,6600,19600
6753,6754,21-10-2020 15:09:53.202207,Pollo · Saludable,Yerbabuena,9000,3900,12900
6754,6755,21-10-2020 15:09:53.526492,Mexicana,Hidalgo Taquería,12500,4900,17400
6755,6756,21-10-2020 15:09:53.800574,Desayunos · Café,Libertario Coffee Roasters,12500,4600,17100
6756,6757,21-10-2020 15:09:53.974589,Desayunos · Sánduches,Danilo Colombia,11870,3300,15170
6757,6758,21-10-2020 15:09:54.148607,Parrilla,Campocina,13600,4600,18200
6758,6759,21-10-2020 15:09:54.322482,Parrilla,Coquitas,12500,5600,18100
6759,6760,21-10-2020 15:09:54.696575,Pollo · Saludable,Gratina,37900,4200,42100
6760,6761,21-10-2020 15:09:55.070775,Típica · Parrilla,La Ternera Parrilla,37900,5200,43100
6761,6762,21-10-2020 15:09:55.395287,Desayunos,El Corral - Desayunos,18900,5000,23900
6762,6763,21-10-2020 15:09:55.570448,Desayunos · Típica,Calentao Express,23000,6000,29000
6763,6764,21-10-2020 15:09:55.944738,Pescados y Mariscos,Pescadero Héroes del Mar,7500,6600,14100
6764,6765,21-10-2020 15:09:56.218805,Típica · Parrilla,Typykos,18900,6000,24900
6765,6766,21-10-2020 15:09:56.393046,Postres · Café,Loló Coffee & Snacks,23000,4600,27600
6766,6767,21-10-2020 15:09:56.617350,Desayunos · Típica,Criollomania,15000,5200,20200
6767,6768,21-10-2020 15:09:56.991485,Saludable · Desayunos,Básico y elemental,15000,5000,20000
6768,6769,21-10-2020 15:09:57.365670,Pollo · Sánduches,Pollos Century,35000,3000,38000
6769,6770,21-10-2020 15:09:57.539828,Mexicana,Hidalgo Taquería,9000,4900,13900
6770,6771,21-10-2020 15:09:57.713765,Postres · Desayunos,Jacques Pastelería,15000,5900,20900
6771,6772,21-10-2020 15:09:58.087867,Poke,Poke Go,17800,4600,22400
6772,6773,21-10-2020 15:09:58.362244,Parrilla,Coquitas,13600,5600,19200
6773,6774,21-10-2020 15:09:58.736358,Internacional,Rio Sabores y Experiencias,65000,4100,69100
6774,6775,21-10-2020 15:09:58.960444,Desayunos · Típica,La Frijolada,13600,4500,18100
6775,6776,21-10-2020 15:09:59.184542,Desayunos · Sánduches,Danilo Colombia,35000,3300,38300
6776,6777,21-10-2020 15:09:59.458847,Saludable · Desayunos,Agua Dulce,11870,3700,15570
6777,6778,21-10-2020 15:09:59.783126,Desayunos · Sánduches,Frutos del Bosque,10700,3500,14200
6778,6779,21-10-2020 15:09:59.957348,Saludable · Desayunos,Básico y elemental,9000,5000,14000
6779,6780,21-10-2020 15:10:00.281644,Saludable · Parrilla,The Angels Grill and Drinks,35000,6200,41200
6780,6781,21-10-2020 15:10:00.606997,Postres · Desayunos,BagBog Bagels,45800,6400,52200
6781,6782,21-10-2020 15:10:00.981648,Desayunos,La Frijolada Desayunos,48750,4400,53150
6782,6783,21-10-2020 15:10:01.205777,Postres · Helados,Mahé,18900,6000,24900
6783,6784,21-10-2020 15:10:01.479924,Saludable,MIMA,13000,3700,16700
6784,6785,21-10-2020 15:10:01.854417,Típica,La Herencia,7500,5900,13400
6785,6786,21-10-2020 15:10:02.229063,Típica,Sabrosito,15000,4000,19000
6786,6787,21-10-2020 15:10:02.503283,Desayunos · Café,vereda central calle 99,31800,5700,37500
6787,6788,21-10-2020 15:10:02.827645,Desayunos · Helados,San Giorgio Gelateria,35000,3100,38100
6788,6789,21-10-2020 15:10:03.152000,Típica,Salsig,45800,5600,51400
6789,6790,21-10-2020 15:10:03.276087,Típica,Sabrosito,29500,4000,33500
6790,6791,21-10-2020 15:10:03.550285,Desayunos · Típica,Casa Vieja,35000,6000,41000
6791,6792,21-10-2020 15:10:03.774511,Desayunos,Bagel Shop,15600,3200,18800
6792,6793,21-10-2020 15:10:04.098621,Desayunos · Comida Rápida,Chocolatto,24300,3400,27700
6793,6794,21-10-2020 15:10:04.272607,Desayunos · Sánduches,Frutos del Bosque,29500,3500,33000
6794,6795,21-10-2020 15:10:04.496581,Postres · Café,Celestino Café,39700,5900,45600
6795,6796,21-10-2020 15:10:04.670691,Desayunos · Italiana,Rceta By Rausch,18900,3600,22500
6796,6797,21-10-2020 15:10:04.794778,Pizza,Pizza Andante,31800,6300,38100
6797,6798,21-10-2020 15:10:05.068944,Pollo · Saludable,Yerbabuena,53900,3900,57800
6798,6799,21-10-2020 15:10:05.443321,Saludable · Desayunos,Distrito Gourmet,17800,3700,21500
6799,6800,21-10-2020 15:10:05.718874,Hamburguesas · Desayunos,El Inglés Gastro Pub,9000,6600,15600
6800,6801,21-10-2020 15:10:05.842951,Típica,El Cucharón - Tipica,15000,4400,19400
6801,6802,21-10-2020 15:10:06.067097,Postres · Desayunos,Café Quindio,10700,5700,16400
6802,6803,21-10-2020 15:10:06.191449,Pizza,Pizza Andante,24300,6300,30600
6803,6804,21-10-2020 15:10:06.315473,Desayunos,Bagel Shop,27800,3200,31000
6804,6805,21-10-2020 15:10:06.589706,Típica,Cazuelitas 93,35000,3900,38900
6805,6806,21-10-2020 15:10:06.963815,Desayunos · Típica,Calentao Express,15600,6000,21600
6806,6807,21-10-2020 15:10:07.238125,Postres,Beiked,23000,4000,27000
6807,6808,21-10-2020 15:10:07.412281,Saludable · Parrilla,Box,53400,3700,57100
6808,6809,21-10-2020 15:10:07.686648,Desayunos · Comida Rápida,Chocolatto,18900,3400,22300
6809,6810,21-10-2020 15:10:07.910961,Postres · Desayunos,Amelie Helados,53900,6400,60300
6810,6811,21-10-2020 15:10:08.084967,Pollo · Desayunos,Caserito Gourmet,12500,6700,19200
6811,6812,21-10-2020 15:10:08.309109,Postres · Desayunos,Gelateria Da Favola,34500,6500,41000
6812,6813,21-10-2020 15:10:08.633660,Postres · Desayunos,KOKOA & co.,34500,4700,39200
6813,6814,21-10-2020 15:10:08.958417,Sushi,Sushi Reel,24200,4700,28900
6814,6815,21-10-2020 15:10:09.182997,Típica,Sopitas y Más,23000,4200,27200
6815,6816,21-10-2020 15:10:09.557705,Desayunos · Típica,Cochon,15000,3300,18300
6816,6817,21-10-2020 15:10:09.681741,Postres · Desayunos,Café Quindio,13000,5700,18700
6817,6818,21-10-2020 15:10:09.956118,Peruana,Masivo,24200,5800,30000
6818,6819,21-10-2020 15:10:10.230642,Pollo · Desayunos,Candelina,37900,5300,43200
6819,6820,21-10-2020 15:10:10.554985,Desayunos,Desayunos en Bogotá,27800,3400,31200
6820,6821,21-10-2020 15:10:10.780444,Alta Cocina · Italiana,Trattoria de la Plaza,15000,6000,21000
6821,6822,21-10-2020 15:10:11.004522,Desayunos · Panadería,Ficchi Panadería,27800,3100,30900
6822,6823,21-10-2020 15:10:11.128737,Saludable · Desayunos,Maracuyá,23000,6700,29700
6823,6824,21-10-2020 15:10:11.252809,Desayunos · Comida Rápida,La Veneca,7500,6300,13800
6824,6825,21-10-2020 15:10:11.627329,Postres · Café,Loló Coffee & Snacks,53900,4600,58500
6825,6826,21-10-2020 15:10:11.901757,Postres · Desayunos,Sharmus,31800,6100,37900
6826,6827,21-10-2020 15:10:12.276164,Parrilla,Rústico Picadería,48750,3800,52550
6827,6828,21-10-2020 15:10:12.450741,Desayunos · Panadería,Le Pain Quotidien,39700,3900,43600
6828,6829,21-10-2020 15:10:12.574797,Pollo,Heart & Cooking,45800,5000,50800
6829,6830,21-10-2020 15:10:12.698973,Saludable · Desayunos,Básico y elemental,17800,5000,22800
6830,6831,21-10-2020 15:10:13.073324,Postres · Desayunos,Maltihelados,53900,6200,60100
6831,6832,21-10-2020 15:10:13.397723,Parrilla,Coquitas,35000,5600,40600
6832,6833,21-10-2020 15:10:13.722229,Pollo · Desayunos,Piaf,23000,6500,29500
6833,6834,21-10-2020 15:10:13.846263,Desayunos,La Frijolada Desayunos,70000,4400,74400
6834,6835,21-10-2020 15:10:14.170608,Saludable,Ventura Soup y Salad,34500,3800,38300
6835,6836,21-10-2020 15:10:14.444957,Saludable · Parrilla,Box,15600,3700,19300
6836,6837,21-10-2020 15:10:14.568940,Desayunos · Árabe,Boniato Sabores Vivos,35000,5300,40300
6837,6838,21-10-2020 15:10:14.793025,Típica,Campo Victoria,23000,3000,26000
6838,6839,21-10-2020 15:10:14.967068,Desayunos · Panadería,Pasteleite,18900,5900,24800
6839,6840,21-10-2020 15:10:15.341326,Comida Rápida · Perros Calientes,Similoa - Comida Rapida,31800,3700,35500
6840,6841,21-10-2020 15:10:15.515274,Postres · Desayunos,Sharmus,9000,6100,15100
6841,6842,21-10-2020 15:10:15.639471,Pollo,Heart & Cooking,29500,5000,34500
6842,6843,21-10-2020 15:10:15.915067,Desayunos · Panadería,Ficchi Panadería,53400,3100,56500
6843,6844,21-10-2020 15:10:16.289552,Postres · Desayunos,Aury Postres - Comidas & Picadas,53900,4700,58600
6844,6845,21-10-2020 15:10:16.664014,Saludable · Desayunos,Bawana - Sandwich,27800,3400,31200
6845,6846,21-10-2020 15:10:16.888235,Pizza,Pizza Andante,37900,6300,44200
6846,6847,21-10-2020 15:10:17.062621,Crepes,La Chabatta,24200,5900,30100
6847,6848,21-10-2020 15:10:17.287000,Desayunos · Parrilla,Mi Patria,48750,4600,53350
6848,6849,21-10-2020 15:10:17.661490,Pescados y Mariscos,La Gran Cazuela,15000,3200,18200
6849,6850,21-10-2020 15:10:18.035969,Saludable · Desayunos,La Cesta,53400,4700,58100
6850,6851,21-10-2020 15:10:18.411242,Típica,Cabrito Santandereano,18900,6600,25500
6851,6852,21-10-2020 15:10:18.685727,Hamburguesas · Alitas,Beer,15600,6600,22200
6852,6853,21-10-2020 15:10:18.809799,Desayunos · Panadería,Artesanos,13000,4300,17300
6853,6854,21-10-2020 15:10:19.033997,Saludable,Hanai - Bowls Saludables,15000,5900,20900
6854,6855,21-10-2020 15:10:19.408890,Postres · Desayunos,La Folie - Postres,31800,3300,35100
6855,6856,21-10-2020 15:10:19.733347,Parrilla,Antojo a Domicilio,35000,5000,40000
6856,6857,21-10-2020 15:10:20.057712,Saludable · Típica,Saludable Mrg,39700,5800,45500
6857,6858,21-10-2020 15:10:20.432067,Saludable · Desayunos,Guadalupe - Fruteria,45800,5900,51700
6858,6859,21-10-2020 15:10:20.606353,Típica,Cazuelitas 93,23000,3900,26900
6859,6860,21-10-2020 15:10:20.780647,Pollo · Desayunos,Workzone,70000,3100,73100
6860,6861,21-10-2020 15:10:21.005884,Saludable,A2manos,12500,4200,16700
6861,6862,21-10-2020 15:10:21.380261,Desayunos · Panadería,Siena Café,53900,3700,57600
6862,6863,21-10-2020 15:10:21.654723,Pescados y Mariscos,Pescadero Héroes del Mar,70000,6600,76600
6863,6864,21-10-2020 15:10:21.979200,China,China Food Col,7500,3600,11100
6864,6865,21-10-2020 15:10:22.153565,Saludable · Típica,Sopas Mrg,35000,3100,38100
6865,6866,21-10-2020 15:10:22.327838,Alta Cocina · Italiana,Trattoria de la Plaza,24300,6000,30300
6866,6867,21-10-2020 15:10:22.652480,Desayunos · Típica,Calentao Express,24300,6000,30300
6867,6868,21-10-2020 15:10:22.776733,Sánduches · China,Peru Mix,31800,5900,37700
6868,6869,21-10-2020 15:10:23.151161,Típica,Lo Nuestro,35000,3100,38100
6869,6870,21-10-2020 15:10:23.325327,Desayunos · Típica,90 Calentados,10700,3700,14400
6870,6871,21-10-2020 15:10:23.549463,Desayunos · Empanadas,Mis Delicias,35000,3200,38200
6871,6872,21-10-2020 15:10:23.673745,Parrilla,Beraca Parrilla Bbq,12500,5600,18100
6872,6873,21-10-2020 15:10:23.848072,Alta Cocina · Italiana,Trattoria de la Plaza,45800,6000,51800
6873,6874,21-10-2020 15:10:24.072460,Pescados y Mariscos,La Gran Cazuela,8900,3200,12100
6874,6875,21-10-2020 15:10:24.397326,Desayunos · Jugos y Batidos,Kuriwaji,45800,6300,52100
6875,6876,21-10-2020 15:10:24.521809,Desayunos · Típica,Alce,18900,4900,23800
6876,6877,21-10-2020 15:10:24.646030,Postres,Beiked,35000,4000,39000
6877,6878,21-10-2020 15:10:24.970493,Desayunos · Sánduches,Danilo Colombia,11870,3300,15170
6878,6879,21-10-2020 15:10:25.094721,Postres · Desayunos,Maltihelado,18900,4500,23400
6879,6880,21-10-2020 15:10:25.269695,Parrilla · Internacional,Taperia de la Plaza,10700,5700,16400
6880,6881,21-10-2020 15:10:25.594349,Desayunos · Típica,La Frijolada,65000,4500,69500
6881,6882,21-10-2020 15:10:25.868861,Postres · Desayunos,BagBog Bagels,23000,6400,29400
6882,6883,21-10-2020 15:10:25.993477,Postres · Panadería,RIGHT AWAY FOODS,15600,6600,22200
6883,6884,21-10-2020 15:10:26.317955,Desayunos · Panadería,Decofruta,23000,4700,27700
6884,6885,21-10-2020 15:10:26.442231,Crepes,San Crepes,29500,4900,34400
6885,6886,21-10-2020 15:10:26.816896,Desayunos · Panadería,Limarys,15600,6500,22100
6886,6887,21-10-2020 15:10:27.191487,Parrilla,Beraca Parrilla Bbq,15600,5600,21200
6887,6888,21-10-2020 15:10:27.516134,Sánduches · Pescados y Mariscos,Pacific Comida de Mar,23000,4000,27000
6888,6889,21-10-2020 15:10:27.890545,Típica,Sabores De Mi Tierra,53900,5400,59300
6889,6890,21-10-2020 15:10:28.115040,Desayunos · Típica,Calentao Express,11870,6000,17870
6890,6891,21-10-2020 15:10:28.389740,Postres · Café,Loló Coffee & Snacks,23000,4600,27600
6891,6892,21-10-2020 15:10:28.614329,Típica,La Herencia,53400,5900,59300
6892,6893,21-10-2020 15:10:28.938775,Desayunos · Empanadas,Empanadas Doraditas.com,35000,3000,38000
6893,6894,21-10-2020 15:10:29.213192,Parrilla,Campocina,23000,4600,27600
6894,6895,21-10-2020 15:10:29.437795,Típica,Cazuelitas 93,23000,3900,26900
6895,6896,21-10-2020 15:10:29.762400,Desayunos · Panadería,Choclofee,31800,4700,36500
6896,6897,21-10-2020 15:10:30.036687,Postres · Desayunos,Amelie Helados,31800,6400,38200
6897,6898,21-10-2020 15:10:30.261056,Desayunos · Café,Frambas,31800,3400,35200
6898,6899,21-10-2020 15:10:30.635573,Desayunos · Café,Aromacafé el Placer de Compartir,39700,5000,44700
6899,6900,21-10-2020 15:10:30.809920,Helados,Orso To Go,45800,6800,52600
6900,6901,21-10-2020 15:10:31.084146,Desayunos · Panadería,Artesanos,13600,4300,17900
6901,6902,21-10-2020 15:10:31.209015,Desayunos · Café,vereda central calle 99,18900,5700,24600
6902,6903,21-10-2020 15:10:31.584819,Típica,Baondish,18900,5800,24700
6903,6904,21-10-2020 15:10:31.709211,Desayunos,El Corral - Desayunos,53400,5000,58400
6904,6905,21-10-2020 15:10:31.933650,Desayunos,Bagel Shop,11870,3200,15070
6905,6906,21-10-2020 15:10:32.158159,Desayunos · Italiana,Rceta By Rausch,35000,3600,38600
6906,6907,21-10-2020 15:10:32.533006,Saludable · Desayunos,Copacabana Açai Bowls,18900,3000,21900
6907,6908,21-10-2020 15:10:32.807660,Saludable,Amor Propio saludable,48750,4000,52750
6908,6909,21-10-2020 15:10:33.032115,Desayunos · Panadería,Choclofee,37900,4700,42600
6909,6910,21-10-2020 15:10:33.156760,Típica · Parrilla,El Portal de la Antigua,9000,5600,14600
6910,6911,21-10-2020 15:10:33.431912,Desayunos · Café,Moramia,24300,4700,29000
6911,6912,21-10-2020 15:10:33.656561,Asiática,TeT,8900,5900,14800
6912,6913,21-10-2020 15:10:33.780805,Desayunos · Panadería,Artesanos,9000,4300,13300
6913,6914,21-10-2020 15:10:34.005459,Desayunos · Mexicana,La Mera Mera - Mexicana,53900,3100,57000
6914,6915,21-10-2020 15:10:34.280225,Saludable · Parrilla,The Angels Grill and Drinks,29500,6200,35700
6915,6916,21-10-2020 15:10:34.555217,Típica · Parrilla,Toya,34500,4200,38700
6916,6917,21-10-2020 15:10:34.730008,Desayunos,Jacinta Arepas de Huevo,48750,4000,52750
6917,6918,21-10-2020 15:10:35.105006,Parrilla · Internacional,Taperia de la Plaza,35000,5700,40700
6918,6919,21-10-2020 15:10:35.429732,Desayunos,Don Leo,18900,6000,24900
6919,6920,21-10-2020 15:10:35.554320,Desayunos,Desayunos en Bogotá,48750,3400,52150
6920,6921,21-10-2020 15:10:35.678744,Parrilla,Arepaisa de Medellín,27800,5600,33400
6921,6922,21-10-2020 15:10:36.053459,Desayunos · Típica,Desayunadero de la 42,53900,5900,59800
6922,6923,21-10-2020 15:10:36.277991,Desayunos · Helados,San Giorgio Gelateria,13600,3100,16700
6923,6924,21-10-2020 15:10:36.402721,Saludable,Amor Propio saludable,9000,4000,13000
6924,6925,21-10-2020 15:10:36.628457,Parrilla,Rústico Picadería,35000,3800,38800
6925,6926,21-10-2020 15:10:36.953632,Desayunos,Sunny Breakfast Brunch,48750,4300,53050
6926,6927,21-10-2020 15:10:37.278288,Saludable,MIMA,35000,3700,38700
6927,6928,21-10-2020 15:10:37.603129,Saludable,A2manos,8900,4200,13100
6928,6929,21-10-2020 15:10:37.927763,Postres,La Tertulia,15000,3400,18400
6929,6930,21-10-2020 15:10:38.152342,Alta Cocina · Postres,La Pinta,13600,4500,18100
6930,6931,21-10-2020 15:10:38.326629,Desayunos · Típica,Criollomania,48750,5200,53950
6931,6932,21-10-2020 15:10:38.501074,Desayunos · Típica,Alce,39700,4900,44600
6932,6933,21-10-2020 15:10:38.825636,Desayunos · Helados,San Giorgio Gelateria,48750,3100,51850
6933,6934,21-10-2020 15:10:39.200298,Alta Cocina · Postres,La Pinta,35000,4500,39500
6934,6935,21-10-2020 15:10:39.525037,Peruana,Uma Cantina Peruana,31800,3200,35000
6935,6936,21-10-2020 15:10:39.699370,Helados,Buon Gelato,13000,4400,17400
6936,6937,21-10-2020 15:10:39.973817,Pollo · Típica,Auyama,35000,3900,38900
6937,6938,21-10-2020 15:10:40.098098,Desayunos · Panadería,Juliana Restaurante,8900,6100,15000
6938,6939,21-10-2020 15:10:40.222789,Desayunos,El Fogón Castellano,23000,3200,26200
6939,6940,21-10-2020 15:10:40.498008,Parrilla,Campocina,12500,4600,17100
6940,6941,21-10-2020 15:10:40.822648,Mexicana,Mexicanachos,53900,3900,57800
6941,6942,21-10-2020 15:10:40.947071,Desayunos · Comida Rápida,La Veneca,45800,6300,52100
6942,6943,21-10-2020 15:10:41.221798,Desayunos · Típica,D´Porco,35000,3900,38900
6943,6944,21-10-2020 15:10:41.546409,Hamburguesas · Alitas,Beer,11870,6600,18470
6944,6945,21-10-2020 15:10:41.672014,Postres · Desayunos,BagBog Bagels,11870,6400,18270
6945,6946,21-10-2020 15:10:41.846511,Saludable,Puro Verde,27800,5700,33500
6946,6947,21-10-2020 15:10:42.221246,Parrilla,El Tambor,34500,6800,41300
6947,6948,21-10-2020 15:10:42.545763,Típica · Parrilla,Mi Ranchito Parrilla,70000,4400,74400
6948,6949,21-10-2020 15:10:42.870385,Pizza · Parrilla,Urban Lunch,13600,4000,17600
6949,6950,21-10-2020 15:10:43.245617,Parrilla,Rústico Picadería,10700,3800,14500
6950,6951,21-10-2020 15:10:43.520715,Pollo · Desayunos,Caserito Gourmet,24300,6700,31000
6951,6952,21-10-2020 15:10:43.895818,Desayunos,El Corral - Desayunos,24300,5000,29300
6952,6953,21-10-2020 15:10:44.070412,Saludable · Jugos y Batidos,Berdes Drinks & Salads,31800,3500,35300
6953,6954,21-10-2020 15:10:44.194831,Asiática,TeT,15000,5900,20900
6954,6955,21-10-2020 15:10:44.469528,Desayunos · Sánduches,Garnish,48750,5200,53950
6955,6956,21-10-2020 15:10:44.693943,Pollo · Típica,Auyama,13000,3900,16900
6956,6957,21-10-2020 15:10:45.018371,Postres · Desayunos,Vivalight Market.,8900,6500,15400
6957,6958,21-10-2020 15:10:45.343239,Alta Cocina · Italiana,Trattoria de la Plaza,24200,6000,30200
6958,6959,21-10-2020 15:10:45.668228,Pollo · Pescados y Mariscos,Bang Bang Rice,31800,3400,35200
6959,6960,21-10-2020 15:10:46.042995,Sushi,Umi,70000,5600,75600
6960,6961,21-10-2020 15:10:46.418159,Típica,Bandejas Mrg,27800,3800,31600
6961,6962,21-10-2020 15:10:46.592788,Típica,Sopitas y Más,13000,4200,17200
6962,6963,21-10-2020 15:10:46.918535,Italiana,Bocatto Di Passo,15000,5000,20000
6963,6964,21-10-2020 15:10:47.143057,Pizza,pizza andante,23000,4200,27200
6964,6965,21-10-2020 15:10:47.267468,Internacional,La Esquina con Sabor Parrilla,15000,3000,18000
6965,6966,21-10-2020 15:10:47.592268,Pizza · Italiana,Pisapore - Pizza,65000,6600,71600
6966,6967,21-10-2020 15:10:47.866999,Postres · Panadería,RIGHT AWAY FOODS,27800,6600,34400
6967,6968,21-10-2020 15:10:48.091815,Desayunos · Típica,Alce,13600,4900,18500
6968,6969,21-10-2020 15:10:48.266402,Desayunos · Típica,Papadió - Colombianas,34500,5700,40200
6969,6970,21-10-2020 15:10:48.641449,Postres · Desayunos,KOKOA & co.,53900,4700,58600
6970,6971,21-10-2020 15:10:48.766076,Crepes,San Crepes,7500,4900,12400
6971,6972,21-10-2020 15:10:48.990466,Postres,La Galeta,31800,3000,34800
6972,6973,21-10-2020 15:10:49.165214,Saludable,Hanai - Bowls Saludables,13000,5900,18900
6973,6974,21-10-2020 15:10:49.540173,Saludable,Puro Verde,24200,5700,29900
6974,6975,21-10-2020 15:10:49.665392,Saludable · Desayunos,Básico y Elemental,29500,5900,35400
6975,6976,21-10-2020 15:10:50.040536,Postres · Desayunos,Restaurante Cornelia,9000,5500,14500
6976,6977,21-10-2020 15:10:50.416156,Sánduches · Pescados y Mariscos,Pacific Comida de Mar,13600,4000,17600
6977,6978,21-10-2020 15:10:50.741296,Pollo,Heart & Cooking,37900,5000,42900
6978,6979,21-10-2020 15:10:51.016746,Parrilla,Antojo a Domicilio,53900,5000,58900
6979,6980,21-10-2020 15:10:51.191771,Desayunos,Bagel Shop,10700,3200,13900
6980,6981,21-10-2020 15:10:51.317684,Postres · Desayunos,Aury Postres - Comidas & Picadas,24300,4700,29000
6981,6982,21-10-2020 15:10:51.693011,Típica,Baondish,53400,5800,59200
6982,6983,21-10-2020 15:10:52.068739,Saludable · Desayunos,Raices Bienestar Gourmet,65000,6600,71600
6983,6984,21-10-2020 15:10:52.294577,Saludable · Jugos y Batidos,Berdes Drinks & Salads,34500,3500,38000
6984,6985,21-10-2020 15:10:52.420659,Postres · Desayunos,Amelie Helados,27800,6400,34200
6985,6986,21-10-2020 15:10:52.596202,Postres · Panadería,RIGHT AWAY FOODS,23000,6600,29600
6986,6987,21-10-2020 15:10:52.772329,Pollo · Sánduches,Pollos Century,23000,3000,26000
6987,6988,21-10-2020 15:10:53.047978,Postres · Desayunos,Maltihelados,8900,6200,15100
6988,6989,21-10-2020 15:10:53.224087,Desayunos,El Fogón Castellano,24300,3200,27500
6989,6990,21-10-2020 15:10:53.599905,Pescados y Mariscos,Pescadero Héroes del Mar,23000,6600,29600
6990,6991,21-10-2020 15:10:53.725856,Pollo,Señor Fantástico,39700,4700,44400
6991,6992,21-10-2020 15:10:54.051523,Desayunos · Café,Matchacha,34500,5900,40400
6992,6993,21-10-2020 15:10:54.227688,Saludable,The Good Rice Bowls,24300,3500,27800
6993,6994,21-10-2020 15:10:54.403728,Desayunos,Bagel Shop,35000,3200,38200
6994,6995,21-10-2020 15:10:54.730329,Postres · Desayunos,BagBog Bagels,53900,6400,60300
6995,6996,21-10-2020 15:10:54.905340,Postres · Desayunos,Aury Postres - Comidas & Picadas,48750,4700,53450
6996,6997,21-10-2020 15:10:55.281652,Desayunos,Archies Desayunos,7500,3100,10600
6997,6998,21-10-2020 15:10:55.456777,Hamburguesas,Monchis - Hamburguesa,37900,4300,42200
6998,6999,21-10-2020 15:10:55.783008,Desayunos,Cafetería el Kippe,15600,3200,18800
6999,7000,21-10-2020 15:10:56.108045,Peruana,Uma Cantina Peruana,15000,3200,18200
7000,7001,21-10-2020 15:10:56.284210,Desayunos · Empanadas,Empanadas Doraditas.com,9000,3000,12000
7001,7002,21-10-2020 15:10:56.509532,Desayunos · Típica,La Frijolada,45800,4500,50300
7002,7003,21-10-2020 15:10:56.886088,Italiana,Bocatto Di Passo,37900,5000,42900
7003,7004,21-10-2020 15:10:57.112650,Desayunos · Sánduches,Garnish,53900,5200,59100
7004,7005,21-10-2020 15:10:57.239395,Típica,Bendita S,37900,4600,42500
7005,7006,21-10-2020 15:10:57.364563,Pizza,Pizza Andante,15600,6300,21900
7006,7007,21-10-2020 15:10:57.490734,Desayunos · Helados,San Giorgio Gelateria,8900,3100,12000
7007,7008,21-10-2020 15:10:57.715526,Saludable · Desayunos,Bawana - Sandwich,18900,3400,22300
7008,7009,21-10-2020 15:10:57.940863,Desayunos · Panadería,El Pan de Phillippe,8900,4600,13500
7009,7010,21-10-2020 15:10:58.266027,Crepes,San Crepes,13600,4900,18500
7010,7011,21-10-2020 15:10:58.441486,Típica,Cabrito Santandereano,24200,6600,30800
7011,7012,21-10-2020 15:10:58.616581,Desayunos · Pescados y Mariscos,Luzí­a - Mediterranea,11870,5700,17570
7012,7013,21-10-2020 15:10:58.742160,Desayunos · Árabe,Boniato Sabores Vivos,35000,5300,40300
7013,7014,21-10-2020 15:10:58.866938,Postres · Desayunos,Restaurante Cornelia,11870,5500,17370
7014,7015,21-10-2020 15:10:59.192735,Desayunos · Típica,Parrilla Farandula Típico,45800,5900,51700
7015,7016,21-10-2020 15:10:59.367619,Típica,Baondish,39700,5800,45500
7016,7017,21-10-2020 15:10:59.643189,Desayunos · Café,Libertario Coffee Roasters,48750,4600,53350
7017,7018,21-10-2020 15:10:59.868195,Desayunos,Desayunos en Bogotá,48750,3400,52150
7018,7019,21-10-2020 15:11:00.043750,Desayunos · Helados,San Giorgio Gelateria,23000,3100,26100
7019,7020,21-10-2020 15:11:00.168608,Hamburguesas · Desayunos,El Inglés Gastro Pub,45800,6600,52400
7020,7021,21-10-2020 15:11:00.294116,Mexicana,Mexicanachos,37900,3900,41800
7021,7022,21-10-2020 15:11:00.419205,Postres · Panadería,RIGHT AWAY FOODS,27800,6600,34400
7022,7023,21-10-2020 15:11:00.694784,Sánduches · China,Peru Mix,35000,5900,40900
7023,7024,21-10-2020 15:11:00.969801,Desayunos · Típica,Alce,23000,4900,27900
7024,7025,21-10-2020 15:11:01.295493,Pizza · Italiana,Piatto - Pizza,37900,6600,44500
7025,7026,21-10-2020 15:11:01.620860,Típica · Parrilla,Mi Ranchito Parrilla,7500,4400,11900
7026,7027,21-10-2020 15:11:01.946817,Postres · Desayunos,Restaurante Cornelia,35000,5500,40500
7027,7028,21-10-2020 15:11:02.273294,Pollo,Chicken House,35000,4200,39200
7028,7029,21-10-2020 15:11:02.649542,Parrilla,Carnes la Zarza,8900,4900,13800
7029,7030,21-10-2020 15:11:02.974617,Desayunos,Butter,39700,6700,46400
7030,7031,21-10-2020 15:11:03.250274,Típica,Cazuelitas 93,53400,3900,57300
7031,7032,21-10-2020 15:11:03.525444,Pollo,Oliva Va,23000,5600,28600
7032,7033,21-10-2020 15:11:03.800911,Desayunos · Empanadas,Empanadas Doraditas.com,13600,3000,16600
7033,7034,21-10-2020 15:11:04.025963,Parrilla,Carnes la Zarza,39700,4900,44600
7034,7035,21-10-2020 15:11:04.151512,Pollo · Saludable,Yerbabuena,24200,3900,28100
7035,7036,21-10-2020 15:11:04.476655,Desayunos · Jugos y Batidos,Kuriwaji,23000,6300,29300
7036,7037,21-10-2020 15:11:04.852335,Postres · Desayunos,Cosmo Cookies,8900,5900,14800
7037,7038,21-10-2020 15:11:05.177777,Típica,El Mondongo y Mucho Mas,29500,5600,35100
7038,7039,21-10-2020 15:11:05.453575,Saludable · Parrilla,The Angels Grill and Drinks,53900,6200,60100
7039,7040,21-10-2020 15:11:05.678703,Pollo · Saludable,Yerbabuena,15600,3900,19500
7040,7041,21-10-2020 15:11:05.954495,Desayunos · Jugos y Batidos,Kuriwaji,13600,6300,19900
7041,7042,21-10-2020 15:11:06.179990,Desayunos · Jugos y Batidos,Kuriwaji,70000,6300,76300
7042,7043,21-10-2020 15:11:06.406114,Desayunos · Italiana,Rceta By Rausch,13000,3600,16600
7043,7044,21-10-2020 15:11:06.631183,Saludable · Parrilla,The Angels Grill and Drinks,12500,6200,18700
7044,7045,21-10-2020 15:11:06.807276,Desayunos · Típica,Calentao Express,37900,6000,43900
7045,7046,21-10-2020 15:11:07.032567,Parrilla,Antojo a Domicilio,18900,5000,23900
7046,7047,21-10-2020 15:11:07.258244,Desayunos · Típica,Peninsula Calentados y Parrilla,23000,3400,26400
7047,7048,21-10-2020 15:11:07.534521,Desayunos · Comida Rápida,Chocolatto,13000,3400,16400
7048,7049,21-10-2020 15:11:07.860201,Desayunos · Panadería,Artesanos,34500,4300,38800
7049,7050,21-10-2020 15:11:08.185587,Hamburguesas · Alitas,Beer,15000,6600,21600
7050,7051,21-10-2020 15:11:08.311421,Saludable · Desayunos,Agua Dulce,35000,3700,38700
7051,7052,21-10-2020 15:11:08.637268,Típica · Pescados y Mariscos,La Vitualla,13000,6300,19300
7052,7053,21-10-2020 15:11:08.963357,Típica,La Cocina,17800,4600,22400
7053,7054,21-10-2020 15:11:09.338466,Típica,Salsig,34500,5600,40100
7054,7055,21-10-2020 15:11:09.714614,Sushi,Sushi Reel,8900,4700,13600
7055,7056,21-10-2020 15:11:09.989934,Asiática,TeT,45800,5900,51700
7056,7057,21-10-2020 15:11:10.215843,Postres · Desayunos,Gelateria Da Favola,70000,6500,76500
7057,7058,21-10-2020 15:11:10.491398,Postres,La Tertulia,39700,3400,43100
7058,7059,21-10-2020 15:11:10.617313,Desayunos,Fratelli - Desayunos,35000,4600,39600
7059,7060,21-10-2020 15:11:10.792416,Saludable · Desayunos,Distrito Gourmet,7500,3700,11200
7060,7061,21-10-2020 15:11:11.017969,Típica,La Cocina,8900,4600,13500
7061,7062,21-10-2020 15:11:11.343070,Panadería,Boul,23000,3100,26100
7062,7063,21-10-2020 15:11:11.718960,Hamburguesas,Monchis - Hamburguesa,45800,4300,50100
7063,7064,21-10-2020 15:11:11.994078,Desayunos · Típica,Papadió - Colombianas,9000,5700,14700
7064,7065,21-10-2020 15:11:12.269681,Parrilla · Café,Gaira Café,34500,4400,38900
7065,7066,21-10-2020 15:11:12.596099,Saludable · Desayunos,Maracuyá,17800,6700,24500
7066,7067,21-10-2020 15:11:12.972037,Hamburguesas,Burger Society,7500,4100,11600
7067,7068,21-10-2020 15:11:13.096910,Italiana,Bocatto Di Passo,13600,5000,18600
7068,7069,21-10-2020 15:11:13.423327,Sushi,Canoa To Go,15000,5900,20900
7069,7070,21-10-2020 15:11:13.799094,Saludable · Típica,Sopas Mrg,65000,3100,68100
7070,7071,21-10-2020 15:11:14.124811,Pescados y Mariscos,Pescadero Héroes del Mar,13600,6600,20200
7071,7072,21-10-2020 15:11:14.300663,Desayunos · Típica,Casa Vieja,15600,6000,21600
7072,7073,21-10-2020 15:11:14.626466,Comida Rápida,Fiesta Digital Andrés,18900,3100,22000
7073,7074,21-10-2020 15:11:14.951659,Desayunos,Jacinta Arepas de Huevo,23000,4000,27000
7074,7075,21-10-2020 15:11:15.227736,Desayunos · Típica,Calentao Express,35000,6000,41000
7075,7076,21-10-2020 15:11:15.453149,Sánduches,Submarin,35000,3800,38800
7076,7077,21-10-2020 15:11:15.678688,Desayunos · Típica,La Frijolada,23000,4500,27500
7077,7078,21-10-2020 15:11:16.054159,Desayunos · Panadería,Pasteleite,70000,5900,75900
7078,7079,21-10-2020 15:11:16.430064,Postres · Desayunos,Aury Postres - Comidas & Picadas,70000,4700,74700
7079,7080,21-10-2020 15:11:16.655140,Parrilla,Campocina,13000,4600,17600
7080,7081,21-10-2020 15:11:16.830921,Desayunos,Archies Desayunos,65000,3100,68100
7081,7082,21-10-2020 15:11:17.206607,Postres · Desayunos,Amelie Helados,24200,6400,30600
7082,7083,21-10-2020 15:11:17.432491,Típica,Bandejas Mrg,70000,3800,73800
7083,7084,21-10-2020 15:11:17.809092,Mexicana,La leyenda mexican kitchen,10700,3200,13900
7084,7085,21-10-2020 15:11:17.934625,Perros Calientes,Dog Shop - Rapida,35000,4900,39900
7085,7086,21-10-2020 15:11:18.059542,Pollo · Desayunos,Abasto,8900,3600,12500
7086,7087,21-10-2020 15:11:18.285340,Típica,Bandejas Mrg,18900,3800,22700
7087,7088,21-10-2020 15:11:18.560323,Parrilla · Internacional,Taperia de la Plaza,27800,5700,33500
7088,7089,21-10-2020 15:11:18.886301,Postres · Desayunos,Amelie Helados,65000,6400,71400
7089,7090,21-10-2020 15:11:19.261671,Saludable,Amor Propio saludable,17800,4000,21800
7090,7091,21-10-2020 15:11:19.587722,Pescados y Mariscos,La Gran Cazuela,23000,3200,26200
7091,7092,21-10-2020 15:11:19.863092,Postres · Desayunos,Vivalight Market.,13000,6500,19500
7092,7093,21-10-2020 15:11:20.188784,Peruana,Uma Cantina Peruana,27800,3200,31000
7093,7094,21-10-2020 15:11:20.364052,Sánduches · Pescados y Mariscos,Pacific Comida de Mar,70000,4000,74000
7094,7095,21-10-2020 15:11:20.540601,Parrilla · Café,Gaira Café,23000,4400,27400
7095,7096,21-10-2020 15:11:20.766126,Saludable,Ventura Soup y Salad,15000,3800,18800
7096,7097,21-10-2020 15:11:20.991903,Alta Cocina · Postres,La Pinta,9000,4500,13500
7097,7098,21-10-2020 15:11:21.117487,Postres · Desayunos,Maltihelados,24200,6200,30400
7098,7099,21-10-2020 15:11:21.293696,Postres · Saludable,Ana Rebana,7500,6300,13800
7099,7100,21-10-2020 15:11:21.669478,Pizza · Parrilla,Urban Lunch,18900,4000,22900
7100,7101,21-10-2020 15:11:21.795605,Postres · Desayunos,BagBog Bagels,23000,6400,29400
7101,7102,21-10-2020 15:11:21.971437,Desayunos · Café,Aromacafé el Placer de Compartir,23000,5000,28000
7102,7103,21-10-2020 15:11:22.098135,Desayunos · Típica,Rojo Gourmet,53900,4700,58600
7103,7104,21-10-2020 15:11:22.373832,Saludable,Amor Propio saludable,12500,4000,16500
7104,7105,21-10-2020 15:11:22.499599,Hamburguesas,Burger Society,70000,4100,74100
7105,7106,21-10-2020 15:11:22.876505,Desayunos · Típica,Criollomania,39700,5200,44900
7106,7107,21-10-2020 15:11:23.102934,Saludable · Jugos y Batidos,Berdes Drinks & Salads,18900,3500,22400
7107,7108,21-10-2020 15:11:23.278424,Típica,Bandejas Mrg,29500,3800,33300
7108,7109,21-10-2020 15:11:23.504462,Pollo,Chicken House,35000,4200,39200
7109,7110,21-10-2020 15:11:23.780207,Parrilla,Arepaisa de Medellín,23000,5600,28600
7110,7111,21-10-2020 15:11:24.006292,Típica,Carbón & Mondongos,24200,6400,30600
7111,7112,21-10-2020 15:11:24.131743,Postres · Desayunos,La Folie - Postres,10700,3300,14000
7112,7113,21-10-2020 15:11:24.507817,Desayunos · Típica,Fogón Sangileño,18900,5000,23900
7113,7114,21-10-2020 15:11:24.833459,Desayunos,Butter,23000,6700,29700
7114,7115,21-10-2020 15:11:24.959284,Desayunos · Sánduches,Danilo Colombia,39700,3300,43000
7115,7116,21-10-2020 15:11:25.084558,Pollo,Oliva Va,34500,5600,40100
7116,7117,21-10-2020 15:11:25.360607,Desayunos · Típica,90 Calentados,53900,3700,57600
7117,7118,21-10-2020 15:11:25.686364,Desayunos · Pescados y Mariscos,Luzí­a - Mediterranea,31800,5700,37500
7118,7119,21-10-2020 15:11:26.012345,Comida Rápida,Fiesta Digital Andrés,24300,3100,27400
7119,7120,21-10-2020 15:11:26.287591,Saludable · Desayunos,Básico y elemental,15600,5000,20600
7120,7121,21-10-2020 15:11:26.463215,Desayunos,Archies Desayunos,7500,3100,10600
7121,7122,21-10-2020 15:11:26.738893,Saludable · Desayunos,Maracuyá,34500,6700,41200
7122,7123,21-10-2020 15:11:27.015104,Típica · Parrilla,Parrilla Farandula Gourmet,10700,5100,15800
7123,7124,21-10-2020 15:11:27.190323,Postres · Café,Celestino Café,18900,5900,24800
7124,7125,21-10-2020 15:11:27.566322,Postres · Café,Loló Coffee & Snacks,10700,4600,15300
7125,7126,21-10-2020 15:11:27.791738,Sánduches · China,Peru Mix,8900,5900,14800
7126,7127,21-10-2020 15:11:28.018657,Perros Calientes,Dog Shop - Rapida,8900,4900,13800
7127,7128,21-10-2020 15:11:28.293927,Típica · Parrilla,La Parilla de David,48750,3100,51850
7128,7129,21-10-2020 15:11:28.469487,Desayunos · Típica,La Frijolada,23000,4500,27500
7129,7130,21-10-2020 15:11:28.594516,Desayunos,El Fogón Castellano,17800,3200,21000
7130,7131,21-10-2020 15:11:28.970572,Saludable · Desayunos,Fresh Co,8900,5600,14500
7131,7132,21-10-2020 15:11:29.196101,Pollo,Señor Fantástico,18900,4700,23600
7132,7133,21-10-2020 15:11:29.572706,Pollo · Desayunos,Abasto,23000,3600,26600
7133,7134,21-10-2020 15:11:29.697887,Desayunos · Jugos y Batidos,Kuriwaji,15600,6300,21900
7134,7135,21-10-2020 15:11:30.074040,Saludable · Desayunos,Distrito Gourmet,13600,3700,17300
7135,7136,21-10-2020 15:11:30.200662,Saludable,Ventura Soup y Salad,9000,3800,12800
7136,7137,21-10-2020 15:11:30.576677,Parrilla,Arroces Maria Paula,29500,6800,36300
7137,7138,21-10-2020 15:11:30.751847,Desayunos,Cafetería el Kippe,9000,3200,12200
7138,7139,21-10-2020 15:11:30.977860,Desayunos,La Frijolada Desayunos,24200,4400,28600
7139,7140,21-10-2020 15:11:31.253529,Internacional,Rio Sabores y Experiencias,13000,4100,17100
7140,7141,21-10-2020 15:11:31.429440,Postres · Desayunos,Gelateria Da Favola,23000,6500,29500
7141,7142,21-10-2020 15:11:31.654819,Postres · Desayunos,Sharmus,39700,6100,45800
7142,7143,21-10-2020 15:11:31.981052,Desayunos · Café,El Gualilo,34500,6200,40700
7143,7144,21-10-2020 15:11:32.356506,Postres · Café,Loló Coffee & Snacks,45800,4600,50400
7144,7145,21-10-2020 15:11:32.732661,Saludable,Hanai - Bowls Saludables,39700,5900,45600
7145,7146,21-10-2020 15:11:32.908051,Pescados y Mariscos,La Gran Cazuela,15000,3200,18200
7146,7147,21-10-2020 15:11:33.185470,Sushi,Kim Pop,15000,5400,20400
7147,7148,21-10-2020 15:11:33.511108,Mexicana,Cantina La 15,35000,4300,39300
7148,7149,21-10-2020 15:11:33.687271,Hamburguesas · Desayunos,El Inglés Gastro Pub,53900,6600,60500
7149,7150,21-10-2020 15:11:34.013070,Postres · Desayunos,Maltihelados,18900,6200,25100
7150,7151,21-10-2020 15:11:34.189194,Desayunos · Comida Rápida,La Veneca,27800,6300,34100
7151,7152,21-10-2020 15:11:34.464918,Desayunos,Bagel Shop,48750,3200,51950
7152,7153,21-10-2020 15:11:34.790909,Desayunos · Café,Aromacafé el Placer de Compartir,12500,5000,17500
7153,7154,21-10-2020 15:11:35.166328,Pizza · Italiana,Pisapore - Pizza,13000,6600,19600
7154,7155,21-10-2020 15:11:35.542324,Pizza · Italiana,Pisapore - Pizza,15000,6600,21600
7155,7156,21-10-2020 15:11:35.717643,Hamburguesas,Gofi Burger,12500,5100,17600
7156,7157,21-10-2020 15:11:36.093555,Típica,Sopitas y Más,27800,4200,32000
7157,7158,21-10-2020 15:11:36.369173,Internacional,Rio Sabores y Experiencias,10700,4100,14800
7158,7159,21-10-2020 15:11:36.594983,Pollo,Heart & Cooking,34500,5000,39500
7159,7160,21-10-2020 15:11:36.720191,Saludable · Parrilla,Box,17800,3700,21500
7160,7161,21-10-2020 15:11:37.096195,Hamburguesas · Alitas,Beer,24300,6600,30900
7161,7162,21-10-2020 15:11:37.271706,Típica,Bandejas Mrg,65000,3800,68800
7162,7163,21-10-2020 15:11:37.548093,Saludable · Desayunos,Re.al Alimentos Reales,24200,4000,28200
7163,7164,21-10-2020 15:11:37.673581,Hamburguesas,Burger Society,34500,4100,38600
7164,7165,21-10-2020 15:11:37.849619,Postres · Desayunos,KOKOA & co.,65000,4700,69700
7165,7166,21-10-2020 15:11:38.125208,Desayunos,Bagel Shop,45800,3200,49000
7166,7167,21-10-2020 15:11:38.402360,Desayunos · Panadería,Juliana Restaurante,39700,6100,45800
7167,7168,21-10-2020 15:11:38.627889,Típica · Parrilla,Typykos,18900,6000,24900
7168,7169,21-10-2020 15:11:38.803688,Postres · Helados,Mahé,34500,6000,40500
7169,7170,21-10-2020 15:11:39.079031,Desayunos,El Fogón Castellano,53400,3200,56600
7170,7171,21-10-2020 15:11:39.455326,Sánduches,Submarin,48750,3800,52550
7171,7172,21-10-2020 15:11:39.830840,Típica,Cabrito Santandereano,35000,6600,41600
7172,7173,21-10-2020 15:11:40.106885,Desayunos · Panadería,Juliana Restaurante,70000,6100,76100
7173,7174,21-10-2020 15:11:40.332196,Postres · Desayunos,Amelie Helados,35000,6400,41400
7174,7175,21-10-2020 15:11:40.608389,Hamburguesas · Alitas,Beer,65000,6600,71600
7175,7176,21-10-2020 15:11:40.834076,Pescados y Mariscos,Fish Place - Del Mar,9000,5400,14400
7176,7177,21-10-2020 15:11:41.160088,Postres,Levelma,9000,6200,15200
7177,7178,21-10-2020 15:11:41.285731,Saludable · Desayunos,Re.al Alimentos Reales,13600,4000,17600
7178,7179,21-10-2020 15:11:41.661932,Postres · Desayunos,Buñuelos nacho,24300,6600,30900
7179,7180,21-10-2020 15:11:41.837253,Típica,Bendita S,7500,4600,12100
7180,7181,21-10-2020 15:11:42.213534,Comida Rápida,Fiesta Digital Andrés,45800,3100,48900
7181,7182,21-10-2020 15:11:42.439133,Pizza · Italiana,Piatto - Pizza,17800,6600,24400
7182,7183,21-10-2020 15:11:42.665473,Parrilla,Coquitas,17800,5600,23400
7183,7184,21-10-2020 15:11:42.790727,Postres · Café,Celestino Café,39700,5900,45600
7184,7185,21-10-2020 15:11:42.966597,Pollo · Saludable,Gratina,70000,4200,74200
7185,7186,21-10-2020 15:11:43.191868,Desayunos · Árabe,Boniato Sabores Vivos,8900,5300,14200
7186,7187,21-10-2020 15:11:43.419477,Desayunos · Panadería,Artesanos,24300,4300,28600
7187,7188,21-10-2020 15:11:43.544898,Postres · Desayunos,Protein Bakes,23000,5900,28900
7188,7189,21-10-2020 15:11:43.670775,Desayunos · Típica,Desayunadero de la 42,9000,5900,14900
7189,7190,21-10-2020 15:11:43.996428,Saludable · Desayunos,Libre de Culpa,13600,4000,17600
7190,7191,21-10-2020 15:11:44.272455,Postres · Desayunos,Aury Postres - Comidas & Picadas,13600,4700,18300
7191,7192,21-10-2020 15:11:44.497908,Saludable · Parrilla,The Angels Grill and Drinks,12500,6200,18700
7192,7193,21-10-2020 15:11:44.774041,Desayunos,La Frijolada Desayunos,10700,4400,15100
7193,7194,21-10-2020 15:11:44.899334,Pollo · China,China Tao,13000,3500,16500
7194,7195,21-10-2020 15:11:45.225729,Italiana,F*cking Good Pizza,8900,4200,13100
7195,7196,21-10-2020 15:11:45.351225,Postres · Desayunos,KOKOA & co.,39700,4700,44400
7196,7197,21-10-2020 15:11:45.577098,Pizza,Pastas Laurentina,8900,4800,13700
7197,7198,21-10-2020 15:11:45.902868,Típica,Cazuelitas 93,18900,3900,22800
7198,7199,21-10-2020 15:11:46.128935,Mexicana,La leyenda mexican kitchen,9000,3200,12200
7199,7200,21-10-2020 15:11:46.504707,Postres · Helados,Mahé,15000,6000,21000
7200,7201,21-10-2020 15:11:46.830953,Comida Rápida,Fiesta Digital Andrés,70000,3100,73100
7201,7202,21-10-2020 15:11:47.056637,Típica,Cazuelitas 93,35000,3900,38900
7202,7203,21-10-2020 15:11:47.332789,Desayunos,Fratelli - Desayunos,18900,4600,23500
7203,7204,21-10-2020 15:11:47.458244,Mexicana,Hidalgo Taquería,45800,4900,50700
7204,7205,21-10-2020 15:11:47.584133,Típica,Campo Victoria,10700,3000,13700
7205,7206,21-10-2020 15:11:47.809607,Típica,Sabrosito,34500,4000,38500
7206,7207,21-10-2020 15:11:47.935960,Desayunos,Fratelli - Desayunos,53900,4600,58500
7207,7208,21-10-2020 15:11:48.311554,Desayunos · Típica,90 Calentados,35000,3700,38700
7208,7209,21-10-2020 15:11:48.688927,Típica · Parrilla,Toya,23000,4200,27200
7209,7210,21-10-2020 15:11:49.014591,Desayunos · Helados,San Giorgio Gelateria,27800,3100,30900
7210,7211,21-10-2020 15:11:49.340735,Saludable · Típica,Saludable Mrg,8900,5800,14700
7211,7212,21-10-2020 15:11:49.666365,Saludable · Desayunos,Bawana - Sandwich,24300,3400,27700
7212,7213,21-10-2020 15:11:49.892485,Pollo · Saludable,Gratina,53400,4200,57600
7213,7214,21-10-2020 15:11:50.017885,Postres · Desayunos,Amelie Helados,23000,6400,29400
7214,7215,21-10-2020 15:11:50.243905,Desayunos,Butter,35000,6700,41700
7215,7216,21-10-2020 15:11:50.620017,Típica,El Cucharón - Tipica,15600,4400,20000
7216,7217,21-10-2020 15:11:50.946613,Crepes,San Crepes,53900,4900,58800
7217,7218,21-10-2020 15:11:51.272441,Poke,Poke Go,35000,4600,39600
7218,7219,21-10-2020 15:11:51.649013,Postres,Levelma,13600,6200,19800
7219,7220,21-10-2020 15:11:51.874493,Desayunos · Panadería,Choclofee,8900,4700,13600
7220,7221,21-10-2020 15:11:52.000391,Postres,La Galeta,65000,3000,68000
7221,7222,21-10-2020 15:11:52.175879,Saludable · Desayunos,La Cesta,45800,4700,50500
7222,7223,21-10-2020 15:11:52.402309,Desayunos,La Frijolada Desayunos,24200,4400,28600
7223,7224,21-10-2020 15:11:52.577785,Desayunos · Típica,Fogón Sangileño,70000,5000,75000
7224,7225,21-10-2020 15:11:52.954245,Saludable · Parrilla,Box,37900,3700,41600
7225,7226,21-10-2020 15:11:53.079716,Pizza,pizza andante,15000,4200,19200
7226,7227,21-10-2020 15:11:53.355958,Parrilla,Campocina,29500,4600,34100
7227,7228,21-10-2020 15:11:53.581602,Desayunos · Panadería,Santa Juana Food Bar,35000,5900,40900
7228,7229,21-10-2020 15:11:53.958894,Desayunos · Empanadas,Empanadas Doraditas.com,24300,3000,27300
7229,7230,21-10-2020 15:11:54.134436,Desayunos,Butter,53900,6700,60600
7230,7231,21-10-2020 15:11:54.310530,Típica,El Mondongo y Mucho Mas,9000,5600,14600
7231,7232,21-10-2020 15:11:54.485970,Peruana,Masivo,18900,5800,24700
7232,7233,21-10-2020 15:11:54.812250,Típica · Parrilla,Parrilla Farandula Gourmet,7500,5100,12600
7233,7234,21-10-2020 15:11:54.987888,Saludable · Desayunos,La Estampilla,70000,6000,76000
7234,7235,21-10-2020 15:11:55.164062,Saludable · Desayunos,Básico y elemental,15600,5000,20600
7235,7236,21-10-2020 15:11:55.390250,Sánduches,Submarin,7500,3800,11300
7236,7237,21-10-2020 15:11:55.616925,Parrilla,Coquitas,29500,5600,35100
7237,7238,21-10-2020 15:11:55.892855,Desayunos,El Fogón Castellano,70000,3200,73200
7238,7239,21-10-2020 15:11:56.119487,Postres,Levelma,15600,6200,21800
7239,7240,21-10-2020 15:11:56.395778,Pizza,pizza andante,12500,4200,16700
7240,7241,21-10-2020 15:11:56.722324,Postres · Café,Celestino Café,23000,5900,28900
7241,7242,21-10-2020 15:11:56.898256,Típica,Sopitas y Más,15600,4200,19800
7242,7243,21-10-2020 15:11:57.225370,Saludable · Jugos y Batidos,Berdes Drinks & Salads,35000,3500,38500
7243,7244,21-10-2020 15:11:57.451230,Desayunos · Panadería,El Pan de Phillippe,13000,4600,17600
7244,7245,21-10-2020 15:11:57.577564,Desayunos · Pescados y Mariscos,Luzí­a - Mediterranea,34500,5700,40200
7245,7246,21-10-2020 15:11:57.753090,Típica · Parrilla,Mi Ranchito Parrilla,12500,4400,16900
7246,7247,21-10-2020 15:11:57.929405,Típica,Salsig,39700,5600,45300
7247,7248,21-10-2020 15:11:58.105317,Hamburguesas,Gofi Burger,24300,5100,29400
7248,7249,21-10-2020 15:11:58.481932,Postres · Desayunos,Cosmo Cookies,13000,5900,18900
7249,7250,21-10-2020 15:11:58.807815,Saludable · Desayunos,Libre de Culpa,24300,4000,28300
7250,7251,21-10-2020 15:11:58.934302,Desayunos · Panadería,Santa Juana Food Bar,17800,5900,23700
7251,7252,21-10-2020 15:11:59.210429,Asiática,TeT,15000,5900,20900
7252,7253,21-10-2020 15:11:59.437973,Parrilla,Restaurante Bar Mi Ranchito,11870,5200,17070
7253,7254,21-10-2020 15:11:59.564847,Desayunos · Típica,Parrilla Farandula Típico,48750,5900,54650
7254,7255,21-10-2020 15:11:59.792170,Saludable · Desayunos,Básico y Elemental,24200,5900,30100
7255,7256,21-10-2020 15:12:00.118281,Desayunos · Empanadas,Mis Delicias,23000,3200,26200
7256,7257,21-10-2020 15:12:00.294584,Perros Calientes,Dog Shop - Rapida,70000,4900,74900
7257,7258,21-10-2020 15:12:00.620431,Saludable · Desayunos,Malú,23000,3700,26700
7258,7259,21-10-2020 15:12:00.896653,Pollo · Pescados y Mariscos,Bang Bang Rice,13600,3400,17000
7259,7260,21-10-2020 15:12:01.022166,Saludable · Desayunos,Guadalupe - Fruteria,45800,5900,51700
7260,7261,21-10-2020 15:12:01.248287,Típica · Parrilla,Toya,29500,4200,33700
7261,7262,21-10-2020 15:12:01.524090,Saludable,Hanai - Bowls Saludables,23000,5900,28900
7262,7263,21-10-2020 15:12:01.750339,Desayunos · Café,Libertario Coffee Roasters,34500,4600,39100
7263,7264,21-10-2020 15:12:02.126282,Parrilla,Restaurante Bar Mi Ranchito,13600,5200,18800
7264,7265,21-10-2020 15:12:02.402782,Desayunos · Panadería,Juliana Restaurante,48750,6100,54850
7265,7266,21-10-2020 15:12:02.578391,Hamburguesas,Burger Society,13600,4100,17700
7266,7267,21-10-2020 15:12:02.704587,Parrilla,Antojo a Domicilio,34500,5000,39500
7267,7268,21-10-2020 15:12:02.880230,Helados,Buon Gelato,13000,4400,17400
7268,7269,21-10-2020 15:12:03.056731,Pollo · Desayunos,Candelina,10700,5300,16000
7269,7270,21-10-2020 15:12:03.182250,Pizza · Italiana,Piatto - Pizza,23000,6600,29600
7270,7271,21-10-2020 15:12:03.508849,Desayunos,Butter,15000,6700,21700
7271,7272,21-10-2020 15:12:03.684760,Típica,Lo Nuestro,35000,3100,38100
7272,7273,21-10-2020 15:12:03.911303,Postres · Desayunos,La Folie - Postres,48750,3300,52050
7273,7274,21-10-2020 15:12:04.137573,Comida Rápida · Perros Calientes,Similoa - Comida Rapida,17800,3700,21500
7274,7275,21-10-2020 15:12:04.465301,Saludable · Típica,Sopas Mrg,12500,3100,15600
7275,7276,21-10-2020 15:12:04.641264,Postres · Desayunos,Jacques Pastelería,13000,5900,18900
7276,7277,21-10-2020 15:12:04.967804,Desayunos · Comida Rápida,Chocolatto,24200,3400,27600
7277,7278,21-10-2020 15:12:05.293583,Saludable · Desayunos,La Estampilla,53400,6000,59400
7278,7279,21-10-2020 15:12:05.569616,Pollo · Típica,Auyama,48750,3900,52650
7279,7280,21-10-2020 15:12:05.695232,Parrilla,Campocina,8900,4600,13500
7280,7281,21-10-2020 15:12:05.821364,Hamburguesas · Alitas,Beer,53900,6600,60500
7281,7282,21-10-2020 15:12:06.046899,Parrilla,OAK Ahumado y Brebajes,65000,6000,71000
7282,7283,21-10-2020 15:12:06.323356,Hamburguesas · Saludable,Restaurant Inn,15000,6100,21100
7283,7284,21-10-2020 15:12:06.549223,Parrilla,Antojo a Domicilio,48750,5000,53750
7284,7285,21-10-2020 15:12:06.825744,Postres,La Galeta,35000,3000,38000
7285,7286,21-10-2020 15:12:07.201634,Hamburguesas · Saludable,Restaurant Inn,17800,6100,23900
7286,7287,21-10-2020 15:12:07.378097,Postres · Desayunos,Gelateria Da Favola,31800,6500,38300
7287,7288,21-10-2020 15:12:07.603891,Desayunos · Típica,Alce,13600,4900,18500
7288,7289,21-10-2020 15:12:07.930660,Pescados y Mariscos,Pescadero Héroes del Mar,37900,6600,44500
7289,7290,21-10-2020 15:12:08.156495,Típica · Parrilla,La Parilla de David,34500,3100,37600
7290,7291,21-10-2020 15:12:08.483308,Postres · Desayunos,BagBog Bagels,13000,6400,19400
7291,7292,21-10-2020 15:12:08.809310,Desayunos · Típica,Casa Vieja,24300,6000,30300
7292,7293,21-10-2020 15:12:08.985585,Parrilla,Restaurante Bar Mi Ranchito,37900,5200,43100
7293,7294,21-10-2020 15:12:09.111432,Desayunos · Mexicana,La Mera Mera - Mexicana,23000,3100,26100
7294,7295,21-10-2020 15:12:09.388253,Desayunos,Bagel Shop,15600,3200,18800
7295,7296,21-10-2020 15:12:09.515753,Mexicana,Mexicanachos,35000,3900,38900
7296,7297,21-10-2020 15:12:09.642534,Desayunos · Panadería,Premium Break Bakery,8900,3700,12600
7297,7298,21-10-2020 15:12:09.968639,Típica,Campo Victoria,18900,3000,21900
7298,7299,21-10-2020 15:12:10.195225,Saludable,Hanai - Bowls Saludables,13600,5900,19500
7299,7300,21-10-2020 15:12:10.521417,Pizza,pizza andante,70000,4200,74200
7300,7301,21-10-2020 15:12:10.797785,Típica,Salsig,23000,5600,28600
7301,7302,21-10-2020 15:12:11.073546,Saludable,Amor Propio saludable,24300,4000,28300
7302,7303,21-10-2020 15:12:11.249725,Típica,La Herencia,70000,5900,75900
7303,7304,21-10-2020 15:12:11.525449,Parrilla · Internacional,Taperia de la Plaza,9000,5700,14700
7304,7305,21-10-2020 15:12:11.651887,Típica · Parrilla,Toya,53400,4200,57600
7305,7306,21-10-2020 15:12:12.027752,Postres,La Tertulia,24200,3400,27600
7306,7307,21-10-2020 15:12:12.304003,Desayunos · Jugos y Batidos,Frutiwow,70000,4100,74100
7307,7308,21-10-2020 15:12:12.479622,Alta Cocina · Parrilla,Criterión,45800,6000,51800
7308,7309,21-10-2020 15:12:12.755953,Desayunos · Panadería,Siena Café,23000,3700,26700
7309,7310,21-10-2020 15:12:13.132118,Parrilla · Café,Figaro Café/ Restaurante Argentino,34500,5800,40300
7310,7311,21-10-2020 15:12:13.308397,Desayunos · Café,Norma's Ice Cream Café,27800,6300,34100
7311,7312,21-10-2020 15:12:13.584093,Desayunos · Panadería,Siena Café,53900,3700,57600
7312,7313,21-10-2020 15:12:13.760351,Sánduches · Pescados y Mariscos,Pacific Comida de Mar,8900,4000,12900
7313,7314,21-10-2020 15:12:13.886023,Poke,Poke Go,9000,4600,13600
7314,7315,21-10-2020 15:12:14.012239,Desayunos,Jacinta Arepas de Huevo,70000,4000,74000
7315,7316,21-10-2020 15:12:14.388202,Café · Helados,Sofia heladería y café,27800,5800,33600
7316,7317,21-10-2020 15:12:14.716104,Mexicana,Cantina La 15,45800,4300,50100
7317,7318,21-10-2020 15:12:14.991896,Saludable · Jugos y Batidos,Berdes Drinks & Salads,35000,3500,38500
7318,7319,21-10-2020 15:12:15.268233,Desayunos · Panadería,Choclofee,23000,4700,27700
7319,7320,21-10-2020 15:12:15.644474,Hamburguesas · Alitas,Beer,48750,6600,55350
7320,7321,21-10-2020 15:12:15.920676,Saludable · Parrilla,Box,8900,3700,12600
7321,7322,21-10-2020 15:12:16.246521,Alta Cocina · Parrilla,Criterión,45800,6000,51800
7322,7323,21-10-2020 15:12:16.573158,Parrilla,Antojo a Domicilio,39700,5000,44700
7323,7324,21-10-2020 15:12:16.898940,Crepes,La Chabatta,53900,5900,59800
7324,7325,21-10-2020 15:12:17.075161,Saludable · Desayunos,La Estampilla,23000,6000,29000
7325,7326,21-10-2020 15:12:17.200866,Postres,Toledo Pastelería,24300,6800,31100
7326,7327,21-10-2020 15:12:17.477158,Parrilla · Café,Figaro Café/ Restaurante Argentino,31800,5800,37600
7327,7328,21-10-2020 15:12:17.653020,Desayunos,Cafetería el Kippe,45800,3200,49000
7328,7329,21-10-2020 15:12:17.979462,Pollo · Saludable,Gratina,17800,4200,22000
7329,7330,21-10-2020 15:12:18.255444,Hamburguesas · Panadería,NYC Burgers,53900,6200,60100
7330,7331,21-10-2020 15:12:18.632108,Desayunos · Helados,San Giorgio Gelateria,18900,3100,22000
7331,7332,21-10-2020 15:12:18.807951,Hamburguesas · Alitas,Beer,23000,6600,29600
7332,7333,21-10-2020 15:12:19.084358,Parrilla,Rústico Picadería,35000,3800,38800
7333,7334,21-10-2020 15:12:19.310387,Postres · Desayunos,Maltihelado,27800,4500,32300
7334,7335,21-10-2020 15:12:19.636958,Sánduches · Pescados y Mariscos,Pacific Comida de Mar,24300,4000,28300
7335,7336,21-10-2020 15:12:20.014120,Parrilla,Coquitas,27800,5600,33400
7336,7337,21-10-2020 15:12:20.240916,Desayunos · Internacional,Camilia,15000,3900,18900
7337,7338,21-10-2020 15:12:20.366596,Típica,Cazuelitas 93,9000,3900,12900
7338,7339,21-10-2020 15:12:20.643137,Desayunos · Café,Matchacha,70000,5900,75900
7339,7340,21-10-2020 15:12:20.818838,Sushi,Sushi Reel,24200,4700,28900
7340,7341,21-10-2020 15:12:21.145422,Italiana,F*cking Good Pizza,37900,4200,42100
7341,7342,21-10-2020 15:12:21.271157,Desayunos · Típica,D'Porco - Lechona,35000,6300,41300
7342,7343,21-10-2020 15:12:21.497540,Sushi,Canoa To Go,13000,5900,18900
7343,7344,21-10-2020 15:12:21.723471,Hamburguesas · Alitas,Beer,65000,6600,71600
7344,7345,21-10-2020 15:12:21.900132,Parrilla,Rústico Picadería,48750,3800,52550
7345,7346,21-10-2020 15:12:22.176338,Saludable · Parrilla,Box,7500,3700,11200
7346,7347,21-10-2020 15:12:22.553095,Peruana,Masivo,7500,5800,13300
7347,7348,21-10-2020 15:12:22.778994,Desayunos,El Corral - Desayunos,13000,5000,18000
7348,7349,21-10-2020 15:12:22.955777,Postres · Desayunos,Gelateria Da Favola,17800,6500,24300
7349,7350,21-10-2020 15:12:23.081907,Postres · Panadería,RIGHT AWAY FOODS,53400,6600,60000
7350,7351,21-10-2020 15:12:23.308661,Desayunos · Típica,Criollomania,45800,5200,51000
7351,7352,21-10-2020 15:12:23.634943,Postres,Beiked,17800,4000,21800
7352,7353,21-10-2020 15:12:23.961669,Parrilla,Coquitas,8900,5600,14500
7353,7354,21-10-2020 15:12:24.237996,Desayunos · Mexicana,La Mera Mera - Mexicana,53400,3100,56500
7354,7355,21-10-2020 15:12:24.464564,Desayunos,La Frijolada Desayunos,7500,4400,11900
7355,7356,21-10-2020 15:12:24.590328,Helados,Buon Gelato,70000,4400,74400
7356,7357,21-10-2020 15:12:24.967043,Postres · Desayunos,Aury Postres - Comidas & Picadas,65000,4700,69700
7357,7358,21-10-2020 15:12:25.244607,Postres · Café,Celestino Café,70000,5900,75900
7358,7359,21-10-2020 15:12:25.370988,Postres · Panadería,RIGHT AWAY FOODS,13600,6600,20200
7359,7360,21-10-2020 15:12:25.546888,Desayunos · Típica,Casa Vieja,45800,6000,51800
7360,7361,21-10-2020 15:12:25.673351,Desayunos · Árabe,Boniato Sabores Vivos,24200,5300,29500
7361,7362,21-10-2020 15:12:25.949342,Desayunos,Señor Desayuno,15000,6800,21800
7362,7363,21-10-2020 15:12:26.125802,Pescados y Mariscos,La Gran Cazuela,35000,3200,38200
7363,7364,21-10-2020 15:12:26.252019,Postres · Desayunos,Gelateria Da Favola,34500,6500,41000
7364,7365,21-10-2020 15:12:26.578657,Saludable · Desayunos,Libre de Culpa,65000,4000,69000
7365,7366,21-10-2020 15:12:26.904949,Hamburguesas · Saludable,Restaurant Inn,39700,6100,45800
7366,7367,21-10-2020 15:12:27.031530,China,China Food Col,70000,3600,73600
7367,7368,21-10-2020 15:12:27.357794,Hamburguesas · Alitas,Beer,12500,6600,19100
7368,7369,21-10-2020 15:12:27.584285,Peruana,Uma Cantina Peruana,37900,3200,41100
7369,7370,21-10-2020 15:12:27.711005,Parrilla,Antojo a Domicilio,37900,5000,42900
7370,7371,21-10-2020 15:12:27.988011,Postres · Desayunos,Maltihelados,10700,6200,16900
7371,7372,21-10-2020 15:12:28.214036,Parrilla,Coquitas,24200,5600,29800
7372,7373,21-10-2020 15:12:28.540484,Pizza,Pastas Laurentina,34500,4800,39300
7373,7374,21-10-2020 15:12:28.816336,Pollo · Típica,Auyama,13600,3900,17500
7374,7375,21-10-2020 15:12:29.143398,Peruana,Uma Cantina Peruana,17800,3200,21000
7375,7376,21-10-2020 15:12:29.519521,Pollo,Heart & Cooking,24300,5000,29300
7376,7377,21-10-2020 15:12:29.746310,Desayunos,La Frijolada Desayunos,48750,4400,53150
7377,7378,21-10-2020 15:12:30.072425,Desayunos · Panadería,Juliana Restaurante,24200,6100,30300
7378,7379,21-10-2020 15:12:30.450393,Helados,Orso To Go,34500,6800,41300
7379,7380,21-10-2020 15:12:30.576277,Peruana,Uma Cantina Peruana,15600,3200,18800
7380,7381,21-10-2020 15:12:30.703259,Alta Cocina · Postres,La Pinta,35000,4500,39500
7381,7382,21-10-2020 15:12:30.885035,Pollo · Desayunos,Candelina,27800,5300,33100
7382,7383,21-10-2020 15:12:31.111502,Desayunos · Típica,Peninsula Calentados y Parrilla,37900,3400,41300
7383,7384,21-10-2020 15:12:31.437780,Postres,Beiked,15000,4000,19000
7384,7385,21-10-2020 15:12:31.614489,Peruana,Uma Cantina Peruana,31800,3200,35000
7385,7386,21-10-2020 15:12:31.740468,Pescados y Mariscos,Fish Place - Del Mar,23000,5400,28400
7386,7387,21-10-2020 15:12:32.067067,Pollo · China,China Tao,23000,3500,26500
7387,7388,21-10-2020 15:12:32.443574,Peruana · Internacional,La Chifería,23000,6600,29600
7388,7389,21-10-2020 15:12:32.670128,Pollo · China,China Tao,53900,3500,57400
7389,7390,21-10-2020 15:12:32.895994,Desayunos · Típica,La Frijolada,23000,4500,27500
7390,7391,21-10-2020 15:12:33.272765,Típica,Juan Chorizo,31800,3900,35700
7391,7392,21-10-2020 15:12:33.549792,Poke,Poke Go,17800,4600,22400
7392,7393,21-10-2020 15:12:33.876391,Saludable · Desayunos,La Cesta,65000,4700,69700
7393,7394,21-10-2020 15:12:34.002437,Pizza,18 Scalini,24200,4300,28500
7394,7395,21-10-2020 15:12:34.329253,Italiana,Bocatto Di Passo,45800,5000,50800
7395,7396,21-10-2020 15:12:34.655446,Postres · Desayunos,Vivalight Market.,34500,6500,41000
7396,7397,21-10-2020 15:12:34.782286,Desayunos · Típica,Rojo Gourmet,24300,4700,29000
7397,7398,21-10-2020 15:12:35.108836,Pollo · Saludable,Tremenda Sal y Dulce,45800,6500,52300
7398,7399,21-10-2020 15:12:35.236178,Sushi · Asiática,Tu Sushi,11870,6400,18270
7399,7400,21-10-2020 15:12:35.563994,Desayunos · Típica,La Parrilla Dorada Polo,31800,6600,38400
7400,7401,21-10-2020 15:12:35.690743,Pollo,Señor Fantástico,24300,4700,29000
7401,7402,21-10-2020 15:12:36.067442,Hamburguesas,Burger Society,7500,4100,11600
7402,7403,21-10-2020 15:12:36.444748,Saludable · Desayunos,Maracuyá,24200,6700,30900
7403,7404,21-10-2020 15:12:36.671024,Típica,Sabores De Mi Tierra,34500,5400,39900
7404,7405,21-10-2020 15:12:36.997793,Crepes,La Chabatta,48750,5900,54650
7405,7406,21-10-2020 15:12:37.274062,Pollo · Pescados y Mariscos,Bang Bang Rice,24200,3400,27600
7406,7407,21-10-2020 15:12:37.650823,Pollo · Desayunos,Candelina,65000,5300,70300
7407,7408,21-10-2020 15:12:37.876915,Sánduches · Pescados y Mariscos,Pacific Comida de Mar,10700,4000,14700
7408,7409,21-10-2020 15:12:38.203934,Saludable · Desayunos,Básico y Elemental,65000,5900,70900
7409,7410,21-10-2020 15:12:38.530249,Desayunos · Panadería,Le Pain Quotidien,10700,3900,14600
7410,7411,21-10-2020 15:12:38.757004,Parrilla,Arroces Maria Paula,11870,6800,18670
7411,7412,21-10-2020 15:12:39.033318,Desayunos · Café,Frambas,24300,3400,27700
7412,7413,21-10-2020 15:12:39.210372,Internacional,Rio Sabores y Experiencias,39700,4100,43800
7413,7414,21-10-2020 15:12:39.536777,Desayunos · Típica,Papadió - Colombianas,24200,5700,29900
7414,7415,21-10-2020 15:12:39.863694,Sushi,Canoa To Go,35000,5900,40900
7415,7416,21-10-2020 15:12:40.089858,Saludable · Desayunos,La Estampilla,45800,6000,51800
7416,7417,21-10-2020 15:12:40.317097,Asiática,TeT,12500,5900,18400
7417,7418,21-10-2020 15:12:40.443663,Desayunos · Panadería,Premium Break Bakery,53900,3700,57600
7418,7419,21-10-2020 15:12:40.622265,Pollo · Saludable,Tremenda Sal y Dulce,15600,6500,22100
7419,7420,21-10-2020 15:12:40.949032,Desayunos,Don Leo,39700,6000,45700
7420,7421,21-10-2020 15:12:41.075959,Sushi · Asiática,Tu Sushi,8900,6400,15300
7421,7422,21-10-2020 15:12:41.252754,Desayunos · Café,Frambas,37900,3400,41300
7422,7423,21-10-2020 15:12:41.479847,Sushi,Kim Pop,70000,5400,75400
7423,7424,21-10-2020 15:12:41.756352,Desayunos · Empanadas,Mis Delicias,13000,3200,16200
7424,7425,21-10-2020 15:12:41.983782,Postres · Desayunos,Cosmo Cookies,15600,5900,21500
7425,7426,21-10-2020 15:12:42.260522,Postres · Panadería,RIGHT AWAY FOODS,24300,6600,30900
7426,7427,21-10-2020 15:12:42.537759,Típica,Juan Chorizo,37900,3900,41800
7427,7428,21-10-2020 15:12:42.764249,Desayunos · Jugos y Batidos,Frutiwow,29500,4100,33600
7428,7429,21-10-2020 15:12:42.941381,Típica,Bendita S,11870,4600,16470
7429,7430,21-10-2020 15:12:43.067460,Desayunos · Internacional,Camilia,65000,3900,68900
7430,7431,21-10-2020 15:12:43.294450,Desayunos · Café,Frambas,35000,3400,38400
7431,7432,21-10-2020 15:12:43.471037,Perros Calientes,Dog Shop - Rapida,15000,4900,19900
7432,7433,21-10-2020 15:12:43.648225,Típica,Juan Chorizo,37900,3900,41800
7433,7434,21-10-2020 15:12:43.928571,Desayunos · Pescados y Mariscos,Gypsy Bistro,17800,4500,22300
7434,7435,21-10-2020 15:12:44.255629,Pollo,Chicken House,65000,4200,69200
7435,7436,21-10-2020 15:12:44.632229,Típica,Campo Victoria,48750,3000,51750
7436,7437,21-10-2020 15:12:44.759238,Saludable · Parrilla,Box,15600,3700,19300
7437,7438,21-10-2020 15:12:45.085699,Postres · Desayunos,Café Quindio,9000,5700,14700
7438,7439,21-10-2020 15:12:45.312647,Saludable · Desayunos,Distrito Gourmet,23000,3700,26700
7439,7440,21-10-2020 15:12:45.689425,Hamburguesas · Desayunos,El Inglés Gastro Pub,31800,6600,38400
7440,7441,21-10-2020 15:12:45.816320,Saludable · Desayunos,La Cesta,45800,4700,50500
7441,7442,21-10-2020 15:12:45.992954,Desayunos · Empanadas,Empanadas Doraditas.com,70000,3000,73000
7442,7443,21-10-2020 15:12:46.270439,Saludable,Hanai - Bowls Saludables,12500,5900,18400
7443,7444,21-10-2020 15:12:46.447375,Típica,Sabrosito,35000,4000,39000
7444,7445,21-10-2020 15:12:46.624616,Desayunos · Típica,D´Porco,13000,3900,16900
7445,7446,21-10-2020 15:12:46.902590,Pescados y Mariscos,Pescadero Héroes del Mar,10700,6600,17300
7446,7447,21-10-2020 15:12:47.029628,Saludable · Desayunos,Maracuyá,13000,6700,19700
7447,7448,21-10-2020 15:12:47.356155,Parrilla,Coquitas,45800,5600,51400
7448,7449,21-10-2020 15:12:47.733429,Sushi,Sushi Reel,65000,4700,69700
7449,7450,21-10-2020 15:12:48.060066,Hamburguesas · Alitas,Beer,65000,6600,71600
7450,7451,21-10-2020 15:12:48.237799,Pizza,pizza andante,35000,4200,39200
7451,7452,21-10-2020 15:12:48.565556,Saludable · Parrilla,The Angels Grill and Drinks,15000,6200,21200
7452,7453,21-10-2020 15:12:48.693148,Desayunos · Jugos y Batidos,Frutiwow,53900,4100,58000
7453,7454,21-10-2020 15:12:48.970250,Saludable · Desayunos,Copacabana Açai Bowls,65000,3000,68000
7454,7455,21-10-2020 15:12:49.097801,Saludable · Típica,Saludable Mrg,9000,5800,14800
7455,7456,21-10-2020 15:12:49.425447,Pollo,Oliva Va,18900,5600,24500
7456,7457,21-10-2020 15:12:49.552804,Típica · Parrilla,Typykos,24300,6000,30300
7457,7458,21-10-2020 15:12:49.880193,Poke,Poke Go,24200,4600,28800
7458,7459,21-10-2020 15:12:50.107747,Desayunos · Panadería,Santa Juana Food Bar,37900,5900,43800
7459,7460,21-10-2020 15:12:50.485168,Mexicana,Hidalgo Taquería,23000,4900,27900
7460,7461,21-10-2020 15:12:50.862746,Desayunos,Cafetería el Kippe,7500,3200,10700
7461,7462,21-10-2020 15:12:51.189911,Desayunos · Pescados y Mariscos,Gypsy Bistro,53900,4500,58400
7462,7463,21-10-2020 15:12:51.417632,Desayunos · Típica,Desayunadero de la 42,7500,5900,13400
7463,7464,21-10-2020 15:12:51.543641,Crepes,La Chabatta,34500,5900,40400
7464,7465,21-10-2020 15:12:51.821019,Saludable · Desayunos,Re.al Alimentos Reales,17800,4000,21800
7465,7466,21-10-2020 15:12:51.998107,Típica · Parrilla,Typykos,34500,6000,40500
7466,7467,21-10-2020 15:12:52.175597,Pizza,Pizza Andante,15000,6300,21300
7467,7468,21-10-2020 15:12:52.402343,Crepes,La Chabatta,23000,5900,28900
7468,7469,21-10-2020 15:12:52.730079,Jugos y Batidos,Pomponio,39700,3600,43300
7469,7470,21-10-2020 15:12:52.906404,Hamburguesas,Bendito Cordero,13600,5800,19400
7470,7471,21-10-2020 15:12:53.133992,Parrilla,Arepaisa de Medellín,24300,5600,29900
7471,7472,21-10-2020 15:12:53.410854,Saludable · Parrilla,The Angels Grill and Drinks,45800,6200,52000
7472,7473,21-10-2020 15:12:53.588779,Saludable,Puro Verde,37900,5700,43600
7473,7474,21-10-2020 15:12:53.815058,Saludable,A2manos,15000,4200,19200
7474,7475,21-10-2020 15:12:54.091944,Desayunos · Panadería,El Pan de Phillippe,29500,4600,34100
7475,7476,21-10-2020 15:12:54.268273,Sushi · Desayunos,Maki Roll,39700,4300,44000
7476,7477,21-10-2020 15:12:54.445147,Desayunos · Panadería,Ficchi Panadería,13000,3100,16100
7477,7478,21-10-2020 15:12:54.621469,Típica,El Cucharón - Tipica,11870,4400,16270
7478,7479,21-10-2020 15:12:54.747992,Postres · Desayunos,Maria Luisa - Postres,31800,4300,36100
7479,7480,21-10-2020 15:12:55.124411,Saludable,Hanai - Bowls Saludables,37900,5900,43800
7480,7481,21-10-2020 15:12:55.401758,Desayunos · Pescados y Mariscos,Gypsy Bistro,29500,4500,34000
7481,7482,21-10-2020 15:12:55.627986,Desayunos · Típica,Alce,39700,4900,44600
7482,7483,21-10-2020 15:12:55.854982,Parrilla,Beraca Parrilla Bbq,7500,5600,13100
7483,7484,21-10-2020 15:12:56.181491,Pizza · Italiana,Piatto - Pizza,31800,6600,38400
7484,7485,21-10-2020 15:12:56.558455,Típica · Parrilla,Parrilla Farandula Gourmet,34500,5100,39600
7485,7486,21-10-2020 15:12:56.834799,Hamburguesas,Monchis - Hamburguesa,39700,4300,44000
7486,7487,21-10-2020 15:12:56.962243,Postres · Desayunos,Protein Bakes,13600,5900,19500
7487,7488,21-10-2020 15:12:57.289086,Desayunos · Típica,Cochon,11870,3300,15170
7488,7489,21-10-2020 15:12:57.465100,Pollo,Chicken House,17800,4200,22000
7489,7490,21-10-2020 15:12:57.741251,Desayunos · Típica,Casa Vieja,45800,6000,51800
7490,7491,21-10-2020 15:12:57.867171,Hamburguesas · Saludable,Restaurant Inn,24300,6100,30400
7491,7492,21-10-2020 15:12:58.243475,Típica,Bendita S,35000,4600,39600
7492,7493,21-10-2020 15:12:58.420126,Postres · Café,Celestino Café,65000,5900,70900
7493,7494,21-10-2020 15:12:58.596218,Típica,El Cucharón - Tipica,53400,4400,57800
7494,7495,21-10-2020 15:12:58.822460,Desayunos · Café,Frambas,70000,3400,73400
7495,7496,21-10-2020 15:12:58.998386,Italiana,F*cking Good Pizza,8900,4200,13100
7496,7497,21-10-2020 15:12:59.274902,Peruana,Uma Cantina Peruana,7500,3200,10700
7497,7498,21-10-2020 15:12:59.401155,Saludable,The Good Rice Bowls,29500,3500,33000
7498,7499,21-10-2020 15:12:59.627320,Desayunos · Panadería,Limarys,13600,6500,20100
7499,7500,21-10-2020 15:12:59.903542,Postres,Beiked,39700,4000,43700
7500,7501,21-10-2020 15:13:00.029475,Típica,Lo Nuestro,45800,3100,48900
7501,7502,21-10-2020 15:13:00.255908,Hamburguesas · Desayunos,El Inglés Gastro Pub,34500,6600,41100
7502,7503,21-10-2020 15:13:00.432593,Peruana · Internacional,La Chifería,23000,6600,29600
7503,7504,21-10-2020 15:13:00.809076,Italiana,Bocatto Di Passo,39700,5000,44700
7504,7505,21-10-2020 15:13:01.135512,Postres · Desayunos,Vivalight Market.,37900,6500,44400
7505,7506,21-10-2020 15:13:01.411913,Desayunos · Empanadas,Empanadas Doraditas.com,35000,3000,38000
7506,7507,21-10-2020 15:13:01.738480,Típica,Lo Nuestro,53900,3100,57000
7507,7508,21-10-2020 15:13:01.964756,Típica · Parrilla,La Parilla de David,35000,3100,38100
7508,7509,21-10-2020 15:13:02.342132,Postres · Desayunos,Gelateria Da Favola,35000,6500,41500
7509,7510,21-10-2020 15:13:02.468045,Peruana,Masivo,70000,5800,75800
7510,7511,21-10-2020 15:13:02.594298,Desayunos · Café,Frambas,13000,3400,16400
7511,7512,21-10-2020 15:13:02.720151,Desayunos · Panadería,Juliana Restaurante,15000,6100,21100
7512,7513,21-10-2020 15:13:03.096777,Pizza,18 Scalini,7500,4300,11800
7513,7514,21-10-2020 15:13:03.273180,Pizza · Italiana,Pisapore - Pizza,11870,6600,18470
7514,7515,21-10-2020 15:13:03.449975,Mexicana,Cantina La 15,23000,4300,27300
7515,7516,21-10-2020 15:13:03.726107,Pescados y Mariscos,Fish Place - Del Mar,39700,5400,45100
7516,7517,21-10-2020 15:13:04.102443,Crepes,San Crepes,29500,4900,34400
7517,7518,21-10-2020 15:13:04.378616,Típica,Sabores De Mi Tierra,11870,5400,17270
7518,7519,21-10-2020 15:13:04.754993,Desayunos · Panadería,Premium Break Bakery,70000,3700,73700
7519,7520,21-10-2020 15:13:04.880884,Desayunos · Internacional,Camilia,24300,3900,28200
7520,7521,21-10-2020 15:13:05.056994,Parrilla,Antojo a Domicilio,37900,5000,42900
7521,7522,21-10-2020 15:13:05.233512,Hamburguesas · Alitas,Beer,11870,6600,18470
7522,7523,21-10-2020 15:13:05.559727,Saludable,Puro Verde,48750,5700,54450
7523,7524,21-10-2020 15:13:05.685732,Desayunos · Café,Matchacha,65000,5900,70900
7524,7525,21-10-2020 15:13:05.962112,Desayunos · Panadería,El Pan de Phillippe,13000,4600,17600
7525,7526,21-10-2020 15:13:06.338404,Hamburguesas · Desayunos,El Inglés Gastro Pub,13600,6600,20200
7526,7527,21-10-2020 15:13:06.614802,Peruana · Internacional,La Chifería,39700,6600,46300
7527,7528,21-10-2020 15:13:06.891018,Desayunos · Jugos y Batidos,Frutiwow,39700,4100,43800
7528,7529,21-10-2020 15:13:07.067046,Internacional,La Esquina con Sabor Parrilla,17800,3000,20800
7529,7530,21-10-2020 15:13:07.444588,Desayunos · Panadería,El Pan de Phillippe,53400,4600,58000
7530,7531,21-10-2020 15:13:07.721365,Desayunos · Típica,Alce,39700,4900,44600
7531,7532,21-10-2020 15:13:08.047646,Pizza,pizza andante,35000,4200,39200
7532,7533,21-10-2020 15:13:08.174108,Postres · Desayunos,Restaurante Cornelia,31800,5500,37300
7533,7534,21-10-2020 15:13:08.450473,Saludable · Desayunos,Fresh Co,48750,5600,54350
7534,7535,21-10-2020 15:13:08.776890,Desayunos · Típica,Peninsula Calentados y Parrilla,31800,3400,35200
7535,7536,21-10-2020 15:13:08.902834,Desayunos · Café,El Gualilo,35000,6200,41200
7536,7537,21-10-2020 15:13:09.229562,Desayunos · Panadería,Choclofee,18900,4700,23600
7537,7538,21-10-2020 15:13:09.455723,Saludable,Amor Propio saludable,18900,4000,22900
7538,7539,21-10-2020 15:13:09.732132,Desayunos · Panadería,Choclofee,13000,4700,17700
7539,7540,21-10-2020 15:13:10.108600,Crepes,La Chabatta,70000,5900,75900
7540,7541,21-10-2020 15:13:10.335070,Desayunos,Bagel Shop,9000,3200,12200
7541,7542,21-10-2020 15:13:10.611814,Desayunos · Panadería,Artesanos,53900,4300,58200
7542,7543,21-10-2020 15:13:10.938544,Saludable,Hanai - Bowls Saludables,15000,5900,20900
7543,7544,21-10-2020 15:13:11.114897,Desayunos,Desayunos en Bogotá,15000,3400,18400
7544,7545,21-10-2020 15:13:11.291076,Postres · Desayunos,KOKOA & co.,11870,4700,16570
7545,7546,21-10-2020 15:13:11.667320,Internacional,Rio Sabores y Experiencias,48750,4100,52850
7546,7547,21-10-2020 15:13:12.043762,Pollo · Desayunos,Piaf,29500,6500,36000
7547,7548,21-10-2020 15:13:12.319896,Desayunos,Fratelli - Desayunos,34500,4600,39100
7548,7549,21-10-2020 15:13:12.547222,Desayunos · Típica,Rojo Gourmet,48750,4700,53450
7549,7550,21-10-2020 15:13:12.924170,Parrilla,Coquitas,15600,5600,21200
7550,7551,21-10-2020 15:13:13.300839,Postres · Desayunos,Jacques Pastelería,13000,5900,18900
7551,7552,21-10-2020 15:13:13.677411,Sushi · Desayunos,Maki Roll,7500,4300,11800
7552,7553,21-10-2020 15:13:13.904079,Desayunos,La Frijolada Desayunos,17800,4400,22200
7553,7554,21-10-2020 15:13:14.230441,Desayunos · Panadería,Juliana Restaurante,70000,6100,76100
7554,7555,21-10-2020 15:13:14.456819,Peruana,Uma Cantina Peruana,29500,3200,32700
7555,7556,21-10-2020 15:13:14.733072,Alta Cocina · Parrilla,Criterión,53400,6000,59400
7556,7557,21-10-2020 15:13:15.059452,Desayunos · Típica,Cochon,70000,3300,73300
7557,7558,21-10-2020 15:13:15.335762,Italiana,F*cking Good Pizza,15600,4200,19800
7558,7559,21-10-2020 15:13:15.511886,Desayunos,Desayunos en Bogotá,9000,3400,12400
7559,7560,21-10-2020 15:13:15.688112,Postres · Desayunos,Cosmo Cookies,18900,5900,24800
7560,7561,21-10-2020 15:13:15.864434,Desayunos · Sánduches,Frutos del Bosque,27800,3500,31300
7561,7562,21-10-2020 15:13:15.990825,Sushi · Asiática,Arigato,15600,5300,20900
7562,7563,21-10-2020 15:13:16.217155,Saludable · Típica,Sopas Mrg,53900,3100,57000
7563,7564,21-10-2020 15:13:16.543697,Hamburguesas,Bendito Cordero,27800,5800,33600
7564,7565,21-10-2020 15:13:16.920632,Desayunos · Típica,Cochon,27800,3300,31100
7565,7566,21-10-2020 15:13:17.297053,Parrilla · Café,Figaro Café/ Restaurante Argentino,8900,5800,14700
7566,7567,21-10-2020 15:13:17.473208,Desayunos · Árabe,Boniato Sabores Vivos,53900,5300,59200
7567,7568,21-10-2020 15:13:17.650289,Desayunos · Típica,D'Porco - Lechona,45800,6300,52100
7568,7569,21-10-2020 15:13:18.026420,Sánduches · China,Peru Mix,24200,5900,30100
7569,7570,21-10-2020 15:13:18.152577,Saludable · Desayunos,Distrito Gourmet,39700,3700,43400
7570,7571,21-10-2020 15:13:18.278771,Desayunos · Panadería,Premium Break Bakery,31800,3700,35500
7571,7572,21-10-2020 15:13:18.404982,Desayunos · Típica,Alce,17800,4900,22700
7572,7573,21-10-2020 15:13:18.731540,Saludable · Desayunos,Fresh Co,15000,5600,20600
7573,7574,21-10-2020 15:13:18.907803,Desayunos,Sunny Breakfast Brunch,13000,4300,17300
7574,7575,21-10-2020 15:13:19.284264,Típica,El Mondongo y Mucho Mas,23000,5600,28600
7575,7576,21-10-2020 15:13:19.660627,Desayunos · Helados,San Giorgio Gelateria,35000,3100,38100
7576,7577,21-10-2020 15:13:19.836968,Panadería,Boul,70000,3100,73100
7577,7578,21-10-2020 15:13:20.013310,Típica,Cazuelitas 93,34500,3900,38400
7578,7579,21-10-2020 15:13:20.339431,Saludable,Ventura Soup y Salad,70000,3800,73800
7579,7580,21-10-2020 15:13:20.666262,Sánduches,Submarin,34500,3800,38300
7580,7581,21-10-2020 15:13:20.842720,Postres · Desayunos,Restaurante Cornelia,24200,5500,29700
7581,7582,21-10-2020 15:13:21.169025,Internacional,Rio Sabores y Experiencias,27800,4100,31900
7582,7583,21-10-2020 15:13:21.545379,Desayunos · Café,Norma's Ice Cream Café,31800,6300,38100
7583,7584,21-10-2020 15:13:21.871575,Postres,Toledo Pastelería,23000,6800,29800
7584,7585,21-10-2020 15:13:22.247683,Pollo · Desayunos,Abasto,70000,3600,73600
7585,7586,21-10-2020 15:13:22.624409,Desayunos · Típica,Cochon,45800,3300,49100
7586,7587,21-10-2020 15:13:22.902362,Típica,Cazuelitas 93,18900,3900,22800
7587,7588,21-10-2020 15:13:23.028705,Hamburguesas,Bendito Cordero,12500,5800,18300
7588,7589,21-10-2020 15:13:23.255321,Desayunos · Típica,Papadió - Colombianas,9000,5700,14700
7589,7590,21-10-2020 15:13:23.381898,Típica,Carbón & Mondongos,24300,6400,30700
7590,7591,21-10-2020 15:13:23.507974,Parrilla,Arroces Maria Paula,10700,6800,17500
7591,7592,21-10-2020 15:13:23.684236,Postres · Café,Loló Coffee & Snacks,35000,4600,39600
7592,7593,21-10-2020 15:13:23.860866,Hamburguesas,Burger Society,34500,4100,38600
7593,7594,21-10-2020 15:13:24.087006,Postres · Desayunos,Jacques Pastelería,23000,5900,28900
7594,7595,21-10-2020 15:13:24.263275,Sánduches · Pescados y Mariscos,Pacific Comida de Mar,18900,4000,22900
7595,7596,21-10-2020 15:13:24.539661,Desayunos · Panadería,Pasteleite,9000,5900,14900
7596,7597,21-10-2020 15:13:24.916320,Desayunos · Panadería,El Pan de Phillippe,11870,4600,16470
7597,7598,21-10-2020 15:13:25.092557,Perros Calientes,Dog Shop - Rapida,9000,4900,13900
7598,7599,21-10-2020 15:13:25.368899,Postres · Desayunos,Cosmo Cookies,27800,5900,33700
7599,7600,21-10-2020 15:13:25.645462,Comida Rápida,Fiesta Digital Andrés,35000,3100,38100
7600,7601,21-10-2020 15:13:25.872058,Desayunos · Panadería,Limarys,9000,6500,15500
7601,7602,21-10-2020 15:13:26.248680,Desayunos,Bagel Shop,27800,3200,31000
7602,7603,21-10-2020 15:13:26.625539,Saludable · Desayunos,Copacabana Açai Bowls,13000,3000,16000
7603,7604,21-10-2020 15:13:26.751917,Desayunos · Panadería,Decofruta,35000,4700,39700
7604,7605,21-10-2020 15:13:27.028651,Desayunos · Panadería,El Pan de Phillippe,29500,4600,34100
7605,7606,21-10-2020 15:13:27.154855,Saludable · Desayunos,Raices Bienestar Gourmet,70000,6600,76600
7606,7607,21-10-2020 15:13:27.331111,Desayunos · Panadería,Juliana Restaurante,37900,6100,44000
7607,7608,21-10-2020 15:13:27.507392,Saludable,MIMA,48750,3700,52450
7608,7609,21-10-2020 15:13:27.833898,Parrilla,Parrilla Pimentón,18900,3400,22300
7609,7610,21-10-2020 15:13:28.161256,Pollo · Saludable,Tremenda Sal y Dulce,18900,6500,25400
7610,7611,21-10-2020 15:13:28.437960,Helados,Buon Gelato,45800,4400,50200
7611,7612,21-10-2020 15:13:28.664358,Desayunos · Típica,Casa Vieja,35000,6000,41000
7612,7613,21-10-2020 15:13:28.790628,Hamburguesas · Saludable,Restaurant Inn,23000,6100,29100
7613,7614,21-10-2020 15:13:29.167057,Típica · Pescados y Mariscos,La Vitualla,48750,6300,55050
7614,7615,21-10-2020 15:13:29.543570,Postres · Desayunos,Maltihelados,23000,6200,29200
7615,7616,21-10-2020 15:13:29.770125,Asiática,TeT,13600,5900,19500
7616,7617,21-10-2020 15:13:29.946385,Pizza,18 Scalini,23000,4300,27300
7617,7618,21-10-2020 15:13:30.072437,Crepes,San Crepes,15000,4900,19900
7618,7619,21-10-2020 15:13:30.298829,Pollo · Sánduches,Pollos Century,29500,3000,32500
7619,7620,21-10-2020 15:13:30.475112,Pollo · China,China Tao,12500,3500,16000
7620,7621,21-10-2020 15:13:30.601630,Desayunos · Internacional,Camilia,11870,3900,15770
7621,7622,21-10-2020 15:13:30.777899,Saludable · Desayunos,Bon Eat - Saludable,70000,4800,74800
7622,7623,21-10-2020 15:13:30.903889,Mexicana,Mexicanachos,29500,3900,33400
7623,7624,21-10-2020 15:13:31.130050,Italiana,F*cking Good Pizza,18900,4200,23100
7624,7625,21-10-2020 15:13:31.456453,Postres,Levelma,53900,6200,60100
7625,7626,21-10-2020 15:13:31.832905,Desayunos · Sánduches,Danilo Colombia,48750,3300,52050
7626,7627,21-10-2020 15:13:32.159280,Típica,Bendita S,65000,4600,69600
7627,7628,21-10-2020 15:13:32.335955,Típica · Parrilla,La Ternera Parrilla,15600,5200,20800
7628,7629,21-10-2020 15:13:32.712660,Típica · Parrilla,Typykos,53900,6000,59900
7629,7630,21-10-2020 15:13:32.838957,Desayunos · Café,Norma's Ice Cream Café,23000,6300,29300
7630,7631,21-10-2020 15:13:33.166599,Postres · Desayunos,Protein Bakes,18900,5900,24800
7631,7632,21-10-2020 15:13:33.443064,Parrilla,Arepaisa de Medellín,9000,5600,14600
7632,7633,21-10-2020 15:13:33.619466,Hamburguesas · Panadería,NYC Burgers,29500,6200,35700
7633,7634,21-10-2020 15:13:33.745956,Pollo · Pescados y Mariscos,Bang Bang Rice,10700,3400,14100
7634,7635,21-10-2020 15:13:33.922404,Desayunos · Helados,San Giorgio Gelateria,17800,3100,20900
7635,7636,21-10-2020 15:13:34.249034,Desayunos · Pescados y Mariscos,Gypsy Bistro,11870,4500,16370
7636,7637,21-10-2020 15:13:34.575720,Saludable · Desayunos,Maracuyá,37900,6700,44600
7637,7638,21-10-2020 15:13:34.751978,Pollo,Señor Fantástico,15600,4700,20300
7638,7639,21-10-2020 15:13:34.978723,Panadería,Boul,53400,3100,56500
7639,7640,21-10-2020 15:13:35.104899,Típica,El Mondongo y Mucho Mas,13000,5600,18600
7640,7641,21-10-2020 15:13:35.281357,Alta Cocina · Italiana,Trattoria de la Plaza,11870,6000,17870
7641,7642,21-10-2020 15:13:35.607968,Desayunos · Típica,Desayunadero de la 42,24200,5900,30100
7642,7643,21-10-2020 15:13:35.834583,Pollo · China,China Tao,9000,3500,12500
7643,7644,21-10-2020 15:13:36.111025,Pollo · Típica,Auyama,23000,3900,26900
7644,7645,21-10-2020 15:13:36.437685,Pizza,pizza andante,27800,4200,32000
7645,7646,21-10-2020 15:13:36.814343,Típica,La Cocina,29500,4600,34100
7646,7647,21-10-2020 15:13:37.040871,Pollo · Desayunos,Caserito Gourmet,23000,6700,29700
7647,7648,21-10-2020 15:13:37.317245,Típica,Lo Nuestro,8900,3100,12000
7648,7649,21-10-2020 15:13:37.493586,Desayunos · Típica,Casa Vieja,45800,6000,51800
7649,7650,21-10-2020 15:13:37.820077,Saludable · Desayunos,Malú,9000,3700,12700
7650,7651,21-10-2020 15:13:38.198083,Alta Cocina · Italiana,Trattoria de la Plaza,11870,6000,17870
7651,7652,21-10-2020 15:13:38.324626,Postres · Desayunos,BagBog Bagels,35000,6400,41400
7652,7653,21-10-2020 15:13:38.551176,Italiana,F*cking Good Pizza,35000,4200,39200
7653,7654,21-10-2020 15:13:38.877734,Típica,Campo Victoria,12500,3000,15500
7654,7655,21-10-2020 15:13:39.254370,Saludable · Desayunos,Malú,11870,3700,15570
7655,7656,21-10-2020 15:13:39.430865,Desayunos · Empanadas,Mis Delicias,11870,3200,15070
7656,7657,21-10-2020 15:13:39.807730,Sushi,Sushi Reel,7500,4700,12200
7657,7658,21-10-2020 15:13:40.084128,Jugos y Batidos,Pomponio,13000,3600,16600
7658,7659,21-10-2020 15:13:40.310814,Desayunos · Típica,Peninsula Calentados y Parrilla,35000,3400,38400
7659,7660,21-10-2020 15:13:40.587333,Postres,La Tertulia,15000,3400,18400
7660,7661,21-10-2020 15:13:40.813796,Parrilla,Restaurante Bar Mi Ranchito,65000,5200,70200
7661,7662,21-10-2020 15:13:40.939901,Saludable · Desayunos,Básico y elemental,11870,5000,16870
7662,7663,21-10-2020 15:13:41.066371,Desayunos,Desayunos en Bogotá,31800,3400,35200
7663,7664,21-10-2020 15:13:41.443037,Saludable · Desayunos,Bon Eat - Saludable,9000,4800,13800
7664,7665,21-10-2020 15:13:41.719914,Desayunos · Empanadas,Mis Delicias,24300,3200,27500
7665,7666,21-10-2020 15:13:41.996263,Postres · Desayunos,La Folie - Postres,18900,3300,22200
7666,7667,21-10-2020 15:13:42.373007,Postres · Desayunos,Café Quindio,18900,5700,24600
7667,7668,21-10-2020 15:13:42.499312,Mexicana,Mexicanachos,53400,3900,57300
7668,7669,21-10-2020 15:13:42.626080,Postres · Desayunos,Restaurante Cornelia,48750,5500,54250
7669,7670,21-10-2020 15:13:42.752732,Desayunos · Jugos y Batidos,Frutiwow,65000,4100,69100
7670,7671,21-10-2020 15:13:43.029271,Saludable · Desayunos,Raices Bienestar Gourmet,35000,6600,41600
7671,7672,21-10-2020 15:13:43.257117,Típica,Baondish,10700,5800,16500
7672,7673,21-10-2020 15:13:43.483984,Pollo · Desayunos,Piaf,35000,6500,41500
7673,7674,21-10-2020 15:13:43.861382,Internacional,La Esquina con Sabor Parrilla,15600,3000,18600
7674,7675,21-10-2020 15:13:44.189070,Desayunos · Italiana,Rceta By Rausch,53900,3600,57500
7675,7676,21-10-2020 15:13:44.466212,Desayunos,El Corral - Desayunos,13600,5000,18600
7676,7677,21-10-2020 15:13:44.643223,Típica,Salsig,12500,5600,18100
7677,7678,21-10-2020 15:13:44.821405,Pollo,Oliva Va,35000,5600,40600
7678,7679,21-10-2020 15:13:45.148377,Desayunos,El Corral - Desayunos,10700,5000,15700
7679,7680,21-10-2020 15:13:45.325324,Desayunos · Panadería,Santa Juana Food Bar,13000,5900,18900
7680,7681,21-10-2020 15:13:45.453085,Internacional,Rio Sabores y Experiencias,53400,4100,57500
7681,7682,21-10-2020 15:13:45.780373,Desayunos · Típica,Calentao Express,13600,6000,19600
7682,7683,21-10-2020 15:13:46.107589,Desayunos · Comida Rápida,La Veneca,13600,6300,19900
7683,7684,21-10-2020 15:13:46.335201,Desayunos,Jacinta Arepas de Huevo,23000,4000,27000
7684,7685,21-10-2020 15:13:46.712580,Postres · Desayunos,Maltihelado,65000,4500,69500
7685,7686,21-10-2020 15:13:46.839731,Saludable · Desayunos,Maracuyá,35000,6700,41700
7686,7687,21-10-2020 15:13:47.117576,Saludable,Amor Propio saludable,35000,4000,39000
7687,7688,21-10-2020 15:13:47.494741,Pollo · China,China Tao,17800,3500,21300
7688,7689,21-10-2020 15:13:47.771941,Pescados y Mariscos,Pescadero Héroes del Mar,23000,6600,29600
7689,7690,21-10-2020 15:13:47.999675,Desayunos · Típica,Criollomania,23000,5200,28200
7690,7691,21-10-2020 15:13:48.328406,Desayunos · Helados,San Giorgio Gelateria,65000,3100,68100
7691,7692,21-10-2020 15:13:48.655846,Pizza,Pastas Laurentina,8900,4800,13700
7692,7693,21-10-2020 15:13:48.883672,Asiática,TeT,29500,5900,35400
7693,7694,21-10-2020 15:13:49.010521,Perros Calientes,Dog Shop - Rapida,53400,4900,58300
7694,7695,21-10-2020 15:13:49.388082,Peruana,Masivo,23000,5800,28800
7695,7696,21-10-2020 15:13:49.716139,Parrilla,Beraca Parrilla Bbq,35000,5600,40600
7696,7697,21-10-2020 15:13:49.893242,Saludable,Ventura Soup y Salad,45800,3800,49600
7697,7698,21-10-2020 15:13:50.020083,Pollo · Sánduches,Pollos Century,10700,3000,13700
7698,7699,21-10-2020 15:13:50.298109,Saludable · Desayunos,Distrito Gourmet,10700,3700,14400
7699,7700,21-10-2020 15:13:50.675856,Mexicana,Hidalgo Taquería,17800,4900,22700
7700,7701,21-10-2020 15:13:50.853042,Postres · Desayunos,Café Quindio,15600,5700,21300
7701,7702,21-10-2020 15:13:51.030876,Desayunos · Jugos y Batidos,Kuriwaji,11870,6300,18170
7702,7703,21-10-2020 15:13:51.158091,Típica · Parrilla,El Santandereano,29500,5200,34700
7703,7704,21-10-2020 15:13:51.535458,Típica,Sabrosito,18900,4000,22900
7704,7705,21-10-2020 15:13:51.713439,Saludable · Desayunos,Bon Eat - Saludable,34500,4800,39300
7705,7706,21-10-2020 15:13:52.040556,Pollo · Saludable,Gratina,13000,4200,17200
7706,7707,21-10-2020 15:13:52.367772,Internacional,Rio Sabores y Experiencias,35000,4100,39100
7707,7708,21-10-2020 15:13:52.545742,Desayunos · Panadería,Decofruta,15600,4700,20300
7708,7709,21-10-2020 15:13:52.722761,Desayunos · Panadería,Ficchi Panadería,70000,3100,73100
7709,7710,21-10-2020 15:13:52.849944,Desayunos,Señor Desayuno,18900,6800,25700
7710,7711,21-10-2020 15:13:52.978048,Saludable · Desayunos,Bawana - Sandwich,15000,3400,18400
7711,7712,21-10-2020 15:13:53.255372,Postres · Desayunos,KOKOA & co.,53900,4700,58600
7712,7713,21-10-2020 15:13:53.434006,Peruana · Internacional,La Chifería,29500,6600,36100
7713,7714,21-10-2020 15:13:53.612175,Asiática,Thai Station,34500,6000,40500
7714,7715,21-10-2020 15:13:53.939556,Desayunos · Típica,Casa Vieja,15000,6000,21000
7715,7716,21-10-2020 15:13:54.066798,Típica,Lo Nuestro,18900,3100,22000
7716,7717,21-10-2020 15:13:54.394929,Desayunos · Típica,Criollomania,29500,5200,34700
7717,7718,21-10-2020 15:13:54.522092,Sushi,Canoa To Go,8900,5900,14800
7718,7719,21-10-2020 15:13:54.799355,Postres · Desayunos,KOKOA & co.,29500,4700,34200
7719,7720,21-10-2020 15:13:55.177311,Típica,La Cocina,65000,4600,69600
7720,7721,21-10-2020 15:13:55.304255,Desayunos,Desayunos en Bogotá,12500,3400,15900
7721,7722,21-10-2020 15:13:55.681718,Desayunos · Típica,D'Porco - Lechona,13600,6300,19900
7722,7723,21-10-2020 15:13:55.959566,Pollo · Saludable,Tremenda Sal y Dulce,53400,6500,59900
7723,7724,21-10-2020 15:13:56.136832,Mexicana,Hidalgo Taquería,37900,4900,42800
7724,7725,21-10-2020 15:13:56.364146,Típica · Pescados y Mariscos,La Vitualla,7500,6300,13800
7725,7726,21-10-2020 15:13:56.692128,Peruana · Internacional,La Chifería,31800,6600,38400
7726,7727,21-10-2020 15:13:56.819380,Alta Cocina · Italiana,Trattoria de la Plaza,11870,6000,17870
7727,7728,21-10-2020 15:13:57.096697,Desayunos,El Fogón Castellano,39700,3200,42900
7728,7729,21-10-2020 15:13:57.474840,Saludable,MIMA,27800,3700,31500
7729,7730,21-10-2020 15:13:57.702066,Postres · Desayunos,Buñuelos nacho,7500,6600,14100
7730,7731,21-10-2020 15:13:57.829116,Típica,Sopitas y Más,53400,4200,57600
7731,7732,21-10-2020 15:13:58.107417,Saludable · Desayunos,Malú,15600,3700,19300
7732,7733,21-10-2020 15:13:58.234559,Desayunos · Café,Moramia,15000,4700,19700
7733,7734,21-10-2020 15:13:58.361810,Desayunos · Árabe,Boniato Sabores Vivos,29500,5300,34800
7734,7735,21-10-2020 15:13:58.491027,Pollo · Sánduches,Pollos Century,48750,3000,51750
7735,7736,21-10-2020 15:13:58.718564,Típica · Parrilla,Toya,31800,4200,36000
7736,7737,21-10-2020 15:13:58.996131,Desayunos · Típica,D´Porco,65000,3900,68900
7737,7738,21-10-2020 15:13:59.124397,Desayunos · Típica,Alce,70000,4900,74900
7738,7739,21-10-2020 15:13:59.401996,Saludable · Desayunos,Básico y Elemental,13600,5900,19500
7739,7740,21-10-2020 15:13:59.779490,Desayunos · Café,El Gualilo,23000,6200,29200
7740,7741,21-10-2020 15:13:59.907461,Típica · Pescados y Mariscos,Arroces Mrg,10700,4300,15000
7741,7742,21-10-2020 15:14:00.285013,Saludable · Desayunos,Bawana - Sandwich,29500,3400,32900
7742,7743,21-10-2020 15:14:00.462330,Desayunos · Empanadas,Mis Delicias,15000,3200,18200
7743,7744,21-10-2020 15:14:00.790455,Postres,Levelma,34500,6200,40700
7744,7745,21-10-2020 15:14:01.117843,Parrilla,OAK Ahumado y Brebajes,8900,6000,14900
7745,7746,21-10-2020 15:14:01.495503,Parrilla,Restaurante Bar Mi Ranchito,15000,5200,20200
7746,7747,21-10-2020 15:14:01.623575,Poke,Poke Go,35000,4600,39600
7747,7748,21-10-2020 15:14:01.800906,Típica · Parrilla,Mi Ranchito Parrilla,23000,4400,27400
7748,7749,21-10-2020 15:14:01.928151,Desayunos · Panadería,Siena Café,48750,3700,52450
7749,7750,21-10-2020 15:14:02.156096,Comida Rápida · Perros Calientes,Similoa - Comida Rapida,13000,3700,16700
7750,7751,21-10-2020 15:14:02.433650,Desayunos · Café,Frambas,13000,3400,16400
7751,7752,21-10-2020 15:14:02.611176,Saludable · Desayunos,Copacabana Açai Bowls,13000,3000,16000
7752,7753,21-10-2020 15:14:02.839353,Desayunos · Panadería,Decofruta,34500,4700,39200
7753,7754,21-10-2020 15:14:03.116760,Pizza,Pastas Laurentina,37900,4800,42700
7754,7755,21-10-2020 15:14:03.344059,Desayunos · Comida Rápida,La Veneca,70000,6300,76300
7755,7756,21-10-2020 15:14:03.472223,Perros Calientes,Dog Shop - Rapida,37900,4900,42800
7756,7757,21-10-2020 15:14:03.601209,Desayunos · Comida Rápida,Chocolatto,17800,3400,21200
7757,7758,21-10-2020 15:14:03.778962,Desayunos · Café,El Gualilo,53400,6200,59600
7758,7759,21-10-2020 15:14:04.157230,Postres · Panadería,RIGHT AWAY FOODS,18900,6600,25500
7759,7760,21-10-2020 15:14:04.384840,Café · Helados,Sofia heladería y café,10700,5800,16500
7760,7761,21-10-2020 15:14:04.762400,Desayunos · Típica,Cochon,7500,3300,10800
7761,7762,21-10-2020 15:14:04.890006,Saludable,Hanai - Bowls Saludables,13000,5900,18900
7762,7763,21-10-2020 15:14:05.217332,Desayunos · Empanadas,Mis Delicias,9000,3200,12200
7763,7764,21-10-2020 15:14:05.344868,Italiana,F*cking Good Pizza,27800,4200,32000
7764,7765,21-10-2020 15:14:05.572920,Desayunos · Café,Libertario Coffee Roasters,12500,4600,17100
7765,7766,21-10-2020 15:14:05.700067,Típica,Bendita S,23000,4600,27600
7766,7767,21-10-2020 15:14:05.877308,Poke,Poke Go,35000,4600,39600
7767,7768,21-10-2020 15:14:06.054992,Crepes,San Crepes,13600,4900,18500
7768,7769,21-10-2020 15:14:06.182653,Helados,Buon Gelato,13000,4400,17400
7769,7770,21-10-2020 15:14:06.359812,Hamburguesas · Pescados y Mariscos,El Velero,23000,6500,29500
7770,7771,21-10-2020 15:14:06.738015,Alta Cocina · Parrilla,Criterión,10700,6000,16700
7771,7772,21-10-2020 15:14:06.915246,Helados,Buon Gelato,48750,4400,53150
7772,7773,21-10-2020 15:14:07.292840,Saludable,Amor Propio saludable,11870,4000,15870
7773,7774,21-10-2020 15:14:07.570753,Hamburguesas,Bendito Cordero,35000,5800,40800
7774,7775,21-10-2020 15:14:07.948165,Saludable · Típica,Sopas Mrg,23000,3100,26100
7775,7776,21-10-2020 15:14:08.125841,Mexicana,Cantina La 15,35000,4300,39300
7776,7777,21-10-2020 15:14:08.454300,Desayunos · Panadería,Pasteleite,12500,5900,18400
7777,7778,21-10-2020 15:14:08.832979,Típica,Sopitas y Más,9000,4200,13200
7778,7779,21-10-2020 15:14:09.210654,Saludable · Desayunos,Raices Bienestar Gourmet,65000,6600,71600
7779,7780,21-10-2020 15:14:09.538701,Saludable,The Good Rice Bowls,35000,3500,38500
7780,7781,21-10-2020 15:14:09.866332,Saludable · Desayunos,Bawana - Sandwich,17800,3400,21200
7781,7782,21-10-2020 15:14:09.994100,Típica,Carbón & Mondongos,11870,6400,18270
7782,7783,21-10-2020 15:14:10.373317,Pollo · China,China Tao,29500,3500,33000
7783,7784,21-10-2020 15:14:10.651297,Postres · Desayunos,Amelie Helados,8900,6400,15300
7784,7785,21-10-2020 15:14:10.978929,Desayunos · Panadería,Juliana Restaurante,37900,6100,44000
7785,7786,21-10-2020 15:14:11.257244,Parrilla,Beraca Parrilla Bbq,45800,5600,51400
7786,7787,21-10-2020 15:14:11.634716,Desayunos · Panadería,Premium Break Bakery,9000,3700,12700
7787,7788,21-10-2020 15:14:11.962251,Mexicana,Mexicanachos,13600,3900,17500
7788,7789,21-10-2020 15:14:12.190631,Pollo · Desayunos,Piaf,35000,6500,41500
7789,7790,21-10-2020 15:14:12.318178,Desayunos,Sr Buñuelo,53900,6400,60300
7790,7791,21-10-2020 15:14:12.495693,Saludable · Desayunos,Fresh Co,15600,5600,21200
7791,7792,21-10-2020 15:14:12.824335,Desayunos · Mexicana,La Mera Mera - Mexicana,35000,3100,38100
7792,7793,21-10-2020 15:14:13.001636,Pizza · Parrilla,Urban Lunch,7500,4000,11500
7793,7794,21-10-2020 15:14:13.379280,Postres · Desayunos,Maria Luisa - Postres,15000,4300,19300
7794,7795,21-10-2020 15:14:13.757679,Italiana,F*cking Good Pizza,17800,4200,22000
7795,7796,21-10-2020 15:14:13.886061,Desayunos · Sánduches,Garnish,11870,5200,17070
7796,7797,21-10-2020 15:14:14.213819,Desayunos · Café,Moramia,35000,4700,39700
7797,7798,21-10-2020 15:14:14.341751,Saludable · Desayunos,Bon Eat - Saludable,48750,4800,53550
7798,7799,21-10-2020 15:14:14.468943,Internacional,Rio Sabores y Experiencias,31800,4100,35900
7799,7800,21-10-2020 15:14:14.796516,Saludable,A2manos,48750,4200,52950
7800,7801,21-10-2020 15:14:14.974620,Postres,Beiked,31800,4000,35800
7801,7802,21-10-2020 15:14:15.301996,Pizza · Parrilla,Urban Lunch,10700,4000,14700
7802,7803,21-10-2020 15:14:15.629621,Desayunos,Señor Desayuno,35000,6800,41800
7803,7804,21-10-2020 15:14:15.907649,Desayunos · Panadería,Choclofee,24300,4700,29000
7804,7805,21-10-2020 15:14:16.135183,Mexicana,Mexicanachos,53900,3900,57800
7805,7806,21-10-2020 15:14:16.312562,Típica,Bandejas Mrg,18900,3800,22700
7806,7807,21-10-2020 15:14:16.691070,Desayunos · Helados,San Giorgio Gelateria,37900,3100,41000
7807,7808,21-10-2020 15:14:16.868325,Típica · Parrilla,El Santandereano,53400,5200,58600
7808,7809,21-10-2020 15:14:16.995598,Hamburguesas,Burger Society,9000,4100,13100
7809,7810,21-10-2020 15:14:17.222723,Desayunos · Jugos y Batidos,Dont Be Hungry,70000,5600,75600
7810,7811,21-10-2020 15:14:17.599948,Parrilla,Carnes la Zarza,45800,4900,50700
7811,7812,21-10-2020 15:14:17.877556,Típica,Baondish,27800,5800,33600
7812,7813,21-10-2020 15:14:18.054304,Típica · Parrilla,La Ternera Parrilla,65000,5200,70200
7813,7814,21-10-2020 15:14:18.281662,Alta Cocina · Italiana,Trattoria de la Plaza,31800,6000,37800
7814,7815,21-10-2020 15:14:18.458667,Saludable · Parrilla,Box,35000,3700,38700
7815,7816,21-10-2020 15:14:18.835830,Desayunos,Don Leo,53900,6000,59900
7816,7817,21-10-2020 15:14:19.063793,Típica · Pescados y Mariscos,Arroces Mrg,24300,4300,28600
7817,7818,21-10-2020 15:14:19.441433,Postres · Desayunos,Sweet Tale,9000,5800,14800
7818,7819,21-10-2020 15:14:19.668346,Saludable · Desayunos,Básico y Elemental,13000,5900,18900
7819,7820,21-10-2020 15:14:19.795168,Típica · Parrilla,La Ternera Parrilla,37900,5200,43100
7820,7821,21-10-2020 15:14:19.972323,Saludable,Amor Propio saludable,35000,4000,39000
7821,7822,21-10-2020 15:14:20.099183,Pescados y Mariscos,La Gran Cazuela,11870,3200,15070
7822,7823,21-10-2020 15:14:20.276356,Desayunos · Panadería,Santa Juana Food Bar,34500,5900,40400
7823,7824,21-10-2020 15:14:20.503410,Hamburguesas · Pescados y Mariscos,El Velero,24300,6500,30800
7824,7825,21-10-2020 15:14:20.880553,Desayunos · Típica,D´Porco,8900,3900,12800
7825,7826,21-10-2020 15:14:21.007675,Desayunos · Panadería,Pasteleite,23000,5900,28900
7826,7827,21-10-2020 15:14:21.384957,Desayunos · Parrilla,Mi Patria,12500,4600,17100
7827,7828,21-10-2020 15:14:21.512059,Saludable · Desayunos,Malú,65000,3700,68700
7828,7829,21-10-2020 15:14:21.789579,Desayunos · Sánduches,Danilo Colombia,24300,3300,27600
7829,7830,21-10-2020 15:14:21.916309,Sushi · Asiática,Tu Sushi,53400,6400,59800
7830,7831,21-10-2020 15:14:22.293737,Saludable · Parrilla,The Angels Grill and Drinks,23000,6200,29200
7831,7832,21-10-2020 15:14:22.420758,Postres · Desayunos,Café Quindio,18900,5700,24600
7832,7833,21-10-2020 15:14:22.598085,Desayunos,El Fogón Castellano,48750,3200,51950
7833,7834,21-10-2020 15:14:22.975422,Saludable,Ventura Soup y Salad,34500,3800,38300
7834,7835,21-10-2020 15:14:23.102834,Saludable,Ventura Soup y Salad,53400,3800,57200
7835,7836,21-10-2020 15:14:23.380206,Desayunos · Parrilla,Mi Patria,35000,4600,39600
7836,7837,21-10-2020 15:14:23.557596,Alta Cocina · Parrilla,Criterión,12500,6000,18500
7837,7838,21-10-2020 15:14:23.784554,Desayunos · Sánduches,Garnish,17800,5200,23000
7838,7839,21-10-2020 15:14:24.061427,Helados,Orso To Go,10700,6800,17500
7839,7840,21-10-2020 15:14:24.238287,Típica,Sabores De Mi Tierra,10700,5400,16100
7840,7841,21-10-2020 15:14:24.565422,Desayunos · Panadería,Ficchi Panadería,17800,3100,20900
7841,7842,21-10-2020 15:14:24.792260,Típica,El Cucharón - Tipica,35000,4400,39400
7842,7843,21-10-2020 15:14:25.119398,Desayunos · Panadería,Juliana Restaurante,45800,6100,51900
7843,7844,21-10-2020 15:14:25.246445,Parrilla,Beraca Parrilla Bbq,35000,5600,40600
7844,7845,21-10-2020 15:14:25.623835,Parrilla,Coquitas,37900,5600,43500
7845,7846,21-10-2020 15:14:25.801016,Desayunos,Fratelli - Desayunos,10700,4600,15300
7846,7847,21-10-2020 15:14:26.128199,Panadería,Boul,9000,3100,12100
7847,7848,21-10-2020 15:14:26.455295,Parrilla,OAK Ahumado y Brebajes,13600,6000,19600
7848,7849,21-10-2020 15:14:26.582242,Pollo · Saludable,Yerbabuena,8900,3900,12800
7849,7850,21-10-2020 15:14:26.759183,Desayunos · Panadería,Siena Café,35000,3700,38700
7850,7851,21-10-2020 15:14:27.136459,Saludable,Hanai - Bowls Saludables,35000,5900,40900
7851,7852,21-10-2020 15:14:27.363817,Postres,Toledo Pastelería,15000,6800,21800
7852,7853,21-10-2020 15:14:27.691312,Postres · Café,Celestino Café,18900,5900,24800
7853,7854,21-10-2020 15:14:27.818205,Pollo · Desayunos,Workzone,39700,3100,42800
7854,7855,21-10-2020 15:14:28.195543,Típica,Cazuelitas 93,24300,3900,28200
7855,7856,21-10-2020 15:14:28.572973,Saludable · Desayunos,Fresh Co,53400,5600,59000
7856,7857,21-10-2020 15:14:28.950560,Desayunos · Panadería,Pasteleite,24200,5900,30100
7857,7858,21-10-2020 15:14:29.328879,Postres · Desayunos,Café Quindio,39700,5700,45400
7858,7859,21-10-2020 15:14:29.606139,Desayunos · Café,Aromacafé el Placer de Compartir,10700,5000,15700
7859,7860,21-10-2020 15:14:29.983272,Desayunos · Típica,Fogón Sangileño,18900,5000,23900
7860,7861,21-10-2020 15:14:30.160613,Pollo · Desayunos,Workzone,65000,3100,68100
7861,7862,21-10-2020 15:14:30.537937,Típica,El Cucharón - Tipica,13000,4400,17400
7862,7863,21-10-2020 15:14:30.715106,Desayunos · Café,Moramia,17800,4700,22500
7863,7864,21-10-2020 15:14:31.042373,Parrilla,Arepaisa de Medellín,34500,5600,40100
7864,7865,21-10-2020 15:14:31.169498,Sánduches · Pescados y Mariscos,Pacific Comida de Mar,17800,4000,21800
7865,7866,21-10-2020 15:14:31.546396,Desayunos · Café,Libertario Coffee Roasters,23000,4600,27600
7866,7867,21-10-2020 15:14:31.823413,Peruana · Internacional,La Chifería,10700,6600,17300
7867,7868,21-10-2020 15:14:31.950367,Saludable,Ventura Soup y Salad,13000,3800,16800
7868,7869,21-10-2020 15:14:32.177478,Desayunos · Café,Aromacafé el Placer de Compartir,53900,5000,58900
7869,7870,21-10-2020 15:14:32.504504,Postres · Desayunos,Buñuelos nacho,53900,6600,60500
7870,7871,21-10-2020 15:14:32.781935,Saludable · Desayunos,Bawana - Sandwich,70000,3400,73400
7871,7872,21-10-2020 15:14:32.959000,Mexicana,Mexicanachos,53400,3900,57300
7872,7873,21-10-2020 15:14:33.236348,Desayunos,Cafetería el Kippe,53400,3200,56600
7873,7874,21-10-2020 15:14:33.513901,Saludable · Desayunos,Bawana - Sandwich,37900,3400,41300
7874,7875,21-10-2020 15:14:33.891292,Comida Rápida · Perros Calientes,Similoa - Comida Rapida,24300,3700,28000
7875,7876,21-10-2020 15:14:34.118724,Pollo,Señor Fantástico,8900,4700,13600
7876,7877,21-10-2020 15:14:34.346994,Postres · Desayunos,Sweet Tale,65000,5800,70800
7877,7878,21-10-2020 15:14:34.724386,Saludable · Desayunos,Libre de Culpa,34500,4000,38500
7878,7879,21-10-2020 15:14:35.051406,Pescados y Mariscos,La Gran Cazuela,12500,3200,15700
7879,7880,21-10-2020 15:14:35.328460,Desayunos · Típica,Fogón Sangileño,11870,5000,16870
7880,7881,21-10-2020 15:14:35.656447,Desayunos · Típica,La Frijolada,35000,4500,39500
7881,7882,21-10-2020 15:14:35.933837,Típica · Parrilla,Typykos,12500,6000,18500
7882,7883,21-10-2020 15:14:36.211227,Pizza · Italiana,Piatto - Pizza,13600,6600,20200
7883,7884,21-10-2020 15:14:36.388318,Postres · Desayunos,Gelateria Da Favola,70000,6500,76500
7884,7885,21-10-2020 15:14:36.515700,Sushi · Desayunos,Maki Roll,18900,4300,23200
7885,7886,21-10-2020 15:14:36.743133,Típica,Sabores De Mi Tierra,27800,5400,33200
7886,7887,21-10-2020 15:14:36.920330,Panadería,Boul,9000,3100,12100
7887,7888,21-10-2020 15:14:37.097538,Desayunos · Panadería,Artesanos,70000,4300,74300
7888,7889,21-10-2020 15:14:37.424811,Saludable · Desayunos,La Estampilla,39700,6000,45700
7889,7890,21-10-2020 15:14:37.702261,Mexicana,Mexicanachos,65000,3900,68900
7890,7891,21-10-2020 15:14:37.829215,Jugos y Batidos,Pomponio,53900,3600,57500
7891,7892,21-10-2020 15:14:38.156439,Desayunos,Señor Desayuno,18900,6800,25700
7892,7893,21-10-2020 15:14:38.283443,Pizza · Italiana,Piatto - Pizza,9000,6600,15600
7893,7894,21-10-2020 15:14:38.560709,Típica · Parrilla,Toya,65000,4200,69200
7894,7895,21-10-2020 15:14:38.837772,Postres · Café,Celestino Café,7500,5900,13400
7895,7896,21-10-2020 15:14:39.114930,Típica,Sabrosito,45800,4000,49800
7896,7897,21-10-2020 15:14:39.242440,Desayunos · Café,Norma's Ice Cream Café,65000,6300,71300
7897,7898,21-10-2020 15:14:39.370560,Desayunos,Bagel Shop,8900,3200,12100
7898,7899,21-10-2020 15:14:39.647874,Desayunos · Panadería,Decofruta,35000,4700,39700
7899,7900,21-10-2020 15:14:39.875034,Pollo · Sánduches,Pollos Century,31800,3000,34800
7900,7901,21-10-2020 15:14:40.002188,Café · Helados,Sofia heladería y café,11870,5800,17670
7901,7902,21-10-2020 15:14:40.279578,Saludable,MIMA,35000,3700,38700
7902,7903,21-10-2020 15:14:40.657560,Pollo,Chicken House,24300,4200,28500
7903,7904,21-10-2020 15:14:40.985058,Típica · Parrilla,El Portal de la Antigua,15000,5600,20600
7904,7905,21-10-2020 15:14:41.212241,Postres · Café,Celestino Café,8900,5900,14800
7905,7906,21-10-2020 15:14:41.339221,Mexicana,Mexicanachos,12500,3900,16400
7906,7907,21-10-2020 15:14:41.716481,Pollo · Saludable,Yerbabuena,12500,3900,16400
7907,7908,21-10-2020 15:14:42.044038,Saludable,Puro Verde,24200,5700,29900
7908,7909,21-10-2020 15:14:42.221662,Desayunos · Empanadas,Empanadas Doraditas.com,11870,3000,14870
7909,7910,21-10-2020 15:14:42.348794,Típica · Parrilla,Toya,13000,4200,17200
7910,7911,21-10-2020 15:14:42.726479,Típica · Parrilla,La Parilla de David,39700,3100,42800
7911,7912,21-10-2020 15:14:42.954187,Postres · Desayunos,Sharmus,18900,6100,25000
7912,7913,21-10-2020 15:14:43.331618,Saludable · Típica,Saludable Mrg,35000,5800,40800
7913,7914,21-10-2020 15:14:43.508872,Pizza,Pizza Andante,15000,6300,21300
7914,7915,21-10-2020 15:14:43.786377,Pollo · Desayunos,Abasto,15000,3600,18600
7915,7916,21-10-2020 15:14:43.963756,Desayunos · Café,Frambas,7500,3400,10900
7916,7917,21-10-2020 15:14:44.241380,Crepes,San Crepes,10700,4900,15600
7917,7918,21-10-2020 15:14:44.519905,Postres · Desayunos,Café Quindio,23000,5700,28700
7918,7919,21-10-2020 15:14:44.697711,Desayunos · Panadería,Limarys,13600,6500,20100
7919,7920,21-10-2020 15:14:44.925561,Comida Rápida · Perros Calientes,Similoa - Comida Rapida,18900,3700,22600
7920,7921,21-10-2020 15:14:45.103235,Saludable · Desayunos,Distrito Gourmet,70000,3700,73700
7921,7922,21-10-2020 15:14:45.381246,Asiática,TeT,24200,5900,30100
7922,7923,21-10-2020 15:14:45.558228,Típica,La Olla de Barro,53900,5300,59200
7923,7924,21-10-2020 15:14:45.785447,Internacional,La Esquina con Sabor Parrilla,8900,3000,11900
7924,7925,21-10-2020 15:14:46.062762,Postres,La Tertulia,65000,3400,68400
7925,7926,21-10-2020 15:14:46.390332,Hamburguesas · Saludable,Restaurant Inn,12500,6100,18600
7926,7927,21-10-2020 15:14:46.517628,Postres,Levelma,15600,6200,21800
7927,7928,21-10-2020 15:14:46.645096,Helados,Orso To Go,13000,6800,19800
7928,7929,21-10-2020 15:14:46.872275,Desayunos · Típica,Papadió - Colombianas,7500,5700,13200
7929,7930,21-10-2020 15:14:47.149749,Sánduches · China,Peru Mix,15600,5900,21500
7930,7931,21-10-2020 15:14:47.376939,Desayunos · Panadería,Pasteleite,24300,5900,30200
7931,7932,21-10-2020 15:14:47.654211,Pollo · Desayunos,Abasto,8900,3600,12500
7932,7933,21-10-2020 15:14:47.931320,Típica · Parrilla,La Parilla de David,23000,3100,26100
7933,7934,21-10-2020 15:14:48.208565,Saludable · Desayunos,Básico y elemental,13000,5000,18000
7934,7935,21-10-2020 15:14:48.335484,Desayunos · Café,Norma's Ice Cream Café,24300,6300,30600
7935,7936,21-10-2020 15:14:48.462476,Saludable · Desayunos,Distrito Gourmet,17800,3700,21500
7936,7937,21-10-2020 15:14:48.739926,Desayunos · Típica,Rojo Gourmet,15000,4700,19700
7937,7938,21-10-2020 15:14:49.017378,Desayunos · Helados,San Giorgio Gelateria,24200,3100,27300
7938,7939,21-10-2020 15:14:49.344686,Típica,El Mondongo y Mucho Mas,53900,5600,59500
7939,7940,21-10-2020 15:14:49.573288,Desayunos · Panadería,Le Pain Quotidien,65000,3900,68900
7940,7941,21-10-2020 15:14:49.750440,Parrilla,OAK Ahumado y Brebajes,18900,6000,24900
7941,7942,21-10-2020 15:14:50.077987,Mexicana,Mexicanachos,8900,3900,12800
7942,7943,21-10-2020 15:14:50.205080,Desayunos · Típica,Papadió - Colombianas,34500,5700,40200
7943,7944,21-10-2020 15:14:50.532346,Pescados y Mariscos,La Gran Cazuela,48750,3200,51950
7944,7945,21-10-2020 15:14:50.709539,Internacional,La Esquina con Sabor Parrilla,24200,3000,27200
7945,7946,21-10-2020 15:14:50.836722,Hamburguesas · Desayunos,El Inglés Gastro Pub,23000,6600,29600
7946,7947,21-10-2020 15:14:51.214224,Desayunos · Sánduches,Frutos del Bosque,15000,3500,18500
7947,7948,21-10-2020 15:14:51.541404,Hamburguesas,Bendito Cordero,24300,5800,30100
7948,7949,21-10-2020 15:14:51.918421,Saludable · Desayunos,Bawana - Sandwich,15000,3400,18400
7949,7950,21-10-2020 15:14:52.095566,Saludable · Parrilla,The Angels Grill and Drinks,7500,6200,13700
7950,7951,21-10-2020 15:14:52.272924,Postres · Desayunos,Maltihelado,45800,4500,50300
7951,7952,21-10-2020 15:14:52.400351,Desayunos · Panadería,Le Pain Quotidien,45800,3900,49700
7952,7953,21-10-2020 15:14:52.677939,Postres,La Galeta,34500,3000,37500
7953,7954,21-10-2020 15:14:53.005402,Desayunos · Panadería,El Pan de Phillippe,37900,4600,42500
7954,7955,21-10-2020 15:14:53.282763,Pollo · Saludable,Gratina,39700,4200,43900
7955,7956,21-10-2020 15:14:53.410286,Saludable,Amor Propio saludable,8900,4000,12900
7956,7957,21-10-2020 15:14:53.738192,Pollo · Desayunos,Abasto,23000,3600,26600
7957,7958,21-10-2020 15:14:54.066384,Típica · Pescados y Mariscos,La Vitualla,15000,6300,21300
7958,7959,21-10-2020 15:14:54.443906,Desayunos · Italiana,Rceta By Rausch,23000,3600,26600
7959,7960,21-10-2020 15:14:54.772517,Sushi,Sushi Reel,23000,4700,27700
7960,7961,21-10-2020 15:14:55.150711,Pollo,Señor Fantástico,18900,4700,23600
7961,7962,21-10-2020 15:14:55.278359,Parrilla,OAK Ahumado y Brebajes,18900,6000,24900
7962,7963,21-10-2020 15:14:55.655841,Saludable,MIMA,35000,3700,38700
7963,7964,21-10-2020 15:14:55.933089,Parrilla,Arroces Maria Paula,13000,6800,19800
7964,7965,21-10-2020 15:14:56.110287,Panadería,Boul,15000,3100,18100
7965,7966,21-10-2020 15:14:56.287588,Desayunos · Panadería,El Pan de Phillippe,70000,4600,74600
7966,7967,21-10-2020 15:14:56.615087,Desayunos · Café,Frambas,8900,3400,12300
7967,7968,21-10-2020 15:14:56.942610,Italiana,F*cking Good Pizza,11870,4200,16070
7968,7969,21-10-2020 15:14:57.270679,Saludable · Desayunos,Malú,37900,3700,41600
7969,7970,21-10-2020 15:14:57.398511,Desayunos,Cafetería el Kippe,35000,3200,38200
7970,7971,21-10-2020 15:14:57.576365,Crepes,San Crepes,24300,4900,29200
7971,7972,21-10-2020 15:14:57.853714,Poke,Poke Go,7500,4600,12100
7972,7973,21-10-2020 15:14:58.131119,Pizza,Pizza Andante,65000,6300,71300
7973,7974,21-10-2020 15:14:58.508790,Desayunos,Sr Buñuelo,8900,6400,15300
7974,7975,21-10-2020 15:14:58.686070,Típica · Parrilla,Toya,23000,4200,27200
7975,7976,21-10-2020 15:14:59.063410,Saludable · Desayunos,Raices Bienestar Gourmet,9000,6600,15600
7976,7977,21-10-2020 15:14:59.290777,Típica · Parrilla,Mi Ranchito Parrilla,48750,4400,53150
7977,7978,21-10-2020 15:14:59.468247,Desayunos · Sánduches,Danilo Colombia,34500,3300,37800
7978,7979,21-10-2020 15:14:59.595553,Desayunos,Jacinta Arepas de Huevo,23000,4000,27000
7979,7980,21-10-2020 15:14:59.923956,Postres · Desayunos,Vivalight Market.,35000,6500,41500
7980,7981,21-10-2020 15:15:00.101118,Saludable · Desayunos,Básico y elemental,23000,5000,28000
7981,7982,21-10-2020 15:15:00.428743,Saludable,The Good Rice Bowls,35000,3500,38500
7982,7983,21-10-2020 15:15:00.756158,Poke,Poke Go,15600,4600,20200
7983,7984,21-10-2020 15:15:01.083902,Pizza,pizza andante,34500,4200,38700
7984,7985,21-10-2020 15:15:01.261209,Internacional,Rio Sabores y Experiencias,48750,4100,52850
7985,7986,21-10-2020 15:15:01.438435,Pollo,Heart & Cooking,34500,5000,39500
7986,7987,21-10-2020 15:15:01.715817,Típica,La Herencia,23000,5900,28900
7987,7988,21-10-2020 15:15:01.943300,Helados,Orso To Go,39700,6800,46500
7988,7989,21-10-2020 15:15:02.170893,Hamburguesas,Bendito Cordero,48750,5800,54550
7989,7990,21-10-2020 15:15:02.348346,Desayunos · Típica,Fogón Sangileño,53400,5000,58400
7990,7991,21-10-2020 15:15:02.675953,Desayunos,Butter,24200,6700,30900
7991,7992,21-10-2020 15:15:02.853403,Pollo · Pescados y Mariscos,Bang Bang Rice,15000,3400,18400
7992,7993,21-10-2020 15:15:03.180908,Postres · Desayunos,Maltihelados,8900,6200,15100
7993,7994,21-10-2020 15:15:03.458537,Postres · Desayunos,Amelie Helados,65000,6400,71400
7994,7995,21-10-2020 15:15:03.786214,Desayunos,Sunny Breakfast Brunch,12500,4300,16800
7995,7996,21-10-2020 15:15:04.163855,Típica,El Mondongo y Mucho Mas,23000,5600,28600
7996,7997,21-10-2020 15:15:04.291459,Mexicana,Hidalgo Taquería,9000,4900,13900
7997,7998,21-10-2020 15:15:04.569279,Saludable,Ventura Soup y Salad,53900,3800,57700
7998,7999,21-10-2020 15:15:04.896900,Saludable · Desayunos,Bon Eat - Saludable,34500,4800,39300
7999,8000,21-10-2020 15:15:05.274704,Pizza · Italiana,Piatto - Pizza,37900,6600,44500
8000,8001,21-10-2020 15:15:05.502298,Panadería,Boul,65000,3100,68100
8001,8002,21-10-2020 15:15:05.779966,Sushi,Sushi Reel,27800,4700,32500
8002,8003,21-10-2020 15:15:05.957999,Desayunos · Típica,Cochon,24200,3300,27500
8003,8004,21-10-2020 15:15:06.335776,Desayunos · Sánduches,Danilo Colombia,9000,3300,12300
8004,8005,21-10-2020 15:15:06.463630,Sushi,Canoa To Go,10700,5900,16600
8005,8006,21-10-2020 15:15:06.791449,Desayunos,Desayunos en Bogotá,15600,3400,19000
8006,8007,21-10-2020 15:15:06.918873,Postres · Desayunos,Amelie Helados,13600,6400,20000
8007,8008,21-10-2020 15:15:07.296507,Desayunos,El Fogón Castellano,10700,3200,13900
8008,8009,21-10-2020 15:15:07.423911,Desayunos · Café,vereda central calle 99,23000,5700,28700
8009,8010,21-10-2020 15:15:07.651463,Desayunos · Sánduches,Danilo Colombia,17800,3300,21100
8010,8011,21-10-2020 15:15:07.778776,Hamburguesas,Monchis - Hamburguesa,31800,4300,36100
8011,8012,21-10-2020 15:15:07.956265,Saludable · Desayunos,Básico y Elemental,29500,5900,35400
8012,8013,21-10-2020 15:15:08.183848,Típica,Carbón & Mondongos,45800,6400,52200
8013,8014,21-10-2020 15:15:08.361393,Saludable,Puro Verde,37900,5700,43600
8014,8015,21-10-2020 15:15:08.638914,Postres · Desayunos,Restaurante Cornelia,70000,5500,75500
8015,8016,21-10-2020 15:15:08.816329,Parrilla · Café,Gaira Café,35000,4400,39400
8016,8017,21-10-2020 15:15:09.194043,Desayunos · Típica,Peninsula Calentados y Parrilla,24200,3400,27600
8017,8018,21-10-2020 15:15:09.421817,Típica,Bendita S,34500,4600,39100
8018,8019,21-10-2020 15:15:09.749411,Saludable · Típica,Sopas Mrg,53400,3100,56500
8019,8020,21-10-2020 15:15:09.977078,Desayunos · Pescados y Mariscos,Gypsy Bistro,53900,4500,58400
8020,8021,21-10-2020 15:15:10.254899,Desayunos · Árabe,Boniato Sabores Vivos,35000,5300,40300
8021,8022,21-10-2020 15:15:10.633946,Postres,La Galeta,24300,3000,27300
8022,8023,21-10-2020 15:15:11.011884,Saludable · Desayunos,Raices Bienestar Gourmet,13600,6600,20200
8023,8024,21-10-2020 15:15:11.240020,Pescados y Mariscos,Pescadero Héroes del Mar,11870,6600,18470
8024,8025,21-10-2020 15:15:11.418421,Típica,Salsig,13600,5600,19200
8025,8026,21-10-2020 15:15:11.596227,Saludable · Desayunos,Bawana - Sandwich,53900,3400,57300
8026,8027,21-10-2020 15:15:11.924229,Pescados y Mariscos,Pescadero Héroes del Mar,23000,6600,29600
8027,8028,21-10-2020 15:15:12.151758,Parrilla · Café,Gaira Café,31800,4400,36200
8028,8029,21-10-2020 15:15:12.329361,Hamburguesas · Saludable,Restaurant Inn,8900,6100,15000
8029,8030,21-10-2020 15:15:12.656958,Desayunos · Italiana,Rceta By Rausch,27800,3600,31400
8030,8031,21-10-2020 15:15:12.884397,Típica,Sabores De Mi Tierra,11870,5400,17270
8031,8032,21-10-2020 15:15:13.162228,Desayunos · Pescados y Mariscos,Gypsy Bistro,15600,4500,20100
8032,8033,21-10-2020 15:15:13.339621,Postres · Desayunos,Vivalight Market.,7500,6500,14000
8033,8034,21-10-2020 15:15:13.667107,Típica,Bandejas Mrg,35000,3800,38800
8034,8035,21-10-2020 15:15:13.844495,Saludable,A2manos,35000,4200,39200
8035,8036,21-10-2020 15:15:14.021989,Desayunos · Típica,Fogón Sangileño,17800,5000,22800
8036,8037,21-10-2020 15:15:14.249590,Postres,Toledo Pastelería,8900,6800,15700
8037,8038,21-10-2020 15:15:14.477056,Desayunos · Italiana,Rceta By Rausch,34500,3600,38100
8038,8039,21-10-2020 15:15:14.704484,Desayunos,La Frijolada Desayunos,15000,4400,19400
8039,8040,21-10-2020 15:15:14.831825,Desayunos · Panadería,Choclofee,27800,4700,32500
8040,8041,21-10-2020 15:15:15.059324,Saludable,MIMA,24300,3700,28000
8041,8042,21-10-2020 15:15:15.287049,Pollo · Saludable,Gratina,53900,4200,58100
8042,8043,21-10-2020 15:15:15.564907,Postres · Desayunos,BagBog Bagels,24200,6400,30600
8043,8044,21-10-2020 15:15:15.843742,Postres · Panadería,RIGHT AWAY FOODS,7500,6600,14100
8044,8045,21-10-2020 15:15:16.171595,Desayunos · Panadería,Premium Break Bakery,12500,3700,16200
8045,8046,21-10-2020 15:15:16.449302,Parrilla,Arroces Maria Paula,8900,6800,15700
8046,8047,21-10-2020 15:15:16.776822,Alta Cocina · Italiana,Trattoria de la Plaza,15000,6000,21000
8047,8048,21-10-2020 15:15:16.904182,Desayunos · Panadería,Siena Café,10700,3700,14400
8048,8049,21-10-2020 15:15:17.281917,Desayunos · Panadería,Santa Juana Food Bar,45800,5900,51700
8049,8050,21-10-2020 15:15:17.509527,Crepes,La Chabatta,65000,5900,70900
8050,8051,21-10-2020 15:15:17.887254,Pizza,pizza andante,39700,4200,43900
8051,8052,21-10-2020 15:15:18.064861,Desayunos,Fratelli - Desayunos,11870,4600,16470
8052,8053,21-10-2020 15:15:18.242488,Pollo · Desayunos,Workzone,45800,3100,48900
8053,8054,21-10-2020 15:15:18.469948,Desayunos · Café,Moramia,53900,4700,58600
8054,8055,21-10-2020 15:15:18.847529,Postres · Desayunos,Gelateria Da Favola,15600,6500,22100
8055,8056,21-10-2020 15:15:19.025156,Desayunos · Típica,La Frijolada,65000,4500,69500
8056,8057,21-10-2020 15:15:19.152540,Pescados y Mariscos,Fish Place - Del Mar,24300,5400,29700
8057,8058,21-10-2020 15:15:19.380015,Desayunos · Café,El Gualilo,65000,6200,71200
8058,8059,21-10-2020 15:15:19.557868,Postres · Desayunos,Cosmo Cookies,65000,5900,70900
8059,8060,21-10-2020 15:15:19.835633,Crepes,La Chabatta,35000,5900,40900
8060,8061,21-10-2020 15:15:20.013075,Desayunos,Butter,11870,6700,18570
8061,8062,21-10-2020 15:15:20.340819,Saludable · Desayunos,Básico y Elemental,27800,5900,33700
8062,8063,21-10-2020 15:15:20.468146,Típica,Juan Chorizo,13000,3900,16900
8063,8064,21-10-2020 15:15:20.595429,Pollo · Pescados y Mariscos,Bang Bang Rice,15600,3400,19000
8064,8065,21-10-2020 15:15:20.723037,Asiática,Thai Station,8900,6000,14900
8065,8066,21-10-2020 15:15:21.052186,Desayunos · Típica,La Frijolada,70000,4500,74500
8066,8067,21-10-2020 15:15:21.280404,Postres,La Galeta,37900,3000,40900
8067,8068,21-10-2020 15:15:21.558099,Saludable · Desayunos,Libre de Culpa,27800,4000,31800
8068,8069,21-10-2020 15:15:21.685720,Típica · Pescados y Mariscos,Arroces Mrg,24200,4300,28500
8069,8070,21-10-2020 15:15:21.813330,Pizza · Italiana,Pisapore - Pizza,9000,6600,15600
8070,8071,21-10-2020 15:15:22.090741,Desayunos · Panadería,Pasteleite,31800,5900,37700
8071,8072,21-10-2020 15:15:22.368248,Típica,Baondish,15000,5800,20800
8072,8073,21-10-2020 15:15:22.495718,Pollo · Desayunos,Candelina,27800,5300,33100
8073,8074,21-10-2020 15:15:22.823399,Alta Cocina · Postres,La Pinta,7500,4500,12000
8074,8075,21-10-2020 15:15:23.201273,Desayunos,Cafetería el Kippe,31800,3200,35000
8075,8076,21-10-2020 15:15:23.529044,China,China Food Col,45800,3600,49400
8076,8077,21-10-2020 15:15:23.706952,Asiática,TeT,7500,5900,13400
8077,8078,21-10-2020 15:15:23.984995,Postres · Desayunos,Maltihelado,24200,4500,28700
8078,8079,21-10-2020 15:15:24.312817,Alta Cocina · Postres,La Pinta,17800,4500,22300
8079,8080,21-10-2020 15:15:24.440472,Desayunos,Fratelli - Desayunos,39700,4600,44300
8080,8081,21-10-2020 15:15:24.618193,Desayunos · Pescados y Mariscos,Gypsy Bistro,23000,4500,27500
8081,8082,21-10-2020 15:15:24.946145,Alta Cocina · Postres,La Pinta,31800,4500,36300
8082,8083,21-10-2020 15:15:25.173890,Desayunos · Típica,La Frijolada,13600,4500,18100
8083,8084,21-10-2020 15:15:25.451753,Saludable,Amor Propio saludable,23000,4000,27000
8084,8085,21-10-2020 15:15:25.729844,Postres,Beiked,65000,4000,69000
8085,8086,21-10-2020 15:15:25.957561,Desayunos,El Corral - Desayunos,13600,5000,18600
8086,8087,21-10-2020 15:15:26.086263,Desayunos · Típica,90 Calentados,29500,3700,33200
8087,8088,21-10-2020 15:15:26.363888,Desayunos,El Corral - Desayunos,9000,5000,14000
8088,8089,21-10-2020 15:15:26.541263,Saludable,Amor Propio saludable,53400,4000,57400
8089,8090,21-10-2020 15:15:26.868951,Pollo · Sánduches,Pollos Century,23000,3000,26000
8090,8091,21-10-2020 15:15:27.046631,Postres · Desayunos,Maria Luisa - Postres,7500,4300,11800
8091,8092,21-10-2020 15:15:27.324284,Parrilla,El Tambor,12500,6800,19300
8092,8093,21-10-2020 15:15:27.451824,Desayunos · Típica,Papadió - Colombianas,35000,5700,40700
8093,8094,21-10-2020 15:15:27.629552,Saludable · Desayunos,Malú,9000,3700,12700
8094,8095,21-10-2020 15:15:27.857107,Peruana,Masivo,12500,5800,18300
8095,8096,21-10-2020 15:15:28.084976,Sánduches · Pescados y Mariscos,Pacific Comida de Mar,17800,4000,21800
8096,8097,21-10-2020 15:15:28.362583,Saludable · Desayunos,Guadalupe - Fruteria,7500,5900,13400
8097,8098,21-10-2020 15:15:28.740592,Sushi,Umi,15600,5600,21200
8098,8099,21-10-2020 15:15:29.118461,Mexicana,La leyenda mexican kitchen,15600,3200,18800
8099,8100,21-10-2020 15:15:29.396381,Típica · Parrilla,Mi Ranchito Parrilla,34500,4400,38900
8100,8101,21-10-2020 15:15:29.574408,Alta Cocina · Postres,La Pinta,34500,4500,39000
8101,8102,21-10-2020 15:15:29.952597,Desayunos · Café,Norma's Ice Cream Café,35000,6300,41300
8102,8103,21-10-2020 15:15:30.230888,Sánduches · Pescados y Mariscos,Pacific Comida de Mar,53400,4000,57400
8103,8104,21-10-2020 15:15:30.609079,Postres · Desayunos,Restaurante Cornelia,23000,5500,28500
8104,8105,21-10-2020 15:15:30.736664,Pollo · Típica,Auyama,24200,3900,28100
8105,8106,21-10-2020 15:15:31.064351,Parrilla · Café,Figaro Café/ Restaurante Argentino,24200,5800,30000
8106,8107,21-10-2020 15:15:31.393464,Desayunos · Típica,D´Porco,35000,3900,38900
8107,8108,21-10-2020 15:15:31.521601,Pollo · Pescados y Mariscos,Bang Bang Rice,23000,3400,26400
8108,8109,21-10-2020 15:15:31.749286,Parrilla,Rústico Picadería,18900,3800,22700
8109,8110,21-10-2020 15:15:32.127117,Saludable,A2manos,35000,4200,39200
8110,8111,21-10-2020 15:15:32.405339,Desayunos · Sánduches,Frutos del Bosque,29500,3500,33000
8111,8112,21-10-2020 15:15:32.783133,Postres,La Tertulia,17800,3400,21200
8112,8113,21-10-2020 15:15:32.961040,Desayunos · Típica,Casa Vieja,70000,6000,76000
8113,8114,21-10-2020 15:15:33.188777,Típica,La Cocina,7500,4600,12100
8114,8115,21-10-2020 15:15:33.417311,Pollo · Saludable,Tremenda Sal y Dulce,27800,6500,34300
8115,8116,21-10-2020 15:15:33.695144,Desayunos · Jugos y Batidos,Kuriwaji,17800,6300,24100
8116,8117,21-10-2020 15:15:33.822793,Postres · Desayunos,BagBog Bagels,29500,6400,35900
8117,8118,21-10-2020 15:15:34.000528,Desayunos,Desayunos en Bogotá,15000,3400,18400
8118,8119,21-10-2020 15:15:34.178487,Pizza,Pizza Andante,34500,6300,40800
8119,8120,21-10-2020 15:15:34.356242,Pollo · Desayunos,Workzone,35000,3100,38100
8120,8121,21-10-2020 15:15:34.484033,Comida Rápida · Perros Calientes,Similoa - Comida Rapida,15000,3700,18700
8121,8122,21-10-2020 15:15:34.712262,Desayunos · Jugos y Batidos,Dont Be Hungry,48750,5600,54350
8122,8123,21-10-2020 15:15:35.090283,Parrilla,OAK Ahumado y Brebajes,10700,6000,16700
8123,8124,21-10-2020 15:15:35.368230,Saludable · Jugos y Batidos,Berdes Drinks & Salads,15000,3500,18500
8124,8125,21-10-2020 15:15:35.545967,Saludable · Desayunos,Agua Dulce,34500,3700,38200
8125,8126,21-10-2020 15:15:35.773512,Parrilla · Café,Gaira Café,39700,4400,44100
8126,8127,21-10-2020 15:15:35.951199,Pollo · Sánduches,Pollos Century,35000,3000,38000
8127,8128,21-10-2020 15:15:36.078956,Sushi,Umi,13600,5600,19200
8128,8129,21-10-2020 15:15:36.256429,Desayunos · Comida Rápida,La Veneca,53900,6300,60200
8129,8130,21-10-2020 15:15:36.485227,Pollo · Saludable,Tremenda Sal y Dulce,23000,6500,29500
8130,8131,21-10-2020 15:15:36.812825,Internacional,La Esquina con Sabor Parrilla,9000,3000,12000
8131,8132,21-10-2020 15:15:37.140604,Desayunos · Panadería,Ficchi Panadería,48750,3100,51850
8132,8133,21-10-2020 15:15:37.268719,Desayunos,Butter,12500,6700,19200
8133,8134,21-10-2020 15:15:37.546514,Saludable,Hanai - Bowls Saludables,24300,5900,30200
8134,8135,21-10-2020 15:15:37.724331,Parrilla,Coquitas,7500,5600,13100
8135,8136,21-10-2020 15:15:37.852100,Pollo · Saludable,Gratina,9000,4200,13200
8136,8137,21-10-2020 15:15:38.230145,Típica,La Cocina,23000,4600,27600
8137,8138,21-10-2020 15:15:38.358102,Postres · Desayunos,Maltihelados,23000,6200,29200
8138,8139,21-10-2020 15:15:38.485780,Típica,Campo Victoria,70000,3000,73000
8139,8140,21-10-2020 15:15:38.613485,Pizza,Pastas Laurentina,27800,4800,32600
8140,8141,21-10-2020 15:15:38.791333,Postres · Desayunos,Maltihelado,10700,4500,15200
8141,8142,21-10-2020 15:15:39.119291,Hamburguesas · Panadería,NYC Burgers,34500,6200,40700
8142,8143,21-10-2020 15:15:39.347208,Típica · Parrilla,La Parilla de David,45800,3100,48900
8143,8144,21-10-2020 15:15:39.575134,Saludable · Desayunos,Re.al Alimentos Reales,53900,4000,57900
8144,8145,21-10-2020 15:15:39.853075,Desayunos · Panadería,Choclofee,48750,4700,53450
8145,8146,21-10-2020 15:15:40.231597,Típica · Parrilla,Toya,8900,4200,13100
8146,8147,21-10-2020 15:15:40.359393,Típica,Baondish,34500,5800,40300
8147,8148,21-10-2020 15:15:40.587395,Saludable · Jugos y Batidos,Berdes Drinks & Salads,11870,3500,15370
8148,8149,21-10-2020 15:15:40.715401,Desayunos · Parrilla,Mi Patria,11870,4600,16470
8149,8150,21-10-2020 15:15:40.893313,Postres · Desayunos,La Folie - Postres,27800,3300,31100
8150,8151,21-10-2020 15:15:41.021102,Parrilla,Beraca Parrilla Bbq,24300,5600,29900
8151,8152,21-10-2020 15:15:41.199336,Sushi,Kim Pop,27800,5400,33200
8152,8153,21-10-2020 15:15:41.477534,Saludable · Parrilla,Box,8900,3700,12600
8153,8154,21-10-2020 15:15:41.756524,Crepes,La Chabatta,39700,5900,45600
8154,8155,21-10-2020 15:15:42.034325,Postres · Helados,Mahé,13600,6000,19600
8155,8156,21-10-2020 15:15:42.212183,Desayunos · Típica,Calentao Express,48750,6000,54750
8156,8157,21-10-2020 15:15:42.339894,Postres · Desayunos,Sweet Tale,35000,5800,40800
8157,8158,21-10-2020 15:15:42.517620,Postres,Levelma,15000,6200,21200
8158,8159,21-10-2020 15:15:42.645427,Pollo,Señor Fantástico,29500,4700,34200
8159,8160,21-10-2020 15:15:43.023288,Saludable · Desayunos,Fresh Co,18900,5600,24500
8160,8161,21-10-2020 15:15:43.401286,Desayunos · Empanadas,Mis Delicias,45800,3200,49000
8161,8162,21-10-2020 15:15:43.679225,Pescados y Mariscos,La Gran Cazuela,24300,3200,27500
8162,8163,21-10-2020 15:15:43.806926,Desayunos · Sánduches,Danilo Colombia,39700,3300,43000
8163,8164,21-10-2020 15:15:43.984696,Típica · Parrilla,Typykos,31800,6000,37800
8164,8165,21-10-2020 15:15:44.112417,Panadería,Boul,24200,3100,27300
8165,8166,21-10-2020 15:15:44.240544,Típica,Cazuelitas 93,45800,3900,49700
8166,8167,21-10-2020 15:15:44.368270,Parrilla,Arepaisa de Medellín,23000,5600,28600
8167,8168,21-10-2020 15:15:44.495958,Saludable,Puro Verde,23000,5700,28700
8168,8169,21-10-2020 15:15:44.823889,Pollo · Desayunos,Candelina,29500,5300,34800
8169,8170,21-10-2020 15:15:45.051491,Típica,Carbón & Mondongos,35000,6400,41400
8170,8171,21-10-2020 15:15:45.379416,Hamburguesas · Pescados y Mariscos,El Velero,34500,6500,41000
8171,8172,21-10-2020 15:15:45.757436,Pollo,Chicken House,12500,4200,16700
8172,8173,21-10-2020 15:15:45.935404,Asiática,Thai Station,18900,6000,24900
8173,8174,21-10-2020 15:15:46.063355,Típica,Juan Chorizo,39700,3900,43600
8174,8175,21-10-2020 15:15:46.291263,Típica,Cabrito Santandereano,53400,6600,60000
8175,8176,21-10-2020 15:15:46.519282,Sushi,Kim Pop,37900,5400,43300
8176,8177,21-10-2020 15:15:46.647110,Hamburguesas,Burger Society,35000,4100,39100
8177,8178,21-10-2020 15:15:46.875943,Sushi,Umi,48750,5600,54350
8178,8179,21-10-2020 15:15:47.154105,Desayunos,Cafetería el Kippe,45800,3200,49000
8179,8180,21-10-2020 15:15:47.431929,Saludable · Desayunos,Bon Eat - Saludable,27800,4800,32600
8180,8181,21-10-2020 15:15:47.760071,Desayunos · Panadería,Juliana Restaurante,70000,6100,76100
8181,8182,21-10-2020 15:15:47.938149,Postres · Desayunos,Restaurante Cornelia,23000,5500,28500
8182,8183,21-10-2020 15:15:48.266297,Pollo · Saludable,Gratina,15600,4200,19800
8183,8184,21-10-2020 15:15:48.544168,Desayunos · Café,vereda central calle 99,13600,5700,19300
8184,8185,21-10-2020 15:15:48.822275,Típica,Sabores De Mi Tierra,8900,5400,14300
8185,8186,21-10-2020 15:15:48.950206,Desayunos,Archies Desayunos,39700,3100,42800
8186,8187,21-10-2020 15:15:49.127933,Parrilla,El Tambor,53400,6800,60200
8187,8188,21-10-2020 15:15:49.506110,Pollo · Desayunos,Abasto,23000,3600,26600
8188,8189,21-10-2020 15:15:49.634224,Típica · Parrilla,La Parilla de David,35000,3100,38100
8189,8190,21-10-2020 15:15:49.962469,Pizza · Parrilla,Urban Lunch,24200,4000,28200
8190,8191,21-10-2020 15:15:50.140610,Pollo · Saludable,Tremenda Sal y Dulce,34500,6500,41000
8191,8192,21-10-2020 15:15:50.518710,Hamburguesas,Monchis - Hamburguesa,31800,4300,36100
8192,8193,21-10-2020 15:15:50.746878,Saludable · Desayunos,Básico y Elemental,35000,5900,40900
8193,8194,21-10-2020 15:15:51.124944,Desayunos · Típica,Papadió - Colombianas,23000,5700,28700
8194,8195,21-10-2020 15:15:51.502752,Desayunos · Típica,Calentao Express,70000,6000,76000
8195,8196,21-10-2020 15:15:51.630764,Desayunos · Sánduches,Garnish,15000,5200,20200
8196,8197,21-10-2020 15:15:51.858761,Hamburguesas · Saludable,Restaurant Inn,35000,6100,41100
8197,8198,21-10-2020 15:15:52.136695,Saludable · Desayunos,Guadalupe - Fruteria,23000,5900,28900
8198,8199,21-10-2020 15:15:52.364675,Jugos y Batidos,Pomponio,9000,3600,12600
8199,8200,21-10-2020 15:15:52.642768,Postres,Levelma,29500,6200,35700
8200,8201,21-10-2020 15:15:52.770660,Típica,Sopitas y Más,34500,4200,38700
8201,8202,21-10-2020 15:15:53.048646,Desayunos · Jugos y Batidos,Dont Be Hungry,11870,5600,17470
8202,8203,21-10-2020 15:15:53.226604,Típica,Bandejas Mrg,27800,3800,31600
8203,8204,21-10-2020 15:15:53.554551,Desayunos · Panadería,Limarys,15600,6500,22100
8204,8205,21-10-2020 15:15:53.932631,Desayunos · Sánduches,Frutos del Bosque,18900,3500,22400
8205,8206,21-10-2020 15:15:54.260700,Típica · Parrilla,Typykos,8900,6000,14900
8206,8207,21-10-2020 15:15:54.538572,Desayunos · Mexicana,La Mera Mera - Mexicana,34500,3100,37600
8207,8208,21-10-2020 15:15:54.716551,Desayunos,La Frijolada Desayunos,8900,4400,13300
8208,8209,21-10-2020 15:15:55.044414,Postres · Desayunos,Jacques Pastelería,15600,5900,21500
8209,8210,21-10-2020 15:15:55.372684,Postres,Beiked,13600,4000,17600
8210,8211,21-10-2020 15:15:55.650561,Típica · Parrilla,El Portal de la Antigua,24300,5600,29900
8211,8212,21-10-2020 15:15:55.828474,Hamburguesas,Bendito Cordero,13600,5800,19400
8212,8213,21-10-2020 15:15:56.006241,Sánduches · China,Peru Mix,29500,5900,35400
8213,8214,21-10-2020 15:15:56.384233,Postres · Desayunos,Maltihelado,45800,4500,50300
8214,8215,21-10-2020 15:15:56.512066,Hamburguesas · Saludable,Restaurant Inn,70000,6100,76100
8215,8216,21-10-2020 15:15:56.890255,Pollo · Típica,Auyama,35000,3900,38900
8216,8217,21-10-2020 15:15:57.068118,Parrilla,Arroces Maria Paula,37900,6800,44700
8217,8218,21-10-2020 15:15:57.347238,Desayunos,Señor Desayuno,15600,6800,22400
8218,8219,21-10-2020 15:15:57.475145,Crepes,San Crepes,24200,4900,29100
8219,8220,21-10-2020 15:15:57.603179,Desayunos,Desayunos en Bogotá,24200,3400,27600
8220,8221,21-10-2020 15:15:57.831270,Típica · Pescados y Mariscos,La Vitualla,37900,6300,44200
8221,8222,21-10-2020 15:15:58.159249,Desayunos · Café,Norma's Ice Cream Café,35000,6300,41300
8222,8223,21-10-2020 15:15:58.437319,Hamburguesas,Gofi Burger,34500,5100,39600
8223,8224,21-10-2020 15:15:58.565217,Típica · Pescados y Mariscos,Arroces Mrg,53900,4300,58200
8224,8225,21-10-2020 15:15:58.793190,Asiática,Thai Station,29500,6000,35500
8225,8226,21-10-2020 15:15:59.171596,Hamburguesas,Bendito Cordero,17800,5800,23600
8226,8227,21-10-2020 15:15:59.449758,Parrilla,El Tambor,53400,6800,60200
8227,8228,21-10-2020 15:15:59.577616,Pizza,Pizza Andante,39700,6300,46000
8228,8229,21-10-2020 15:15:59.856023,Comida Rápida · Perros Calientes,Similoa - Comida Rapida,70000,3700,73700
8229,8230,21-10-2020 15:16:00.184358,Postres · Helados,Mahé,11870,6000,17870
8230,8231,21-10-2020 15:16:00.312342,Típica,Lo Nuestro,24300,3100,27400
8231,8232,21-10-2020 15:16:00.490460,Desayunos · Comida Rápida,Chocolatto,53400,3400,56800
8232,8233,21-10-2020 15:16:00.868537,Saludable,Puro Verde,70000,5700,75700
8233,8234,21-10-2020 15:16:01.196586,Típica · Pescados y Mariscos,Arroces Mrg,7500,4300,11800
8234,8235,21-10-2020 15:16:01.575056,Postres · Desayunos,BagBog Bagels,27800,6400,34200
8235,8236,21-10-2020 15:16:01.803178,Peruana,Uma Cantina Peruana,24300,3200,27500
8236,8237,21-10-2020 15:16:02.181251,Desayunos · Jugos y Batidos,Frutiwow,15600,4100,19700
8237,8238,21-10-2020 15:16:02.309257,Desayunos,Archies Desayunos,7500,3100,10600
8238,8239,21-10-2020 15:16:02.438373,Alta Cocina · Postres,La Pinta,17800,4500,22300
8239,8240,21-10-2020 15:16:02.666573,Desayunos · Café,Aromacafé el Placer de Compartir,35000,5000,40000
8240,8241,21-10-2020 15:16:02.994644,Postres · Desayunos,Restaurante Cornelia,15600,5500,21100
8241,8242,21-10-2020 15:16:03.172586,Desayunos,Fratelli - Desayunos,53400,4600,58000
8242,8243,21-10-2020 15:16:03.300495,Pescados y Mariscos,Pescadero Héroes del Mar,15000,6600,21600
8243,8244,21-10-2020 15:16:03.428772,Postres,Toledo Pastelería,35000,6800,41800
8244,8245,21-10-2020 15:16:03.807173,Parrilla,Campocina,65000,4600,69600
8245,8246,21-10-2020 15:16:04.185704,Típica,Juan Chorizo,23000,3900,26900
8246,8247,21-10-2020 15:16:04.363927,Desayunos · Típica,Criollomania,53900,5200,59100
8247,8248,21-10-2020 15:16:04.692245,Sushi,Sushi Reel,45800,4700,50500
8248,8249,21-10-2020 15:16:05.020631,Sushi · Asiática,Tu Sushi,10700,6400,17100
8249,8250,21-10-2020 15:16:05.299328,Desayunos · Pescados y Mariscos,Luzí­a - Mediterranea,31800,5700,37500
8250,8251,21-10-2020 15:16:05.427961,Típica · Parrilla,Parrilla Farandula Gourmet,15000,5100,20100
8251,8252,21-10-2020 15:16:05.806484,Helados,Orso To Go,24300,6800,31100
8252,8253,21-10-2020 15:16:05.984547,Postres · Desayunos,Maltihelado,27800,4500,32300
8253,8254,21-10-2020 15:16:06.262783,Saludable,A2manos,53400,4200,57600
8254,8255,21-10-2020 15:16:06.540998,Hamburguesas · Pescados y Mariscos,El Velero,17800,6500,24300
8255,8256,21-10-2020 15:16:06.769430,Desayunos · Típica,La Frijolada,24300,4500,28800
8256,8257,21-10-2020 15:16:06.897480,Desayunos · Sánduches,Frutos del Bosque,18900,3500,22400
8257,8258,21-10-2020 15:16:07.175646,Pollo,Oliva Va,8900,5600,14500
8258,8259,21-10-2020 15:16:07.454976,Postres · Desayunos,Amelie Helados,29500,6400,35900
8259,8260,21-10-2020 15:16:07.833061,Pollo,Heart & Cooking,24300,5000,29300
8260,8261,21-10-2020 15:16:08.211434,Desayunos · Café,Moramia,27800,4700,32500
8261,8262,21-10-2020 15:16:08.439911,Saludable,Ventura Soup y Salad,70000,3800,73800
8262,8263,21-10-2020 15:16:08.667992,Desayunos,Butter,70000,6700,76700
8263,8264,21-10-2020 15:16:08.946178,Peruana,Masivo,53900,5800,59700
8264,8265,21-10-2020 15:16:09.224613,Saludable,Amor Propio saludable,18900,4000,22900
8265,8266,21-10-2020 15:16:09.502939,Típica,Sabrosito,35000,4000,39000
8266,8267,21-10-2020 15:16:09.631202,Desayunos · Típica,La Frijolada,17800,4500,22300
8267,8268,21-10-2020 15:16:09.909624,Típica,Baondish,35000,5800,40800
8268,8269,21-10-2020 15:16:10.187892,Pollo,Heart & Cooking,27800,5000,32800
8269,8270,21-10-2020 15:16:10.566218,Saludable · Desayunos,Maracuyá,15600,6700,22300
8270,8271,21-10-2020 15:16:10.694819,Desayunos · Parrilla,Mi Patria,15600,4600,20200
8271,8272,21-10-2020 15:16:10.923534,Desayunos · Típica,Rojo Gourmet,39700,4700,44400
8272,8273,21-10-2020 15:16:11.051719,Peruana · Internacional,La Chifería,11870,6600,18470
8273,8274,21-10-2020 15:16:11.330138,Comida Rápida · Perros Calientes,Similoa - Comida Rapida,39700,3700,43400
8274,8275,21-10-2020 15:16:11.708661,Desayunos · Panadería,Juliana Restaurante,17800,6100,23900
8275,8276,21-10-2020 15:16:12.037113,Saludable · Desayunos,Copacabana Açai Bowls,24200,3000,27200
8276,8277,21-10-2020 15:16:12.415287,Parrilla,Rústico Picadería,12500,3800,16300
8277,8278,21-10-2020 15:16:12.794708,Parrilla,Beraca Parrilla Bbq,70000,5600,75600
8278,8279,21-10-2020 15:16:13.123376,Internacional,Rio Sabores y Experiencias,53900,4100,58000
8279,8280,21-10-2020 15:16:13.301461,Sushi,Umi,37900,5600,43500
8280,8281,21-10-2020 15:16:13.629802,Mexicana,Hidalgo Taquería,65000,4900,69900
8281,8282,21-10-2020 15:16:14.008746,Desayunos · Mexicana,La Mera Mera - Mexicana,24200,3100,27300
8282,8283,21-10-2020 15:16:14.387093,Sushi · Asiática,Tu Sushi,15000,6400,21400
8283,8284,21-10-2020 15:16:14.565457,Desayunos · Helados,San Giorgio Gelateria,9000,3100,12100
8284,8285,21-10-2020 15:16:14.743630,Desayunos · Típica,Peninsula Calentados y Parrilla,53400,3400,56800
8285,8286,21-10-2020 15:16:14.971799,Típica · Parrilla,El Santandereano,31800,5200,37000
8286,8287,21-10-2020 15:16:15.350303,Pollo · Desayunos,Abasto,35000,3600,38600
8287,8288,21-10-2020 15:16:15.478564,Postres · Panadería,RIGHT AWAY FOODS,23000,6600,29600
8288,8289,21-10-2020 15:16:15.656752,Parrilla,Rústico Picadería,65000,3800,68800
8289,8290,21-10-2020 15:16:15.885058,Saludable · Desayunos,Malú,13600,3700,17300
8290,8291,21-10-2020 15:16:16.063220,Típica,Cazuelitas 93,13600,3900,17500
8291,8292,21-10-2020 15:16:16.191525,Típica · Parrilla,El Santandereano,10700,5200,15900
8292,8293,21-10-2020 15:16:16.319631,Desayunos,Bagel Shop,15000,3200,18200
8293,8294,21-10-2020 15:16:16.497802,Saludable · Parrilla,The Angels Grill and Drinks,45800,6200,52000
8294,8295,21-10-2020 15:16:16.726200,Pizza,Pizza Andante,37900,6300,44200
8295,8296,21-10-2020 15:16:16.854414,Desayunos · Panadería,Decofruta,48750,4700,53450
8296,8297,21-10-2020 15:16:17.232829,Saludable · Típica,Sopas Mrg,17800,3100,20900
8297,8298,21-10-2020 15:16:17.511108,Saludable · Parrilla,Box,23000,3700,26700
8298,8299,21-10-2020 15:16:17.739501,Sánduches,Submarin,9000,3800,12800
8299,8300,21-10-2020 15:16:17.869029,China,China Food Col,15000,3600,18600
8300,8301,21-10-2020 15:16:17.997248,Peruana,Masivo,45800,5800,51600
8301,8302,21-10-2020 15:16:18.175546,Crepes,La Chabatta,12500,5900,18400
8302,8303,21-10-2020 15:16:18.454198,Desayunos · Café,Frambas,53900,3400,57300
8303,8304,21-10-2020 15:16:18.832729,Parrilla,Carnes la Zarza,18900,4900,23800
8304,8305,21-10-2020 15:16:19.211117,Pollo · China,China Tao,13600,3500,17100
8305,8306,21-10-2020 15:16:19.339304,Saludable · Típica,Sopas Mrg,29500,3100,32600
8306,8307,21-10-2020 15:16:19.467748,Típica,La Cocina,11870,4600,16470
8307,8308,21-10-2020 15:16:19.846253,Crepes,San Crepes,24200,4900,29100
8308,8309,21-10-2020 15:16:20.225183,Pollo · Típica,Auyama,39700,3900,43600
8309,8310,21-10-2020 15:16:20.554000,Saludable,MIMA,7500,3700,11200
8310,8311,21-10-2020 15:16:20.932742,Hamburguesas · Saludable,Restaurant Inn,10700,6100,16800
8311,8312,21-10-2020 15:16:21.311413,Pollo,Heart & Cooking,29500,5000,34500
8312,8313,21-10-2020 15:16:21.690075,Desayunos · Panadería,Le Pain Quotidien,12500,3900,16400
8313,8314,21-10-2020 15:16:21.968881,Desayunos · Típica,90 Calentados,35000,3700,38700
8314,8315,21-10-2020 15:16:22.147152,Asiática,TeT,11870,5900,17770
8315,8316,21-10-2020 15:16:22.475586,Perros Calientes,Dog Shop - Rapida,9000,4900,13900
8316,8317,21-10-2020 15:16:22.854142,Pollo · Desayunos,Piaf,8900,6500,15400
8317,8318,21-10-2020 15:16:23.033610,Peruana,Masivo,9000,5800,14800
8318,8319,21-10-2020 15:16:23.261900,Pollo · Saludable,Yerbabuena,35000,3900,38900
8319,8320,21-10-2020 15:16:23.440643,Hamburguesas,Bendito Cordero,8900,5800,14700
8320,8321,21-10-2020 15:16:23.619159,Desayunos · Italiana,Rceta By Rausch,11870,3600,15470
8321,8322,21-10-2020 15:16:23.948011,Desayunos,El Corral - Desayunos,65000,5000,70000
8322,8323,21-10-2020 15:16:24.076711,Postres · Desayunos,Protein Bakes,15600,5900,21500
8323,8324,21-10-2020 15:16:24.455343,Asiática,Thai Station,53400,6000,59400
8324,8325,21-10-2020 15:16:24.834042,Parrilla · Café,Figaro Café/ Restaurante Argentino,12500,5800,18300
8325,8326,21-10-2020 15:16:25.012463,Sánduches,Submarin,13000,3800,16800
8326,8327,21-10-2020 15:16:25.190495,Desayunos · Típica,Papadió - Colombianas,34500,5700,40200
8327,8328,21-10-2020 15:16:25.568809,Parrilla · Café,Gaira Café,34500,4400,38900
8328,8329,21-10-2020 15:16:25.797154,Pescados y Mariscos,Pescadero Héroes del Mar,37900,6600,44500
8329,8330,21-10-2020 15:16:26.075966,Desayunos · Típica,Parrilla Farandula Típico,34500,5900,40400
8330,8331,21-10-2020 15:16:26.304171,Pescados y Mariscos,La Gran Cazuela,35000,3200,38200
8331,8332,21-10-2020 15:16:26.482609,Parrilla,Antojo a Domicilio,23000,5000,28000
8332,8333,21-10-2020 15:16:26.660933,Postres · Desayunos,Vivalight Market.,39700,6500,46200
8333,8334,21-10-2020 15:16:27.039533,Desayunos · Café,Matchacha,18900,5900,24800
8334,8335,21-10-2020 15:16:27.218020,Desayunos · Típica,Rojo Gourmet,35000,4700,39700
8335,8336,21-10-2020 15:16:27.496597,Típica,Bendita S,18900,4600,23500
8336,8337,21-10-2020 15:16:27.825205,Desayunos · Café,Norma's Ice Cream Café,23000,6300,29300
8337,8338,21-10-2020 15:16:28.154923,Sushi · Desayunos,Maki Roll,35000,4300,39300
8338,8339,21-10-2020 15:16:28.383247,Internacional,La Esquina con Sabor Parrilla,23000,3000,26000
8339,8340,21-10-2020 15:16:28.511477,Desayunos,La Frijolada Desayunos,65000,4400,69400
8340,8341,21-10-2020 15:16:28.839845,Postres · Desayunos,BagBog Bagels,70000,6400,76400
8341,8342,21-10-2020 15:16:29.118567,Desayunos · Café,Aromacafé el Placer de Compartir,35000,5000,40000
8342,8343,21-10-2020 15:16:29.296869,Desayunos · Típica,D´Porco,10700,3900,14600
8343,8344,21-10-2020 15:16:29.625460,Postres · Desayunos,Maltihelado,65000,4500,69500
8344,8345,21-10-2020 15:16:29.803763,Parrilla,Campocina,39700,4600,44300
8345,8346,21-10-2020 15:16:30.182241,Postres · Panadería,RIGHT AWAY FOODS,35000,6600,41600
8346,8347,21-10-2020 15:16:30.310553,Típica · Parrilla,El Santandereano,34500,5200,39700
8347,8348,21-10-2020 15:16:30.588945,Saludable · Desayunos,Bawana - Sandwich,48750,3400,52150
8348,8349,21-10-2020 15:16:30.817249,Panadería,Boul,35000,3100,38100
8349,8350,21-10-2020 15:16:30.995668,Postres · Desayunos,Cosmo Cookies,29500,5900,35400
8350,8351,21-10-2020 15:16:31.174277,Sushi,Sushi Reel,24200,4700,28900
8351,8352,21-10-2020 15:16:31.552867,Desayunos · Árabe,Boniato Sabores Vivos,24300,5300,29600
8352,8353,21-10-2020 15:16:31.731572,Desayunos · Internacional,Camilia,11870,3900,15770
8353,8354,21-10-2020 15:16:32.060166,Desayunos · Típica,Fogón Sangileño,18900,5000,23900
8354,8355,21-10-2020 15:16:32.288472,Desayunos · Internacional,Camilia,65000,3900,68900
8355,8356,21-10-2020 15:16:32.667013,Desayunos · Café,Aromacafé el Placer de Compartir,13600,5000,18600
8356,8357,21-10-2020 15:16:32.995652,Desayunos · Panadería,Siena Café,35000,3700,38700
8357,8358,21-10-2020 15:16:33.124277,Crepes,La Chabatta,7500,5900,13400
8358,8359,21-10-2020 15:16:33.254441,Típica,Cabrito Santandereano,13000,6600,19600
8359,8360,21-10-2020 15:16:33.383477,Jugos y Batidos,Pomponio,11870,3600,15470
8360,8361,21-10-2020 15:16:33.612109,Sushi,Kim Pop,15600,5400,21000
8361,8362,21-10-2020 15:16:33.840647,Asiática,TeT,27800,5900,33700
8362,8363,21-10-2020 15:16:34.019059,Desayunos,La Frijolada Desayunos,15000,4400,19400
8363,8364,21-10-2020 15:16:34.147418,Saludable · Desayunos,Agua Dulce,29500,3700,33200
8364,8365,21-10-2020 15:16:34.275766,Parrilla · Internacional,Taperia de la Plaza,9000,5700,14700
8365,8366,21-10-2020 15:16:34.454485,Postres,La Tertulia,53400,3400,56800
8366,8367,21-10-2020 15:16:34.632803,Saludable · Parrilla,The Angels Grill and Drinks,29500,6200,35700
8367,8368,21-10-2020 15:16:34.911205,Saludable · Desayunos,Libre de Culpa,29500,4000,33500
8368,8369,21-10-2020 15:16:35.089811,Pollo · Saludable,Yerbabuena,70000,3900,73900
8369,8370,21-10-2020 15:16:35.217941,Sánduches · China,Peru Mix,45800,5900,51700
8370,8371,21-10-2020 15:16:35.397280,Desayunos · Típica,La Frijolada,18900,4500,23400
8371,8372,21-10-2020 15:16:35.776368,Saludable · Desayunos,Raices Bienestar Gourmet,65000,6600,71600
8372,8373,21-10-2020 15:16:36.156057,Pollo · Desayunos,Candelina,27800,5300,33100
8373,8374,21-10-2020 15:16:36.535717,Desayunos,Fratelli - Desayunos,10700,4600,15300
8374,8375,21-10-2020 15:16:36.714819,Postres · Desayunos,Maria Luisa - Postres,48750,4300,53050
8375,8376,21-10-2020 15:16:37.094289,Desayunos · Pescados y Mariscos,Luzí­a - Mediterranea,13600,5700,19300
8376,8377,21-10-2020 15:16:37.373256,Desayunos · Típica,Fogón Sangileño,23000,5000,28000
8377,8378,21-10-2020 15:16:37.551910,Parrilla,Restaurante Bar Mi Ranchito,15000,5200,20200
8378,8379,21-10-2020 15:16:37.681408,Postres · Desayunos,Jacques Pastelería,65000,5900,70900
8379,8380,21-10-2020 15:16:38.010239,Parrilla · Café,Figaro Café/ Restaurante Argentino,13000,5800,18800
8380,8381,21-10-2020 15:16:38.139389,Postres · Saludable,Ana Rebana,27800,6300,34100
8381,8382,21-10-2020 15:16:38.419405,Desayunos · Panadería,Siena Café,15600,3700,19300
8382,8383,21-10-2020 15:16:38.548728,Pollo · China,China Tao,37900,3500,41400
8383,8384,21-10-2020 15:16:38.877542,Desayunos,Archies Desayunos,53900,3100,57000
8384,8385,21-10-2020 15:16:39.006517,Peruana,Uma Cantina Peruana,15000,3200,18200
8385,8386,21-10-2020 15:16:39.284998,Desayunos · Panadería,Premium Break Bakery,15600,3700,19300
8386,8387,21-10-2020 15:16:39.413574,Postres · Desayunos,La Folie - Postres,12500,3300,15800
8387,8388,21-10-2020 15:16:39.642245,China,China Food Col,24300,3600,27900
8388,8389,21-10-2020 15:16:39.870866,Desayunos · Árabe,Boniato Sabores Vivos,24300,5300,29600
8389,8390,21-10-2020 15:16:40.249696,Desayunos,Don Leo,65000,6000,71000
8390,8391,21-10-2020 15:16:40.578609,Internacional,Rio Sabores y Experiencias,65000,4100,69100
8391,8392,21-10-2020 15:16:40.857325,Parrilla,Arepaisa de Medellín,53400,5600,59000
8392,8393,21-10-2020 15:16:41.135803,Saludable,MIMA,34500,3700,38200
8393,8394,21-10-2020 15:16:41.464379,Desayunos · Café,Frambas,65000,3400,68400
8394,8395,21-10-2020 15:16:41.642750,Saludable,A2manos,8900,4200,13100
8395,8396,21-10-2020 15:16:42.021741,Pollo,Heart & Cooking,7500,5000,12500
8396,8397,21-10-2020 15:16:42.349976,Mexicana,Hidalgo Taquería,37900,4900,42800
8397,8398,21-10-2020 15:16:42.528362,Parrilla,El Tambor,31800,6800,38600
8398,8399,21-10-2020 15:16:42.656966,Pizza,18 Scalini,48750,4300,53050
8399,8400,21-10-2020 15:16:42.985721,Postres · Desayunos,La Folie - Postres,35000,3300,38300
8400,8401,21-10-2020 15:16:43.314243,Hamburguesas · Desayunos,El Inglés Gastro Pub,13600,6600,20200
8401,8402,21-10-2020 15:16:43.544105,Desayunos · Café,Moramia,48750,4700,53450
8402,8403,21-10-2020 15:16:43.773049,Postres · Desayunos,Protein Bakes,15000,5900,20900
8403,8404,21-10-2020 15:16:44.001508,Pollo · Saludable,Tremenda Sal y Dulce,65000,6500,71500
8404,8405,21-10-2020 15:16:44.329898,Sushi,Umi,12500,5600,18100
8405,8406,21-10-2020 15:16:44.508297,Desayunos · Café,vereda central calle 99,7500,5700,13200
8406,8407,21-10-2020 15:16:44.686709,Saludable · Desayunos,Bawana - Sandwich,35000,3400,38400
8407,8408,21-10-2020 15:16:44.965263,Saludable · Desayunos,Distrito Gourmet,13600,3700,17300
8408,8409,21-10-2020 15:16:45.293864,Saludable · Desayunos,La Cesta,11870,4700,16570
8409,8410,21-10-2020 15:16:45.472223,Sánduches · China,Peru Mix,24300,5900,30200
8410,8411,21-10-2020 15:16:45.700727,Jugos y Batidos,Pomponio,9000,3600,12600
8411,8412,21-10-2020 15:16:46.079435,Desayunos · Típica,Alce,18900,4900,23800
8412,8413,21-10-2020 15:16:46.458332,Típica,Bendita S,53400,4600,58000
8413,8414,21-10-2020 15:16:46.586717,Parrilla,Restaurante Bar Mi Ranchito,65000,5200,70200
8414,8415,21-10-2020 15:16:46.715388,Hamburguesas,Monchis - Hamburguesa,65000,4300,69300
8415,8416,21-10-2020 15:16:47.094037,Parrilla,Rústico Picadería,23000,3800,26800
8416,8417,21-10-2020 15:16:47.222490,Desayunos · Sánduches,Garnish,70000,5200,75200
8417,8418,21-10-2020 15:16:47.401238,Parrilla,Coquitas,29500,5600,35100
8418,8419,21-10-2020 15:16:47.780265,Postres · Panadería,RIGHT AWAY FOODS,29500,6600,36100
8419,8420,21-10-2020 15:16:47.958814,Desayunos · Típica,Papadió - Colombianas,10700,5700,16400
8420,8421,21-10-2020 15:16:48.087244,Jugos y Batidos,Pomponio,35000,3600,38600
8421,8422,21-10-2020 15:16:48.416295,Típica · Parrilla,El Santandereano,27800,5200,33000
8422,8423,21-10-2020 15:16:48.646073,Hamburguesas,Gofi Burger,24200,5100,29300
8423,8424,21-10-2020 15:16:48.775004,Pollo · Saludable,Gratina,37900,4200,42100
8424,8425,21-10-2020 15:16:49.154200,Postres · Desayunos,Gelateria Da Favola,13600,6500,20100
8425,8426,21-10-2020 15:16:49.383091,Postres · Desayunos,Protein Bakes,15600,5900,21500
8426,8427,21-10-2020 15:16:49.611861,Desayunos · Café,Frambas,35000,3400,38400
8427,8428,21-10-2020 15:16:49.790639,Desayunos · Típica,Alce,27800,4900,32700
8428,8429,21-10-2020 15:16:49.919213,Asiática,Thai Station,27800,6000,33800
8429,8430,21-10-2020 15:16:50.248227,Desayunos,Jacinta Arepas de Huevo,15000,4000,19000
8430,8431,21-10-2020 15:16:50.627146,Desayunos · Panadería,Le Pain Quotidien,23000,3900,26900
8431,8432,21-10-2020 15:16:50.755635,Parrilla,Carnes la Zarza,27800,4900,32700
8432,8433,21-10-2020 15:16:51.084397,Sánduches,Submarin,39700,3800,43500
8433,8434,21-10-2020 15:16:51.312892,Mexicana,La leyenda mexican kitchen,29500,3200,32700
8434,8435,21-10-2020 15:16:51.441390,Típica,Bandejas Mrg,24300,3800,28100
8435,8436,21-10-2020 15:16:51.819952,Desayunos · Panadería,Choclofee,15600,4700,20300
8436,8437,21-10-2020 15:16:52.098730,Desayunos · Panadería,Pasteleite,11870,5900,17770
8437,8438,21-10-2020 15:16:52.427758,Postres · Desayunos,Café Quindio,23000,5700,28700
8438,8439,21-10-2020 15:16:52.806603,Desayunos · Panadería,Artesanos,35000,4300,39300
8439,8440,21-10-2020 15:16:52.985042,Desayunos · Típica,Desayunadero de la 42,70000,5900,75900
8440,8441,21-10-2020 15:16:53.263778,Típica,Sabrosito,11870,4000,15870
8441,8442,21-10-2020 15:16:53.393008,Típica,Baondish,15600,5800,21400
8442,8443,21-10-2020 15:16:53.672990,Postres · Desayunos,Restaurante Cornelia,53400,5500,58900
8443,8444,21-10-2020 15:16:54.051798,Desayunos,Jacinta Arepas de Huevo,65000,4000,69000
8444,8445,21-10-2020 15:16:54.230536,Peruana · Internacional,La Chifería,15600,6600,22200
8445,8446,21-10-2020 15:16:54.609889,Desayunos · Panadería,Decofruta,27800,4700,32500
8446,8447,21-10-2020 15:16:54.888459,Desayunos · Típica,Calentao Express,29500,6000,35500
8447,8448,21-10-2020 15:16:55.267189,Postres · Desayunos,Maltihelado,12500,4500,17000
8448,8449,21-10-2020 15:16:55.445932,Desayunos · Empanadas,Mis Delicias,11870,3200,15070
8449,8450,21-10-2020 15:16:55.574423,Sushi,Sushi Reel,31800,4700,36500
8450,8451,21-10-2020 15:16:55.903228,Asiática,Thai Station,18900,6000,24900
8451,8452,21-10-2020 15:16:56.232196,Típica · Pescados y Mariscos,La Vitualla,9000,6300,15300
8452,8453,21-10-2020 15:16:56.611494,Alta Cocina · Italiana,Trattoria de la Plaza,23000,6000,29000
8453,8454,21-10-2020 15:16:56.840401,Parrilla · Café,Gaira Café,15600,4400,20000
8454,8455,21-10-2020 15:16:56.968710,Pollo · Sánduches,Pollos Century,34500,3000,37500
8455,8456,21-10-2020 15:16:57.297288,Parrilla · Internacional,Taperia de la Plaza,10700,5700,16400
8456,8457,21-10-2020 15:16:57.626074,Desayunos · Pescados y Mariscos,Luzí­a - Mediterranea,18900,5700,24600
8457,8458,21-10-2020 15:16:57.904687,Hamburguesas · Saludable,Restaurant Inn,27800,6100,33900
8458,8459,21-10-2020 15:16:58.033277,Desayunos · Típica,La Frijolada,53900,4500,58400
8459,8460,21-10-2020 15:16:58.412127,Comida Rápida,Fiesta Digital Andrés,35000,3100,38100
8460,8461,21-10-2020 15:16:58.742353,Desayunos,Sr Buñuelo,10700,6400,17100
8461,8462,21-10-2020 15:16:58.920786,Parrilla,Rústico Picadería,23000,3800,26800
8462,8463,21-10-2020 15:16:59.049196,Saludable,Ventura Soup y Salad,11870,3800,15670
8463,8464,21-10-2020 15:16:59.378035,Desayunos · Mexicana,La Mera Mera - Mexicana,23000,3100,26100
8464,8465,21-10-2020 15:16:59.756808,Desayunos · Mexicana,La Mera Mera - Mexicana,10700,3100,13800
8465,8466,21-10-2020 15:17:00.035297,Típica · Parrilla,La Ternera Parrilla,70000,5200,75200
8466,8467,21-10-2020 15:17:00.414643,Saludable · Parrilla,The Angels Grill and Drinks,45800,6200,52000
8467,8468,21-10-2020 15:17:00.793786,Saludable,MIMA,37900,3700,41600
8468,8469,21-10-2020 15:17:01.022689,Saludable · Parrilla,Box,45800,3700,49500
8469,8470,21-10-2020 15:17:01.306673,Típica,Cazuelitas 93,23000,3900,26900
8470,8471,21-10-2020 15:17:01.585498,Pollo · Desayunos,Workzone,27800,3100,30900
8471,8472,21-10-2020 15:17:01.814674,Hamburguesas · Pescados y Mariscos,El Velero,17800,6500,24300
8472,8473,21-10-2020 15:17:02.144069,Pollo,Señor Fantástico,65000,4700,69700
8473,8474,21-10-2020 15:17:02.473184,Jugos y Batidos,Pomponio,8900,3600,12500
8474,8475,21-10-2020 15:17:02.752054,Típica · Parrilla,Parrilla Farandula Gourmet,17800,5100,22900
8475,8476,21-10-2020 15:17:02.880716,Pizza,pizza andante,15600,4200,19800
8476,8477,21-10-2020 15:17:03.159604,Desayunos · Panadería,Choclofee,17800,4700,22500
8477,8478,21-10-2020 15:17:03.539017,Típica,La Olla de Barro,23000,5300,28300
8478,8479,21-10-2020 15:17:03.919528,Saludable · Desayunos,Bawana - Sandwich,35000,3400,38400
8479,8480,21-10-2020 15:17:04.298536,Desayunos · Típica,D´Porco,34500,3900,38400
8480,8481,21-10-2020 15:17:04.627721,Desayunos · Típica,Fogón Sangileño,70000,5000,75000
8481,8482,21-10-2020 15:17:04.757100,Desayunos · Típica,Desayunadero de la 42,39700,5900,45600
8482,8483,21-10-2020 15:17:05.136489,Parrilla,Arepaisa de Medellín,9000,5600,14600
8483,8484,21-10-2020 15:17:05.265484,Postres · Desayunos,Cosmo Cookies,18900,5900,24800
8484,8485,21-10-2020 15:17:05.644764,Parrilla,Campocina,23000,4600,27600
8485,8486,21-10-2020 15:17:05.923896,Peruana · Internacional,La Chifería,39700,6600,46300
8486,8487,21-10-2020 15:17:06.052604,Saludable,MIMA,29500,3700,33200
8487,8488,21-10-2020 15:17:06.231359,Desayunos · Helados,San Giorgio Gelateria,53900,3100,57000
8488,8489,21-10-2020 15:17:06.410821,Jugos y Batidos,Pomponio,13000,3600,16600
8489,8490,21-10-2020 15:17:06.740384,Desayunos · Italiana,Rceta By Rausch,35000,3600,38600
8490,8491,21-10-2020 15:17:06.918942,Desayunos · Típica,Peninsula Calentados y Parrilla,29500,3400,32900
8491,8492,21-10-2020 15:17:07.197958,Saludable,A2manos,29500,4200,33700
8492,8493,21-10-2020 15:17:07.476799,Postres · Desayunos,Sharmus,10700,6100,16800
8493,8494,21-10-2020 15:17:07.856064,Típica,Cazuelitas 93,27800,3900,31700
8494,8495,21-10-2020 15:17:07.985232,Saludable · Desayunos,Guadalupe - Fruteria,23000,5900,28900
8495,8496,21-10-2020 15:17:08.364354,Desayunos · Panadería,Santa Juana Food Bar,10700,5900,16600
8496,8497,21-10-2020 15:17:08.593196,Postres · Café,Loló Coffee & Snacks,70000,4600,74600
8497,8498,21-10-2020 15:17:08.771819,Pollo · Desayunos,Piaf,53900,6500,60400
8498,8499,21-10-2020 15:17:08.900658,Postres · Desayunos,Aury Postres - Comidas & Picadas,45800,4700,50500
8499,8500,21-10-2020 15:17:09.279856,Jugos y Batidos,Pomponio,15000,3600,18600
8500,8501,21-10-2020 15:17:09.609200,Postres,La Galeta,65000,3000,68000
8501,8502,21-10-2020 15:17:09.988525,Hamburguesas,Monchis - Hamburguesa,18900,4300,23200
8502,8503,21-10-2020 15:17:10.167480,Saludable · Desayunos,Libre de Culpa,31800,4000,35800
8503,8504,21-10-2020 15:17:10.396504,Típica,Lo Nuestro,70000,3100,73100
8504,8505,21-10-2020 15:17:10.625563,Asiática,TeT,9000,5900,14900
8505,8506,21-10-2020 15:17:11.004764,Desayunos · Jugos y Batidos,Dont Be Hungry,23000,5600,28600
8506,8507,21-10-2020 15:17:11.284288,Parrilla,Arroces Maria Paula,10700,6800,17500
8507,8508,21-10-2020 15:17:11.563293,Postres,La Tertulia,13600,3400,17000
8508,8509,21-10-2020 15:17:11.942611,Saludable,Amor Propio saludable,45800,4000,49800
8509,8510,21-10-2020 15:17:12.221735,Postres,Beiked,53400,4000,57400
8510,8511,21-10-2020 15:17:12.350535,Saludable · Desayunos,Agua Dulce,15000,3700,18700
8511,8512,21-10-2020 15:17:12.729699,Saludable · Desayunos,Re.al Alimentos Reales,15600,4000,19600
8512,8513,21-10-2020 15:17:12.958512,Desayunos · Panadería,Pasteleite,29500,5900,35400
8513,8514,21-10-2020 15:17:13.187528,Parrilla,Parrilla Pimentón,45800,3400,49200
8514,8515,21-10-2020 15:17:13.416693,Desayunos · Comida Rápida,Chocolatto,45800,3400,49200
8515,8516,21-10-2020 15:17:13.745989,Pollo · Desayunos,Abasto,53900,3600,57500
8516,8517,21-10-2020 15:17:13.924714,Crepes,San Crepes,35000,4900,39900
8517,8518,21-10-2020 15:17:14.103639,Típica,La Cocina,24300,4600,28900
8518,8519,21-10-2020 15:17:14.385756,Saludable · Desayunos,Bawana - Sandwich,15000,3400,18400
8519,8520,21-10-2020 15:17:14.514514,Mexicana,Cantina La 15,70000,4300,74300
8520,8521,21-10-2020 15:17:14.893590,Desayunos,Jacinta Arepas de Huevo,15000,4000,19000
8521,8522,21-10-2020 15:17:15.272755,Desayunos,Fratelli - Desayunos,37900,4600,42500
8522,8523,21-10-2020 15:17:15.451482,Poke,Poke Go,24300,4600,28900
8523,8524,21-10-2020 15:17:15.630081,Típica · Parrilla,La Ternera Parrilla,29500,5200,34700
8524,8525,21-10-2020 15:17:15.859048,Desayunos · Café,vereda central calle 99,48750,5700,54450
8525,8526,21-10-2020 15:17:16.138193,Típica,Sopitas y Más,23000,4200,27200
8526,8527,21-10-2020 15:17:16.267064,Café · Helados,Sofia heladería y café,23000,5800,28800
8527,8528,21-10-2020 15:17:16.646120,Parrilla,Campocina,13000,4600,17600
8528,8529,21-10-2020 15:17:16.924900,Desayunos,Fratelli - Desayunos,13600,4600,18200
8529,8530,21-10-2020 15:17:17.203863,Desayunos · Jugos y Batidos,Frutiwow,35000,4100,39100
8530,8531,21-10-2020 15:17:17.433211,Típica · Parrilla,Typykos,53400,6000,59400
8531,8532,21-10-2020 15:17:17.711998,Parrilla · Café,Gaira Café,31800,4400,36200
8532,8533,21-10-2020 15:17:17.840862,Desayunos · Café,El Gualilo,29500,6200,35700
8533,8534,21-10-2020 15:17:18.069604,Saludable · Desayunos,Básico y Elemental,45800,5900,51700
8534,8535,21-10-2020 15:17:18.448505,Hamburguesas,Monchis - Hamburguesa,12500,4300,16800
8535,8536,21-10-2020 15:17:18.677477,Café · Helados,Sofia heladería y café,15000,5800,20800
8536,8537,21-10-2020 15:17:19.006505,Pollo · Saludable,Gratina,39700,4200,43900
8537,8538,21-10-2020 15:17:19.185490,Saludable · Desayunos,Copacabana Açai Bowls,37900,3000,40900
8538,8539,21-10-2020 15:17:19.314101,Saludable · Desayunos,Maracuyá,13000,6700,19700
8539,8540,21-10-2020 15:17:19.644300,Pollo,Chicken House,10700,4200,14900
8540,8541,21-10-2020 15:17:19.773161,Postres · Panadería,RIGHT AWAY FOODS,70000,6600,76600
8541,8542,21-10-2020 15:17:20.152263,Desayunos,Butter,24300,6700,31000
8542,8543,21-10-2020 15:17:20.331168,Desayunos · Italiana,Rceta By Rausch,29500,3600,33100
8543,8544,21-10-2020 15:17:20.460007,Desayunos,Fratelli - Desayunos,13000,4600,17600
8544,8545,21-10-2020 15:17:20.839002,Desayunos · Típica,Casa Vieja,12500,6000,18500
8545,8546,21-10-2020 15:17:20.968199,Saludable · Desayunos,Agua Dulce,35000,3700,38700
8546,8547,21-10-2020 15:17:21.197245,Saludable · Desayunos,Básico y elemental,10700,5000,15700
8547,8548,21-10-2020 15:17:21.526266,Desayunos · Italiana,Rceta By Rausch,37900,3600,41500
8548,8549,21-10-2020 15:17:21.805251,Hamburguesas · Desayunos,El Inglés Gastro Pub,27800,6600,34400
8549,8550,21-10-2020 15:17:22.034181,Postres · Desayunos,Sharmus,65000,6100,71100
8550,8551,21-10-2020 15:17:22.213211,Pollo · China,China Tao,11870,3500,15370
8551,8552,21-10-2020 15:17:22.342019,Postres,Toledo Pastelería,24200,6800,31000
8552,8553,21-10-2020 15:17:22.721005,Postres · Desayunos,Vivalight Market.,13000,6500,19500
8553,8554,21-10-2020 15:17:23.049970,Desayunos · Café,Moramia,10700,4700,15400
8554,8555,21-10-2020 15:17:23.178597,Saludable · Desayunos,Re.al Alimentos Reales,11870,4000,15870
8555,8556,21-10-2020 15:17:23.507568,Saludable · Desayunos,Raices Bienestar Gourmet,70000,6600,76600
8556,8557,21-10-2020 15:17:23.836698,Desayunos,Fratelli - Desayunos,27800,4600,32400
8557,8558,21-10-2020 15:17:24.065600,Postres · Desayunos,Restaurante Cornelia,23000,5500,28500
8558,8559,21-10-2020 15:17:24.244459,Pollo · Desayunos,Piaf,53400,6500,59900
8559,8560,21-10-2020 15:17:24.473470,Postres · Desayunos,Aury Postres - Comidas & Picadas,13000,4700,17700
8560,8561,21-10-2020 15:17:24.602370,Parrilla · Café,Gaira Café,27800,4400,32200
8561,8562,21-10-2020 15:17:24.982463,Desayunos,El Fogón Castellano,35000,3200,38200
8562,8563,21-10-2020 15:17:25.111290,Hamburguesas,Burger Society,29500,4100,33600
8563,8564,21-10-2020 15:17:25.390518,Parrilla,OAK Ahumado y Brebajes,17800,6000,23800
8564,8565,21-10-2020 15:17:25.769520,Desayunos · Sánduches,Danilo Colombia,24200,3300,27500
8565,8566,21-10-2020 15:17:26.048364,Desayunos · Panadería,Limarys,13000,6500,19500
8566,8567,21-10-2020 15:17:26.177180,Pollo,Heart & Cooking,11870,5000,16870
8567,8568,21-10-2020 15:17:26.305744,Desayunos · Panadería,El Pan de Phillippe,39700,4600,44300
8568,8569,21-10-2020 15:17:26.484524,Típica,Juan Chorizo,10700,3900,14600
8569,8570,21-10-2020 15:17:26.613684,Saludable,Hanai - Bowls Saludables,9000,5900,14900
8570,8571,21-10-2020 15:17:26.742494,Típica,Sabores De Mi Tierra,24200,5400,29600
8571,8572,21-10-2020 15:17:26.971468,Desayunos · Típica,La Parrilla Dorada Polo,7500,6600,14100
8572,8573,21-10-2020 15:17:27.150283,Pollo,Chicken House,48750,4200,52950
8573,8574,21-10-2020 15:17:27.329021,Típica,Cabrito Santandereano,45800,6600,52400
8574,8575,21-10-2020 15:17:27.707949,Parrilla,Beraca Parrilla Bbq,39700,5600,45300
8575,8576,21-10-2020 15:17:27.986930,Sushi · Desayunos,Maki Roll,7500,4300,11800
8576,8577,21-10-2020 15:17:28.365937,Mexicana,Hidalgo Taquería,53400,4900,58300
8577,8578,21-10-2020 15:17:28.594713,Sushi,Sushi Reel,35000,4700,39700
8578,8579,21-10-2020 15:17:28.723898,Postres · Panadería,RIGHT AWAY FOODS,7500,6600,14100
8579,8580,21-10-2020 15:17:28.952903,Desayunos,Bagel Shop,53400,3200,56600
8580,8581,21-10-2020 15:17:29.081535,Típica,La Herencia,10700,5900,16600
8581,8582,21-10-2020 15:17:29.310314,Típica · Pescados y Mariscos,Arroces Mrg,29500,4300,33800
8582,8583,21-10-2020 15:17:29.639489,Pizza · Italiana,Piatto - Pizza,29500,6600,36100
8583,8584,21-10-2020 15:17:29.818805,Típica,Bendita S,65000,4600,69600
8584,8585,21-10-2020 15:17:30.048924,Saludable,Puro Verde,27800,5700,33500
8585,8586,21-10-2020 15:17:30.378349,Postres · Desayunos,Maltihelados,31800,6200,38000
8586,8587,21-10-2020 15:17:30.657723,Desayunos,Cafetería el Kippe,34500,3200,37700
8587,8588,21-10-2020 15:17:30.886656,Saludable · Desayunos,Malú,24300,3700,28000
8588,8589,21-10-2020 15:17:31.015876,Desayunos,Desayunos en Bogotá,39700,3400,43100
8589,8590,21-10-2020 15:17:31.194952,Típica · Parrilla,El Portal de la Antigua,31800,5600,37400
8590,8591,21-10-2020 15:17:31.323913,Postres · Desayunos,Protein Bakes,35000,5900,40900
8591,8592,21-10-2020 15:17:31.703252,Pollo · Desayunos,Workzone,35000,3100,38100
8592,8593,21-10-2020 15:17:32.032288,Hamburguesas · Saludable,Restaurant Inn,11870,6100,17970
8593,8594,21-10-2020 15:17:32.211310,Parrilla,Restaurante Bar Mi Ranchito,9000,5200,14200
8594,8595,21-10-2020 15:17:32.590653,Típica,Baondish,45800,5800,51600
8595,8596,21-10-2020 15:17:32.819937,Pescados y Mariscos,La Gran Cazuela,13600,3200,16800
8596,8597,21-10-2020 15:17:33.049154,Pollo · Desayunos,Workzone,35000,3100,38100
8597,8598,21-10-2020 15:17:33.428252,Desayunos · Típica,D'Porco - Lechona,65000,6300,71300
8598,8599,21-10-2020 15:17:33.657321,Hamburguesas · Alitas,Beer,15600,6600,22200
8599,8600,21-10-2020 15:17:33.836372,Italiana,Bocatto Di Passo,18900,5000,23900
8600,8601,21-10-2020 15:17:34.115671,Parrilla,Rústico Picadería,24200,3800,28000
8601,8602,21-10-2020 15:17:34.445266,Parrilla · Café,Figaro Café/ Restaurante Argentino,8900,5800,14700
8602,8603,21-10-2020 15:17:34.774603,Típica · Parrilla,El Portal de la Antigua,24200,5600,29800
8603,8604,21-10-2020 15:17:35.105002,Desayunos,Jacinta Arepas de Huevo,23000,4000,27000
8604,8605,21-10-2020 15:17:35.334361,Saludable · Desayunos,Básico y Elemental,24300,5900,30200
8605,8606,21-10-2020 15:17:35.463337,Desayunos · Sánduches,Frutos del Bosque,39700,3500,43200
8606,8607,21-10-2020 15:17:35.592286,Mexicana,La leyenda mexican kitchen,70000,3200,73200
8607,8608,21-10-2020 15:17:35.771413,Desayunos · Panadería,Decofruta,34500,4700,39200
8608,8609,21-10-2020 15:17:36.050345,Parrilla,Campocina,39700,4600,44300
8609,8610,21-10-2020 15:17:36.379203,Parrilla,Campocina,29500,4600,34100
8610,8611,21-10-2020 15:17:36.608528,Peruana,Uma Cantina Peruana,39700,3200,42900
8611,8612,21-10-2020 15:17:36.888016,Desayunos · Comida Rápida,Chocolatto,18900,3400,22300
8612,8613,21-10-2020 15:17:37.167001,Pollo · Desayunos,Piaf,65000,6500,71500
8613,8614,21-10-2020 15:17:37.496145,Saludable · Desayunos,Básico y elemental,10700,5000,15700
8614,8615,21-10-2020 15:17:37.825254,Pescados y Mariscos,La Gran Cazuela,65000,3200,68200
8615,8616,21-10-2020 15:17:38.004187,Postres · Desayunos,Protein Bakes,15000,5900,20900
8616,8617,21-10-2020 15:17:38.183519,Postres · Desayunos,Maltihelados,23000,6200,29200
8617,8618,21-10-2020 15:17:38.413051,Postres · Desayunos,Maria Luisa - Postres,9000,4300,13300
8618,8619,21-10-2020 15:17:38.792772,Pizza · Italiana,Pisapore - Pizza,53400,6600,60000
8619,8620,21-10-2020 15:17:39.122222,Saludable · Desayunos,Guadalupe - Fruteria,23000,5900,28900
8620,8621,21-10-2020 15:17:39.401589,Sushi,Umi,35000,5600,40600
8621,8622,21-10-2020 15:17:39.581734,Parrilla,Arepaisa de Medellín,11870,5600,17470
8622,8623,21-10-2020 15:17:39.860837,Parrilla,El Tambor,31800,6800,38600
8623,8624,21-10-2020 15:17:39.990007,Parrilla,Coquitas,48750,5600,54350
8624,8625,21-10-2020 15:17:40.270529,Pollo,Heart & Cooking,13600,5000,18600
8625,8626,21-10-2020 15:17:40.400334,Desayunos · Panadería,Santa Juana Food Bar,35000,5900,40900
8626,8627,21-10-2020 15:17:40.730089,Pizza,Pastas Laurentina,23000,4800,27800
8627,8628,21-10-2020 15:17:40.858965,Desayunos,Butter,15000,6700,21700
8628,8629,21-10-2020 15:17:41.088187,Saludable · Desayunos,Guadalupe - Fruteria,13000,5900,18900
8629,8630,21-10-2020 15:17:41.367296,Saludable · Jugos y Batidos,Berdes Drinks & Salads,37900,3500,41400
8630,8631,21-10-2020 15:17:41.596427,Saludable · Desayunos,Agua Dulce,10700,3700,14400
8631,8632,21-10-2020 15:17:41.775605,Saludable · Típica,Sopas Mrg,48750,3100,51850
8632,8633,21-10-2020 15:17:42.104900,Desayunos · Jugos y Batidos,Dont Be Hungry,13000,5600,18600
8633,8634,21-10-2020 15:17:42.484185,Postres,La Galeta,12500,3000,15500
8634,8635,21-10-2020 15:17:42.863571,Parrilla,Parrilla Pimentón,53900,3400,57300
8635,8636,21-10-2020 15:17:42.992579,Típica,Sabores De Mi Tierra,23000,5400,28400
8636,8637,21-10-2020 15:17:43.271832,Postres · Desayunos,KOKOA & co.,15600,4700,20300
8637,8638,21-10-2020 15:17:43.601393,Típica,Juan Chorizo,24300,3900,28200
8638,8639,21-10-2020 15:17:43.880688,Desayunos · Típica,La Frijolada,53900,4500,58400
8639,8640,21-10-2020 15:17:44.260269,Postres · Desayunos,Sharmus,34500,6100,40600
8640,8641,21-10-2020 15:17:44.539586,Típica,Juan Chorizo,8900,3900,12800
8641,8642,21-10-2020 15:17:44.868982,Desayunos · Panadería,Siena Café,15000,3700,18700
8642,8643,21-10-2020 15:17:45.148044,Pescados y Mariscos,Fish Place - Del Mar,23000,5400,28400
8643,8644,21-10-2020 15:17:45.277347,Desayunos · Típica,Cochon,23000,3300,26300
8644,8645,21-10-2020 15:17:45.406577,Alta Cocina · Parrilla,Criterión,29500,6000,35500
8645,8646,21-10-2020 15:17:45.535564,Saludable · Jugos y Batidos,Berdes Drinks & Salads,12500,3500,16000
8646,8647,21-10-2020 15:17:45.714927,Desayunos · Café,Norma's Ice Cream Café,53900,6300,60200
8647,8648,21-10-2020 15:17:45.894572,Saludable · Desayunos,Bawana - Sandwich,53400,3400,56800
8648,8649,21-10-2020 15:17:46.174281,Desayunos · Sánduches,Danilo Colombia,8900,3300,12200
8649,8650,21-10-2020 15:17:46.453722,Parrilla,Antojo a Domicilio,29500,5000,34500
8650,8651,21-10-2020 15:17:46.833116,Desayunos · Sánduches,Frutos del Bosque,37900,3500,41400
8651,8652,21-10-2020 15:17:47.162549,Parrilla,Arepaisa de Medellín,35000,5600,40600
8652,8653,21-10-2020 15:17:47.542078,Desayunos · Panadería,Premium Break Bakery,24200,3700,27900
8653,8654,21-10-2020 15:17:47.921377,Desayunos · Típica,Parrilla Farandula Típico,24200,5900,30100
8654,8655,21-10-2020 15:17:48.150393,Parrilla,Parrilla Pimentón,7500,3400,10900
8655,8656,21-10-2020 15:17:48.529648,Desayunos,Señor Desayuno,9000,6800,15800
8656,8657,21-10-2020 15:17:48.808872,Desayunos,Bagel Shop,34500,3200,37700
8657,8658,21-10-2020 15:17:49.138020,Desayunos · Panadería,El Pan de Phillippe,45800,4600,50400
8658,8659,21-10-2020 15:17:49.368221,Saludable · Desayunos,Raices Bienestar Gourmet,11870,6600,18470
8659,8660,21-10-2020 15:17:49.497486,Pescados y Mariscos,Fish Place - Del Mar,27800,5400,33200
8660,8661,21-10-2020 15:17:49.626364,Saludable,MIMA,53400,3700,57100
8661,8662,21-10-2020 15:17:49.805754,Poke,Poke Go,35000,4600,39600
8662,8663,21-10-2020 15:17:49.984671,Asiática,Thai Station,18900,6000,24900
8663,8664,21-10-2020 15:17:50.263829,Típica,Carbón & Mondongos,11870,6400,18270
8664,8665,21-10-2020 15:17:50.393242,Internacional,Rio Sabores y Experiencias,48750,4100,52850
8665,8666,21-10-2020 15:17:50.572283,Desayunos · Café,Norma's Ice Cream Café,13600,6300,19900
8666,8667,21-10-2020 15:17:50.701663,Desayunos,Sr Buñuelo,53400,6400,59800
8667,8668,21-10-2020 15:17:50.880980,Saludable,A2manos,70000,4200,74200
8668,8669,21-10-2020 15:17:51.010279,Desayunos · Empanadas,Mis Delicias,35000,3200,38200
8669,8670,21-10-2020 15:17:51.340061,Desayunos · Café,vereda central calle 99,39700,5700,45400
8670,8671,21-10-2020 15:17:51.620127,Postres · Desayunos,La Folie - Postres,70000,3300,73300
8671,8672,21-10-2020 15:17:51.849666,Saludable · Desayunos,Básico y Elemental,11870,5900,17770
8672,8673,21-10-2020 15:17:52.229455,Saludable,Amor Propio saludable,37900,4000,41900
8673,8674,21-10-2020 15:17:52.558964,Pollo · Desayunos,Workzone,53900,3100,57000
8674,8675,21-10-2020 15:17:52.938763,Desayunos · Sánduches,Danilo Colombia,53400,3300,56700
8675,8676,21-10-2020 15:17:53.068473,Desayunos · Típica,Rojo Gourmet,39700,4700,44400
8676,8677,21-10-2020 15:17:53.398336,Saludable · Desayunos,Raices Bienestar Gourmet,13000,6600,19600
8677,8678,21-10-2020 15:17:53.778326,Desayunos,Sr Buñuelo,53400,6400,59800
8678,8679,21-10-2020 15:17:54.158029,Típica,El Cucharón - Tipica,15600,4400,20000
8679,8680,21-10-2020 15:17:54.287666,Típica,Bendita S,23000,4600,27600
8680,8681,21-10-2020 15:17:54.568547,Crepes,La Chabatta,53900,5900,59800
8681,8682,21-10-2020 15:17:54.848153,Postres · Café,Loló Coffee & Snacks,9000,4600,13600
8682,8683,21-10-2020 15:17:55.128095,Helados,Orso To Go,23000,6800,29800
8683,8684,21-10-2020 15:17:55.307833,Saludable,Hanai - Bowls Saludables,34500,5900,40400
8684,8685,21-10-2020 15:17:55.487124,Típica · Parrilla,El Santandereano,48750,5200,53950
8685,8686,21-10-2020 15:17:55.867032,Mexicana,Hidalgo Taquería,27800,4900,32700
8686,8687,21-10-2020 15:17:56.247052,Desayunos · Típica,Alce,11870,4900,16770
8687,8688,21-10-2020 15:17:56.526760,Parrilla,Restaurante Bar Mi Ranchito,31800,5200,37000
8688,8689,21-10-2020 15:17:56.806676,Sushi,Kim Pop,13600,5400,19000
8689,8690,21-10-2020 15:17:57.036318,Pollo,Heart & Cooking,39700,5000,44700
8690,8691,21-10-2020 15:17:57.416240,Postres · Desayunos,Vivalight Market.,27800,6500,34300
8691,8692,21-10-2020 15:17:57.695816,Pollo · Saludable,Tremenda Sal y Dulce,37900,6500,44400
8692,8693,21-10-2020 15:17:58.075921,Desayunos,Don Leo,29500,6000,35500
8693,8694,21-10-2020 15:17:58.255544,Peruana · Internacional,La Chifería,48750,6600,55350
8694,8695,21-10-2020 15:17:58.385290,Desayunos · Café,Frambas,7500,3400,10900
8695,8696,21-10-2020 15:17:58.664765,Desayunos · Panadería,Limarys,11870,6500,18370
8696,8697,21-10-2020 15:17:59.044526,Peruana,Uma Cantina Peruana,10700,3200,13900
8697,8698,21-10-2020 15:17:59.224197,Postres · Café,Celestino Café,24300,5900,30200
8698,8699,21-10-2020 15:17:59.504175,Saludable · Jugos y Batidos,Berdes Drinks & Salads,8900,3500,12400
8699,8700,21-10-2020 15:17:59.735046,Parrilla,Rústico Picadería,10700,3800,14500
8700,8701,21-10-2020 15:17:59.864444,Desayunos,Archies Desayunos,12500,3100,15600
8701,8702,21-10-2020 15:18:00.244694,Desayunos · Típica,Papadió - Colombianas,8900,5700,14600
8702,8703,21-10-2020 15:18:00.574454,Desayunos · Panadería,Juliana Restaurante,35000,6100,41100
8703,8704,21-10-2020 15:18:00.754116,Postres,Beiked,15600,4000,19600
8704,8705,21-10-2020 15:18:00.883711,Típica,Baondish,65000,5800,70800
8705,8706,21-10-2020 15:18:01.263866,Postres,Levelma,24200,6200,30400
8706,8707,21-10-2020 15:18:01.543537,Típica,Baondish,23000,5800,28800
8707,8708,21-10-2020 15:18:01.723282,Hamburguesas,Bendito Cordero,31800,5800,37600
8708,8709,21-10-2020 15:18:01.902716,Saludable,Ventura Soup y Salad,24300,3800,28100
8709,8710,21-10-2020 15:18:02.133060,Desayunos · Típica,Rojo Gourmet,13000,4700,17700
8710,8711,21-10-2020 15:18:02.413076,Asiática,TeT,23000,5900,28900
8711,8712,21-10-2020 15:18:02.742854,Parrilla,Rústico Picadería,10700,3800,14500
8712,8713,21-10-2020 15:18:02.872212,Desayunos,El Fogón Castellano,48750,3200,51950
8713,8714,21-10-2020 15:18:03.101762,Pollo · Desayunos,Abasto,23000,3600,26600
8714,8715,21-10-2020 15:18:03.381334,Saludable · Parrilla,The Angels Grill and Drinks,65000,6200,71200
8715,8716,21-10-2020 15:18:03.510460,Postres · Café,Celestino Café,8900,5900,14800
8716,8717,21-10-2020 15:18:03.689827,Desayunos · Empanadas,Empanadas Doraditas.com,17800,3000,20800
8717,8718,21-10-2020 15:18:04.069408,Saludable · Desayunos,La Estampilla,31800,6000,37800
8718,8719,21-10-2020 15:18:04.298629,Desayunos,La Frijolada Desayunos,37900,4400,42300
8719,8720,21-10-2020 15:18:04.628452,Desayunos,Señor Desayuno,18900,6800,25700
8720,8721,21-10-2020 15:18:04.808509,Perros Calientes,Dog Shop - Rapida,27800,4900,32700
8721,8722,21-10-2020 15:18:05.087998,Sánduches · China,Peru Mix,65000,5900,70900
8722,8723,21-10-2020 15:18:05.417873,Italiana,F*cking Good Pizza,35000,4200,39200
8723,8724,21-10-2020 15:18:05.597618,Parrilla,Campocina,48750,4600,53350
8724,8725,21-10-2020 15:18:05.927150,Postres · Panadería,RIGHT AWAY FOODS,34500,6600,41100
8725,8726,21-10-2020 15:18:06.056575,Desayunos · Pescados y Mariscos,Luzí­a - Mediterranea,18900,5700,24600
8726,8727,21-10-2020 15:18:06.436782,Alta Cocina · Parrilla,Criterión,15000,6000,21000
8727,8728,21-10-2020 15:18:06.566155,Saludable · Típica,Sopas Mrg,11870,3100,14970
8728,8729,21-10-2020 15:18:06.795566,Postres · Desayunos,La Folie - Postres,7500,3300,10800
8729,8730,21-10-2020 15:18:07.075094,Pescados y Mariscos,Pescadero Héroes del Mar,10700,6600,17300
8730,8731,21-10-2020 15:18:07.354596,Pollo · Típica,Auyama,10700,3900,14600
8731,8732,21-10-2020 15:18:07.483785,Parrilla,Antojo a Domicilio,34500,5000,39500
8732,8733,21-10-2020 15:18:07.863544,Saludable · Desayunos,Re.al Alimentos Reales,13000,4000,17000
8733,8734,21-10-2020 15:18:07.992783,Sushi,Kim Pop,15000,5400,20400
8734,8735,21-10-2020 15:18:08.322388,Pollo,Chicken House,35000,4200,39200
8735,8736,21-10-2020 15:18:08.652149,Parrilla,Beraca Parrilla Bbq,48750,5600,54350
8736,8737,21-10-2020 15:18:08.781912,Postres · Café,Loló Coffee & Snacks,18900,4600,23500
8737,8738,21-10-2020 15:18:08.911125,Postres · Desayunos,Sweet Tale,35000,5800,40800
8738,8739,21-10-2020 15:18:09.190355,Desayunos,Desayunos en Bogotá,37900,3400,41300
8739,8740,21-10-2020 15:18:09.420012,Sushi · Asiática,Tu Sushi,53400,6400,59800
8740,8741,21-10-2020 15:18:09.599596,Internacional,La Esquina con Sabor Parrilla,70000,3000,73000
8741,8742,21-10-2020 15:18:09.779025,Parrilla,Arepaisa de Medellín,29500,5600,35100
8742,8743,21-10-2020 15:18:10.158780,Típica,La Herencia,31800,5900,37700
8743,8744,21-10-2020 15:18:10.388472,Saludable · Desayunos,Libre de Culpa,10700,4000,14700
8744,8745,21-10-2020 15:18:10.618553,Desayunos · Panadería,Premium Break Bakery,9000,3700,12700
8745,8746,21-10-2020 15:18:10.848251,Sushi,Canoa To Go,18900,5900,24800
8746,8747,21-10-2020 15:18:11.227929,Postres,Toledo Pastelería,70000,6800,76800
8747,8748,21-10-2020 15:18:11.408287,Jugos y Batidos,Pomponio,13600,3600,17200
8748,8749,21-10-2020 15:18:11.588313,Postres · Desayunos,La Folie - Postres,35000,3300,38300
8749,8750,21-10-2020 15:18:11.868660,Sánduches · Pescados y Mariscos,Pacific Comida de Mar,53900,4000,57900
8750,8751,21-10-2020 15:18:12.048513,Postres · Desayunos,Gelateria Da Favola,11870,6500,18370
8751,8752,21-10-2020 15:18:12.278585,Típica,La Herencia,35000,5900,40900
8752,8753,21-10-2020 15:18:12.508358,Desayunos · Panadería,Choclofee,31800,4700,36500
8753,8754,21-10-2020 15:18:12.738147,Postres · Desayunos,Sweet Tale,10700,5800,16500
8754,8755,21-10-2020 15:18:13.118059,Pollo,Oliva Va,12500,5600,18100
8755,8756,21-10-2020 15:18:13.247656,Típica,Juan Chorizo,35000,3900,38900
8756,8757,21-10-2020 15:18:13.477289,Pollo · Saludable,Gratina,29500,4200,33700
8757,8758,21-10-2020 15:18:13.757018,Italiana,Bocatto Di Passo,9000,5000,14000
8758,8759,21-10-2020 15:18:14.136679,Italiana,F*cking Good Pizza,13600,4200,17800
8759,8760,21-10-2020 15:18:14.466425,Sushi · Asiática,Arigato,35000,5300,40300
8760,8761,21-10-2020 15:18:14.796141,Hamburguesas,Gofi Burger,15600,5100,20700
8761,8762,21-10-2020 15:18:14.975632,Postres · Desayunos,La Folie - Postres,13000,3300,16300
8762,8763,21-10-2020 15:18:15.306311,Postres · Desayunos,Maltihelado,7500,4500,12000
8763,8764,21-10-2020 15:18:15.585796,Típica · Parrilla,La Parilla de David,70000,3100,73100
8764,8765,21-10-2020 15:18:15.915366,Italiana,F*cking Good Pizza,15600,4200,19800
8765,8766,21-10-2020 15:18:16.194999,Saludable,A2manos,9000,4200,13200
8766,8767,21-10-2020 15:18:16.524971,Desayunos · Panadería,Santa Juana Food Bar,45800,5900,51700
8767,8768,21-10-2020 15:18:16.805153,Desayunos,Sunny Breakfast Brunch,13000,4300,17300
8768,8769,21-10-2020 15:18:16.984635,Desayunos · Italiana,Rceta By Rausch,7500,3600,11100
8769,8770,21-10-2020 15:18:17.314493,Desayunos · Italiana,Rceta By Rausch,9000,3600,12600
8770,8771,21-10-2020 15:18:17.544017,Saludable · Desayunos,La Estampilla,13600,6000,19600
8771,8772,21-10-2020 15:18:17.773811,Parrilla,Arroces Maria Paula,70000,6800,76800
8772,8773,21-10-2020 15:18:18.003548,Desayunos · Panadería,Premium Break Bakery,53400,3700,57100
8773,8774,21-10-2020 15:18:18.183160,Desayunos · Típica,La Frijolada,8900,4500,13400
8774,8775,21-10-2020 15:18:18.362692,Saludable · Desayunos,Bon Eat - Saludable,53400,4800,58200
8775,8776,21-10-2020 15:18:18.492322,Típica · Parrilla,Toya,70000,4200,74200
8776,8777,21-10-2020 15:18:18.772214,Saludable · Desayunos,Malú,70000,3700,73700
8777,8778,21-10-2020 15:18:19.102091,Desayunos · Típica,Alce,11870,4900,16770
8778,8779,21-10-2020 15:18:19.381672,Postres · Desayunos,Restaurante Cornelia,18900,5500,24400
8779,8780,21-10-2020 15:18:19.511436,Desayunos · Típica,La Parrilla Dorada Polo,13600,6600,20200
8780,8781,21-10-2020 15:18:19.891444,Desayunos · Empanadas,Mis Delicias,17800,3200,21000
8781,8782,21-10-2020 15:18:20.121375,Típica,Baondish,10700,5800,16500
8782,8783,21-10-2020 15:18:20.352143,Parrilla · Café,Figaro Café/ Restaurante Argentino,9000,5800,14800
8783,8784,21-10-2020 15:18:20.632080,Típica · Parrilla,La Parilla de David,17800,3100,20900
8784,8785,21-10-2020 15:18:20.861805,Típica,Cabrito Santandereano,18900,6600,25500
8785,8786,21-10-2020 15:18:21.141384,Panadería,Boul,53900,3100,57000
8786,8787,21-10-2020 15:18:21.320969,Hamburguesas,Monchis - Hamburguesa,18900,4300,23200
8787,8788,21-10-2020 15:18:21.600698,Mexicana,La leyenda mexican kitchen,12500,3200,15700
8788,8789,21-10-2020 15:18:21.980471,Alta Cocina · Parrilla,Criterión,45800,6000,51800
8789,8790,21-10-2020 15:18:22.260752,Desayunos · Sánduches,Danilo Colombia,18900,3300,22200
8790,8791,21-10-2020 15:18:22.640697,Postres · Helados,Mahé,8900,6000,14900
8791,8792,21-10-2020 15:18:22.970659,Típica · Parrilla,Mi Ranchito Parrilla,24200,4400,28600
8792,8793,21-10-2020 15:18:23.100207,Saludable · Desayunos,Básico y elemental,23000,5000,28000
8793,8794,21-10-2020 15:18:23.280182,Saludable,Amor Propio saludable,9000,4000,13000
8794,8795,21-10-2020 15:18:23.510699,Típica · Parrilla,El Santandereano,29500,5200,34700
8795,8796,21-10-2020 15:18:23.790873,Italiana,F*cking Good Pizza,31800,4200,36000
8796,8797,21-10-2020 15:18:24.070817,Internacional,Rio Sabores y Experiencias,31800,4100,35900
8797,8798,21-10-2020 15:18:24.250566,Postres · Desayunos,Buñuelos nacho,12500,6600,19100
8798,8799,21-10-2020 15:18:24.580811,Pizza · Italiana,Piatto - Pizza,15000,6600,21600
8799,8800,21-10-2020 15:18:24.960614,Típica,La Cocina,24200,4600,28800
8800,8801,21-10-2020 15:18:25.140422,Saludable · Desayunos,Fresh Co,17800,5600,23400
8801,8802,21-10-2020 15:18:25.371151,Desayunos · Panadería,Juliana Restaurante,39700,6100,45800
8802,8803,21-10-2020 15:18:25.701484,Hamburguesas · Desayunos,El Inglés Gastro Pub,31800,6600,38400
8803,8804,21-10-2020 15:18:25.881445,Parrilla,Beraca Parrilla Bbq,31800,5600,37400
8804,8805,21-10-2020 15:18:26.261989,Helados,Orso To Go,31800,6800,38600
8805,8806,21-10-2020 15:18:26.391865,Sushi,Umi,45800,5600,51400
8806,8807,21-10-2020 15:18:26.521733,Desayunos,Cafetería el Kippe,23000,3200,26200
8807,8808,21-10-2020 15:18:26.901677,Postres · Desayunos,Cosmo Cookies,48750,5900,54650
8808,8809,21-10-2020 15:18:27.281639,Desayunos,El Fogón Castellano,48750,3200,51950
8809,8810,21-10-2020 15:18:27.661645,Postres · Desayunos,Gelateria Da Favola,70000,6500,76500
8810,8811,21-10-2020 15:18:27.791286,Desayunos,Cafetería el Kippe,24300,3200,27500
8811,8812,21-10-2020 15:18:27.921029,Comida Rápida · Perros Calientes,Similoa - Comida Rapida,12500,3700,16200
8812,8813,21-10-2020 15:18:28.250647,Postres · Café,Celestino Café,10700,5900,16600
8813,8814,21-10-2020 15:18:28.430548,Desayunos · Pescados y Mariscos,Gypsy Bistro,23000,4500,27500
8814,8815,21-10-2020 15:18:28.610453,Desayunos,La Frijolada Desayunos,11870,4400,16270
8815,8816,21-10-2020 15:18:28.790201,Saludable · Desayunos,Básico y elemental,31800,5000,36800
8816,8817,21-10-2020 15:18:29.169950,Típica,Carbón & Mondongos,13600,6400,20000
8817,8818,21-10-2020 15:18:29.349512,Desayunos · Típica,Papadió - Colombianas,7500,5700,13200
8818,8819,21-10-2020 15:18:29.679234,Postres · Desayunos,KOKOA & co.,13600,4700,18300
8819,8820,21-10-2020 15:18:29.808748,Desayunos · Café,vereda central calle 99,70000,5700,75700
8820,8821,21-10-2020 15:18:29.988171,Postres · Desayunos,Vivalight Market.,35000,6500,41500
8821,8822,21-10-2020 15:18:30.319149,Desayunos · Pescados y Mariscos,Gypsy Bistro,23000,4500,27500
8822,8823,21-10-2020 15:18:30.550068,Desayunos · Típica,Casa Vieja,9000,6000,15000
8823,8824,21-10-2020 15:18:30.779965,Parrilla,Carnes la Zarza,24200,4900,29100
8824,8825,21-10-2020 15:18:30.959508,Parrilla,Antojo a Domicilio,15000,5000,20000
8825,8826,21-10-2020 15:18:31.289817,Desayunos · Mexicana,La Mera Mera - Mexicana,23000,3100,26100
8826,8827,21-10-2020 15:18:31.419264,Desayunos · Sánduches,Danilo Colombia,7500,3300,10800
8827,8828,21-10-2020 15:18:31.699543,Parrilla,Carnes la Zarza,48750,4900,53650
8828,8829,21-10-2020 15:18:32.079317,Desayunos,Jacinta Arepas de Huevo,13000,4000,17000
8829,8830,21-10-2020 15:18:32.259226,Desayunos · Típica,90 Calentados,70000,3700,73700
8830,8831,21-10-2020 15:18:32.389093,Pizza · Parrilla,Urban Lunch,13000,4000,17000
8831,8832,21-10-2020 15:18:32.519671,Pizza,pizza andante,29500,4200,33700
8832,8833,21-10-2020 15:18:32.749893,Desayunos · Panadería,Choclofee,24200,4700,28900
8833,8834,21-10-2020 15:18:32.929943,Crepes,San Crepes,31800,4900,36700
8834,8835,21-10-2020 15:18:33.310357,Típica · Parrilla,El Santandereano,12500,5200,17700
8835,8836,21-10-2020 15:18:33.490829,Parrilla,Antojo a Domicilio,70000,5000,75000
8836,8837,21-10-2020 15:18:33.721453,Desayunos · Café,Moramia,70000,4700,74700
8837,8838,21-10-2020 15:18:34.102336,Hamburguesas · Panadería,NYC Burgers,31800,6200,38000
8838,8839,21-10-2020 15:18:34.482796,Desayunos · Empanadas,Mis Delicias,45800,3200,49000
8839,8840,21-10-2020 15:18:34.813477,Poke,Poke Go,13000,4600,17600
8840,8841,21-10-2020 15:18:35.043990,Postres · Desayunos,Cosmo Cookies,53400,5900,59300
8841,8842,21-10-2020 15:18:35.224236,Pollo · Desayunos,Candelina,9000,5300,14300
8842,8843,21-10-2020 15:18:35.504666,Típica,El Mondongo y Mucho Mas,15000,5600,20600
8843,8844,21-10-2020 15:18:35.885821,Saludable · Desayunos,La Estampilla,8900,6000,14900
8844,8845,21-10-2020 15:18:36.116345,Pollo,Oliva Va,17800,5600,23400
8845,8846,21-10-2020 15:18:36.496368,Saludable · Jugos y Batidos,Berdes Drinks & Salads,34500,3500,38000
8846,8847,21-10-2020 15:18:36.727008,Saludable,Amor Propio saludable,24300,4000,28300
8847,8848,21-10-2020 15:18:36.957170,Parrilla,Antojo a Domicilio,27800,5000,32800
8848,8849,21-10-2020 15:18:37.087645,Desayunos · Típica,Rojo Gourmet,10700,4700,15400
8849,8850,21-10-2020 15:18:37.317905,Postres · Desayunos,Vivalight Market.,15000,6500,21500
8850,8851,21-10-2020 15:18:37.648647,Pescados y Mariscos,La Gran Cazuela,24200,3200,27400
8851,8852,21-10-2020 15:18:37.828888,Postres · Desayunos,La Folie - Postres,29500,3300,32800
8852,8853,21-10-2020 15:18:38.009774,Desayunos · Helados,San Giorgio Gelateria,13000,3100,16100
8853,8854,21-10-2020 15:18:38.389763,Parrilla,Rústico Picadería,39700,3800,43500
8854,8855,21-10-2020 15:18:38.620050,Saludable · Desayunos,Bon Eat - Saludable,23000,4800,27800
8855,8856,21-10-2020 15:18:39.000109,Hamburguesas,Bendito Cordero,23000,5800,28800
8856,8857,21-10-2020 15:18:39.230297,Desayunos · Café,Libertario Coffee Roasters,9000,4600,13600
8857,8858,21-10-2020 15:18:39.560277,Postres · Desayunos,Restaurante Cornelia,24200,5500,29700
8858,8859,21-10-2020 15:18:39.790094,Desayunos · Comida Rápida,Chocolatto,65000,3400,68400
8859,8860,21-10-2020 15:18:40.170100,Postres · Desayunos,Protein Bakes,48750,5900,54650
8860,8861,21-10-2020 15:18:40.400161,Perros Calientes,Dog Shop - Rapida,18900,4900,23800
8861,8862,21-10-2020 15:18:40.679991,Saludable · Desayunos,Fresh Co,15000,5600,20600
8862,8863,21-10-2020 15:18:40.910559,Típica,El Cucharón - Tipica,12500,4400,16900
8863,8864,21-10-2020 15:18:41.240935,Pizza,Pastas Laurentina,35000,4800,39800
8864,8865,21-10-2020 15:18:41.370562,Desayunos · Panadería,Artesanos,35000,4300,39300
8865,8866,21-10-2020 15:18:41.650567,Pollo · Pescados y Mariscos,Bang Bang Rice,70000,3400,73400
8866,8867,21-10-2020 15:18:41.880339,Postres · Café,Loló Coffee & Snacks,45800,4600,50400
8867,8868,21-10-2020 15:18:42.210066,Pollo · Pescados y Mariscos,Bang Bang Rice,24200,3400,27600
8868,8869,21-10-2020 15:18:42.339527,Saludable,Ventura Soup y Salad,37900,3800,41700
8869,8870,21-10-2020 15:18:42.519362,Internacional,Rio Sabores y Experiencias,65000,4100,69100
8870,8871,21-10-2020 15:18:42.649020,Pollo · Saludable,Yerbabuena,8900,3900,12800
8871,8872,21-10-2020 15:18:42.929057,Pizza · Italiana,Piatto - Pizza,70000,6600,76600
8872,8873,21-10-2020 15:18:43.208853,Postres · Desayunos,Amelie Helados,27800,6400,34200
8873,8874,21-10-2020 15:18:43.588691,Saludable,A2manos,15000,4200,19200
8874,8875,21-10-2020 15:18:43.768357,Desayunos · Típica,Parrilla Farandula Típico,45800,5900,51700
8875,8876,21-10-2020 15:18:44.098420,Parrilla,Campocina,37900,4600,42500
8876,8877,21-10-2020 15:18:44.228449,Típica · Pescados y Mariscos,Arroces Mrg,24200,4300,28500
8877,8878,21-10-2020 15:18:44.608330,Pollo,Oliva Va,13000,5600,18600
8878,8879,21-10-2020 15:18:44.938219,Postres · Desayunos,Aury Postres - Comidas & Picadas,18900,4700,23600
8879,8880,21-10-2020 15:18:45.117994,Pollo · Saludable,Yerbabuena,24200,3900,28100
8880,8881,21-10-2020 15:18:45.447929,Perros Calientes,Dog Shop - Rapida,37900,4900,42800
8881,8882,21-10-2020 15:18:45.627636,Postres · Café,Loló Coffee & Snacks,48750,4600,53350
8882,8883,21-10-2020 15:18:45.807483,Desayunos · Típica,Papadió - Colombianas,65000,5700,70700
8883,8884,21-10-2020 15:18:46.187479,Desayunos · Típica,D'Porco - Lechona,35000,6300,41300
8884,8885,21-10-2020 15:18:46.467240,Hamburguesas · Panadería,NYC Burgers,8900,6200,15100
8885,8886,21-10-2020 15:18:46.847297,Pizza,pizza andante,23000,4200,27200
8886,8887,21-10-2020 15:18:47.127265,Hamburguesas · Desayunos,El Inglés Gastro Pub,11870,6600,18470
8887,8888,21-10-2020 15:18:47.457258,Alta Cocina · Postres,La Pinta,35000,4500,39500
8888,8889,21-10-2020 15:18:47.786906,Postres · Desayunos,Sweet Tale,65000,5800,70800
8889,8890,21-10-2020 15:18:48.016672,Postres · Café,Loló Coffee & Snacks,35000,4600,39600
8890,8891,21-10-2020 15:18:48.396761,Saludable,A2manos,8900,4200,13100
8891,8892,21-10-2020 15:18:48.776817,Típica · Pescados y Mariscos,La Vitualla,24300,6300,30600
8892,8893,21-10-2020 15:18:48.956656,Desayunos · Mexicana,La Mera Mera - Mexicana,24300,3100,27400
8893,8894,21-10-2020 15:18:49.336814,Sushi,Canoa To Go,15000,5900,20900
8894,8895,21-10-2020 15:18:49.566570,Pizza,Pastas Laurentina,17800,4800,22600
8895,8896,21-10-2020 15:18:49.696149,Postres · Desayunos,Restaurante Cornelia,31800,5500,37300
8896,8897,21-10-2020 15:18:49.976095,Desayunos,Bagel Shop,24300,3200,27500
8897,8898,21-10-2020 15:18:50.356071,Pescados y Mariscos,La Gran Cazuela,27800,3200,31000
8898,8899,21-10-2020 15:18:50.685982,Típica · Pescados y Mariscos,La Vitualla,65000,6300,71300
8899,8900,21-10-2020 15:18:50.916011,Desayunos · Sánduches,Danilo Colombia,10700,3300,14000
8900,8901,21-10-2020 15:18:51.145960,Desayunos,Don Leo,70000,6000,76000
8901,8902,21-10-2020 15:18:51.377229,Desayunos,Jacinta Arepas de Huevo,7500,4000,11500
8902,8903,21-10-2020 15:18:51.506953,Asiática,Thai Station,13600,6000,19600
8903,8904,21-10-2020 15:18:51.887318,Italiana,F*cking Good Pizza,13000,4200,17200
8904,8905,21-10-2020 15:18:52.217314,Desayunos · Típica,90 Calentados,24200,3700,27900
8905,8906,21-10-2020 15:18:52.397174,Alta Cocina · Postres,La Pinta,12500,4500,17000
8906,8907,21-10-2020 15:18:52.576895,Postres,Levelma,23000,6200,29200
8907,8908,21-10-2020 15:18:52.906631,Desayunos,Archies Desayunos,39700,3100,42800
8908,8909,21-10-2020 15:18:53.036554,Desayunos · Típica,Peninsula Calentados y Parrilla,17800,3400,21200
8909,8910,21-10-2020 15:18:53.216312,Saludable · Desayunos,Guadalupe - Fruteria,35000,5900,40900
8910,8911,21-10-2020 15:18:53.496419,Desayunos · Panadería,Choclofee,24300,4700,29000
8911,8912,21-10-2020 15:18:53.826412,Helados,Buon Gelato,48750,4400,53150
8912,8913,21-10-2020 15:18:54.056265,Postres · Café,Celestino Café,17800,5900,23700
8913,8914,21-10-2020 15:18:54.286580,Saludable · Típica,Saludable Mrg,70000,5800,75800
8914,8915,21-10-2020 15:18:54.616788,Típica,Campo Victoria,15000,3000,18000
8915,8916,21-10-2020 15:18:54.996551,Saludable,Ventura Soup y Salad,10700,3800,14500
8916,8917,21-10-2020 15:18:55.226871,Típica,Sabrosito,53900,4000,57900
8917,8918,21-10-2020 15:18:55.407253,Parrilla,Beraca Parrilla Bbq,24200,5600,29800
8918,8919,21-10-2020 15:18:55.537268,Postres,La Galeta,10700,3000,13700
8919,8920,21-10-2020 15:18:55.767025,Desayunos · Comida Rápida,Chocolatto,45800,3400,49200
8920,8921,21-10-2020 15:18:56.096842,Típica,Juan Chorizo,13600,3900,17500
8921,8922,21-10-2020 15:18:56.226716,Pollo,Oliva Va,12500,5600,18100
8922,8923,21-10-2020 15:18:56.457770,Sushi,Sushi Reel,12500,4700,17200
8923,8924,21-10-2020 15:18:56.837926,Desayunos · Comida Rápida,La Veneca,65000,6300,71300
8924,8925,21-10-2020 15:18:57.167931,Parrilla,Restaurante Bar Mi Ranchito,15000,5200,20200
8925,8926,21-10-2020 15:18:57.398117,Pollo · Saludable,Yerbabuena,35000,3900,38900
8926,8927,21-10-2020 15:18:57.628190,Desayunos · Café,Frambas,27800,3400,31200
8927,8928,21-10-2020 15:18:57.807937,Postres · Desayunos,Amelie Helados,17800,6400,24200
8928,8929,21-10-2020 15:18:58.138104,Desayunos,Fratelli - Desayunos,15600,4600,20200
8929,8930,21-10-2020 15:18:58.518254,Italiana,Bocatto Di Passo,15600,5000,20600
8930,8931,21-10-2020 15:18:58.748021,Desayunos · Helados,San Giorgio Gelateria,34500,3100,37600
8931,8932,21-10-2020 15:18:58.878213,Desayunos,El Fogón Castellano,34500,3200,37700
8932,8933,21-10-2020 15:18:59.108223,Hamburguesas,Bendito Cordero,53400,5800,59200
8933,8934,21-10-2020 15:18:59.488670,Desayunos · Italiana,Rceta By Rausch,12500,3600,16100
8934,8935,21-10-2020 15:18:59.768943,Alta Cocina · Parrilla,Criterión,10700,6000,16700
8935,8936,21-10-2020 15:19:00.099368,Perros Calientes,Dog Shop - Rapida,15600,4900,20500
8936,8937,21-10-2020 15:19:00.229858,Desayunos · Sánduches,Frutos del Bosque,53400,3500,56900
8937,8938,21-10-2020 15:19:00.410361,Postres · Desayunos,Sweet Tale,15000,5800,20800
8938,8939,21-10-2020 15:19:00.540373,Desayunos,Bagel Shop,45800,3200,49000
8939,8940,21-10-2020 15:19:00.820333,Desayunos · Internacional,Camilia,15000,3900,18900
8940,8941,21-10-2020 15:19:01.050307,Típica,La Olla de Barro,48750,5300,54050
8941,8942,21-10-2020 15:19:01.430688,Hamburguesas,Monchis - Hamburguesa,35000,4300,39300
8942,8943,21-10-2020 15:19:01.811513,Pizza,Pizza Andante,11870,6300,18170
8943,8944,21-10-2020 15:19:01.991542,Desayunos · Panadería,Siena Café,8900,3700,12600
8944,8945,21-10-2020 15:19:02.321612,Postres · Desayunos,Maltihelado,13000,4500,17500
8945,8946,21-10-2020 15:19:02.701933,Postres,Toledo Pastelería,9000,6800,15800
8946,8947,21-10-2020 15:19:02.881891,Alta Cocina · Parrilla,Criterión,34500,6000,40500
8947,8948,21-10-2020 15:19:03.061657,Pollo,Señor Fantástico,70000,4700,74700
8948,8949,21-10-2020 15:19:03.441780,Saludable,A2manos,15000,4200,19200
8949,8950,21-10-2020 15:19:03.622028,Postres · Panadería,RIGHT AWAY FOODS,10700,6600,17300
8950,8951,21-10-2020 15:19:03.852004,Mexicana,Cantina La 15,35000,4300,39300
8951,8952,21-10-2020 15:19:04.032498,Saludable · Desayunos,La Estampilla,24300,6000,30300
8952,8953,21-10-2020 15:19:04.362656,Postres · Desayunos,La Folie - Postres,34500,3300,37800
8953,8954,21-10-2020 15:19:04.692903,Desayunos · Panadería,Santa Juana Food Bar,15600,5900,21500
8954,8955,21-10-2020 15:19:04.822874,Internacional,La Esquina con Sabor Parrilla,10700,3000,13700
8955,8956,21-10-2020 15:19:05.102946,Sánduches · Pescados y Mariscos,Pacific Comida de Mar,39700,4000,43700
8956,8957,21-10-2020 15:19:05.483237,Postres · Desayunos,La Folie - Postres,37900,3300,41200
8957,8958,21-10-2020 15:19:05.713356,Hamburguesas · Desayunos,El Inglés Gastro Pub,12500,6600,19100
8958,8959,21-10-2020 15:19:06.043178,Comida Rápida · Perros Calientes,Similoa - Comida Rapida,34500,3700,38200
8959,8960,21-10-2020 15:19:06.373109,Postres,La Galeta,13000,3000,16000
8960,8961,21-10-2020 15:19:06.752992,Desayunos · Panadería,Le Pain Quotidien,35000,3900,38900
8961,8962,21-10-2020 15:19:07.033979,Saludable · Desayunos,Agua Dulce,17800,3700,21500
8962,8963,21-10-2020 15:19:07.364056,Desayunos,Sunny Breakfast Brunch,8900,4300,13200
8963,8964,21-10-2020 15:19:07.594107,Típica · Parrilla,Parrilla Farandula Gourmet,18900,5100,24000
8964,8965,21-10-2020 15:19:07.874248,Típica,La Olla de Barro,23000,5300,28300
8965,8966,21-10-2020 15:19:08.054435,Típica · Parrilla,La Parilla de David,12500,3100,15600
8966,8967,21-10-2020 15:19:08.184557,Desayunos · Jugos y Batidos,Kuriwaji,18900,6300,25200
8967,8968,21-10-2020 15:19:08.564706,Pizza · Italiana,Pisapore - Pizza,53900,6600,60500
8968,8969,21-10-2020 15:19:08.944974,Pollo · Saludable,Tremenda Sal y Dulce,9000,6500,15500
8969,8970,21-10-2020 15:19:09.275262,Típica,Campo Victoria,53400,3000,56400
8970,8971,21-10-2020 15:19:09.555477,Típica,Baondish,34500,5800,40300
8971,8972,21-10-2020 15:19:09.736089,Típica · Pescados y Mariscos,Arroces Mrg,9000,4300,13300
8972,8973,21-10-2020 15:19:09.915982,Alta Cocina · Postres,La Pinta,23000,4500,27500
8973,8974,21-10-2020 15:19:10.146021,Típica,La Olla de Barro,45800,5300,51100
8974,8975,21-10-2020 15:19:10.325924,Pollo · Desayunos,Abasto,45800,3600,49400
8975,8976,21-10-2020 15:19:10.505998,Desayunos · Típica,90 Calentados,24300,3700,28000
8976,8977,21-10-2020 15:19:10.836152,Desayunos · Sánduches,Frutos del Bosque,24300,3500,27800
8977,8978,21-10-2020 15:19:11.216819,Desayunos · Empanadas,Empanadas Doraditas.com,53900,3000,56900
8978,8979,21-10-2020 15:19:11.347015,Desayunos · Café,El Gualilo,15600,6200,21800
8979,8980,21-10-2020 15:19:11.677382,Asiática,Thai Station,29500,6000,35500
8980,8981,21-10-2020 15:19:12.058606,Pizza · Italiana,Pisapore - Pizza,23000,6600,29600
8981,8982,21-10-2020 15:19:12.188726,Desayunos · Panadería,Limarys,8900,6500,15400
8982,8983,21-10-2020 15:19:12.369259,Típica,Sabores De Mi Tierra,48750,5400,54150
8983,8984,21-10-2020 15:19:12.549619,Típica,Baondish,23000,5800,28800
8984,8985,21-10-2020 15:19:12.829857,Típica,Cazuelitas 93,27800,3900,31700
8985,8986,21-10-2020 15:19:13.010569,Desayunos · Panadería,El Pan de Phillippe,9000,4600,13600
8986,8987,21-10-2020 15:19:13.340901,Típica,Campo Victoria,8900,3000,11900
8987,8988,21-10-2020 15:19:13.721353,Desayunos,El Fogón Castellano,34500,3200,37700
8988,8989,21-10-2020 15:19:14.001909,Típica,La Herencia,35000,5900,40900
8989,8990,21-10-2020 15:19:14.332064,Desayunos · Típica,90 Calentados,53400,3700,57100
8990,8991,21-10-2020 15:19:14.712243,Pollo · Desayunos,Workzone,35000,3100,38100
8991,8992,21-10-2020 15:19:14.892293,Saludable · Desayunos,Fresh Co,35000,5600,40600
8992,8993,21-10-2020 15:19:15.272598,Desayunos · Panadería,Santa Juana Food Bar,15000,5900,20900
8993,8994,21-10-2020 15:19:15.552827,Helados,Buon Gelato,53400,4400,57800
8994,8995,21-10-2020 15:19:15.682686,Desayunos · Comida Rápida,La Veneca,24300,6300,30600
8995,8996,21-10-2020 15:19:15.862708,Postres · Desayunos,Café Quindio,24300,5700,30000
8996,8997,21-10-2020 15:19:16.193022,Postres · Desayunos,Jacques Pastelería,24300,5900,30200
8997,8998,21-10-2020 15:19:16.423409,Pollo,Señor Fantástico,34500,4700,39200
8998,8999,21-10-2020 15:19:16.553485,Desayunos · Café,Moramia,35000,4700,39700
8999,9000,21-10-2020 15:19:16.783771,Típica,La Olla de Barro,35000,5300,40300
9000,9001,21-10-2020 15:19:17.065301,Desayunos · Panadería,Santa Juana Food Bar,17800,5900,23700
9001,9002,21-10-2020 15:19:17.295326,Postres · Desayunos,Maltihelados,9000,6200,15200
9002,9003,21-10-2020 15:19:17.475690,Saludable · Desayunos,Distrito Gourmet,12500,3700,16200
9003,9004,21-10-2020 15:19:17.606024,Desayunos · Café,El Gualilo,12500,6200,18700
9004,9005,21-10-2020 15:19:17.836044,Típica,Baondish,13600,5800,19400
9005,9006,21-10-2020 15:19:18.216701,Desayunos · Sánduches,Garnish,23000,5200,28200
9006,9007,21-10-2020 15:19:18.397090,Desayunos · Sánduches,Danilo Colombia,35000,3300,38300
9007,9008,21-10-2020 15:19:18.777581,Mexicana,Hidalgo Taquería,27800,4900,32700
9008,9009,21-10-2020 15:19:18.907806,Parrilla · Internacional,Taperia de la Plaza,70000,5700,75700
9009,9010,21-10-2020 15:19:19.038085,Desayunos · Pescados y Mariscos,Luzí­a - Mediterranea,12500,5700,18200
9010,9011,21-10-2020 15:19:19.418986,Pizza · Italiana,Pisapore - Pizza,65000,6600,71600
9011,9012,21-10-2020 15:19:19.599197,Típica,Juan Chorizo,34500,3900,38400
9012,9013,21-10-2020 15:19:19.880008,Sushi,Sushi Reel,18900,4700,23600
9013,9014,21-10-2020 15:19:20.060050,Desayunos · Sánduches,Danilo Colombia,29500,3300,32800
9014,9015,21-10-2020 15:19:20.290262,Pollo · Saludable,Yerbabuena,70000,3900,73900
9015,9016,21-10-2020 15:19:20.670690,Poke,Poke Go,7500,4600,12100
9016,9017,21-10-2020 15:19:20.900997,Sánduches · Pescados y Mariscos,Pacific Comida de Mar,70000,4000,74000
9017,9018,21-10-2020 15:19:21.131088,Saludable,Amor Propio saludable,53400,4000,57400
9018,9019,21-10-2020 15:19:21.311132,Desayunos · Típica,Alce,65000,4900,69900
9019,9020,21-10-2020 15:19:21.691839,Parrilla,Carnes la Zarza,37900,4900,42800
9020,9021,21-10-2020 15:19:22.073602,Parrilla,Beraca Parrilla Bbq,17800,5600,23400
9021,9022,21-10-2020 15:19:22.304070,Desayunos · Panadería,Santa Juana Food Bar,39700,5900,45600
9022,9023,21-10-2020 15:19:22.684948,Comida Rápida · Perros Calientes,Similoa - Comida Rapida,15600,3700,19300
9023,9024,21-10-2020 15:19:22.815014,Desayunos · Café,Libertario Coffee Roasters,35000,4600,39600
9024,9025,21-10-2020 15:19:22.995003,Pollo · China,China Tao,24200,3500,27700
9025,9026,21-10-2020 15:19:23.125188,Desayunos,Butter,70000,6700,76700
9026,9027,21-10-2020 15:19:23.405518,Saludable · Desayunos,Fresh Co,15000,5600,20600
9027,9028,21-10-2020 15:19:23.786283,Típica,Sopitas y Más,35000,4200,39200
9028,9029,21-10-2020 15:19:23.966355,Típica,Lo Nuestro,70000,3100,73100
9029,9030,21-10-2020 15:19:24.296811,Pollo · Saludable,Yerbabuena,24200,3900,28100
9030,9031,21-10-2020 15:19:24.526994,Típica,Lo Nuestro,39700,3100,42800
9031,9032,21-10-2020 15:19:24.707245,Postres · Desayunos,BagBog Bagels,23000,6400,29400
9032,9033,21-10-2020 15:19:24.837525,Alta Cocina · Postres,La Pinta,27800,4500,32300
9033,9034,21-10-2020 15:19:25.017747,Desayunos · Típica,Casa Vieja,11870,6000,17870
9034,9035,21-10-2020 15:19:25.148323,Saludable · Desayunos,Distrito Gourmet,37900,3700,41600
9035,9036,21-10-2020 15:19:25.428933,Típica,Cabrito Santandereano,13600,6600,20200
9036,9037,21-10-2020 15:19:25.559380,Desayunos · Panadería,Choclofee,18900,4700,23600
9037,9038,21-10-2020 15:19:25.939781,Desayunos · Panadería,Siena Café,10700,3700,14400
9038,9039,21-10-2020 15:19:26.069790,Postres,Toledo Pastelería,24300,6800,31100
9039,9040,21-10-2020 15:19:26.250128,Crepes,La Chabatta,70000,5900,75900
9040,9041,21-10-2020 15:19:26.630653,Saludable · Desayunos,La Estampilla,29500,6000,35500
9041,9042,21-10-2020 15:19:26.911088,Desayunos · Internacional,Camilia,12500,3900,16400
9042,9043,21-10-2020 15:19:27.292775,Desayunos · Típica,Peninsula Calentados y Parrilla,13000,3400,16400
9043,9044,21-10-2020 15:19:27.523756,Saludable · Desayunos,Guadalupe - Fruteria,53900,5900,59800
9044,9045,21-10-2020 15:19:27.704216,Desayunos · Típica,Parrilla Farandula Típico,35000,5900,40900
9045,9046,21-10-2020 15:19:27.884388,Hamburguesas · Panadería,NYC Burgers,35000,6200,41200
9046,9047,21-10-2020 15:19:28.164470,Postres · Desayunos,Sharmus,35000,6100,41100
9047,9048,21-10-2020 15:19:28.444805,Postres · Desayunos,Jacques Pastelería,39700,5900,45600
9048,9049,21-10-2020 15:19:28.825016,Parrilla,OAK Ahumado y Brebajes,13000,6000,19000
9049,9050,21-10-2020 15:19:29.055213,Desayunos · Empanadas,Empanadas Doraditas.com,23000,3000,26000
9050,9051,21-10-2020 15:19:29.185405,Típica,Campo Victoria,35000,3000,38000
9051,9052,21-10-2020 15:19:29.566169,Saludable · Desayunos,Bawana - Sandwich,29500,3400,32900
9052,9053,21-10-2020 15:19:29.746378,Hamburguesas · Desayunos,El Inglés Gastro Pub,8900,6600,15500
9053,9054,21-10-2020 15:19:30.076691,Pollo · Sánduches,Pollos Century,35000,3000,38000
9054,9055,21-10-2020 15:19:30.457058,Desayunos,Bagel Shop,15600,3200,18800
9055,9056,21-10-2020 15:19:30.687363,Pescados y Mariscos,La Gran Cazuela,37900,3200,41100
9056,9057,21-10-2020 15:19:30.867999,Desayunos · Internacional,Camilia,8900,3900,12800
9057,9058,21-10-2020 15:19:31.198447,Postres,Beiked,15000,4000,19000
9058,9059,21-10-2020 15:19:31.578962,Parrilla,Antojo a Domicilio,48750,5000,53750
9059,9060,21-10-2020 15:19:31.759178,Pollo,Heart & Cooking,27800,5000,32800
9060,9061,21-10-2020 15:19:32.039407,Alta Cocina · Italiana,Trattoria de la Plaza,34500,6000,40500
9061,9062,21-10-2020 15:19:32.320512,Asiática,TeT,31800,5900,37700
9062,9063,21-10-2020 15:19:32.601040,Peruana · Internacional,La Chifería,35000,6600,41600
9063,9064,21-10-2020 15:19:32.931546,Desayunos · Comida Rápida,Chocolatto,12500,3400,15900
9064,9065,21-10-2020 15:19:33.061984,Desayunos · Típica,Papadió - Colombianas,29500,5700,35200
9065,9066,21-10-2020 15:19:33.442558,Helados,Buon Gelato,27800,4400,32200
9066,9067,21-10-2020 15:19:33.672910,Típica,Salsig,45800,5600,51400
9067,9068,21-10-2020 15:19:33.802956,Desayunos · Típica,90 Calentados,7500,3700,11200
9068,9069,21-10-2020 15:19:34.183393,Pollo,Señor Fantástico,53400,4700,58100
9069,9070,21-10-2020 15:19:34.364342,Parrilla,Beraca Parrilla Bbq,35000,5600,40600
9070,9071,21-10-2020 15:19:34.594715,Desayunos · Jugos y Batidos,Frutiwow,27800,4100,31900
9071,9072,21-10-2020 15:19:34.724963,Crepes,San Crepes,9000,4900,13900
9072,9073,21-10-2020 15:19:35.005421,Típica · Parrilla,El Portal de la Antigua,29500,5600,35100
9073,9074,21-10-2020 15:19:35.335838,Desayunos · Mexicana,La Mera Mera - Mexicana,70000,3100,73100
9074,9075,21-10-2020 15:19:35.666645,Desayunos · Típica,Criollomania,24200,5200,29400
9075,9076,21-10-2020 15:19:35.847086,Poke,Poke Go,53900,4600,58500
9076,9077,21-10-2020 15:19:36.077534,Saludable,Puro Verde,23000,5700,28700
9077,9078,21-10-2020 15:19:36.357914,Saludable,MIMA,18900,3700,22600
9078,9079,21-10-2020 15:19:36.688163,Parrilla,Beraca Parrilla Bbq,23000,5600,28600
9079,9080,21-10-2020 15:19:37.018586,Parrilla · Café,Figaro Café/ Restaurante Argentino,13000,5800,18800
9080,9081,21-10-2020 15:19:37.148692,Desayunos · Panadería,Decofruta,23000,4700,27700
9081,9082,21-10-2020 15:19:37.330122,Postres · Desayunos,Jacques Pastelería,18900,5900,24800
9082,9083,21-10-2020 15:19:37.710783,Asiática,Thai Station,24300,6000,30300
9083,9084,21-10-2020 15:19:37.991135,Pollo · Desayunos,Workzone,23000,3100,26100
9084,9085,21-10-2020 15:19:38.221551,Postres · Desayunos,Amelie Helados,23000,6400,29400
9085,9086,21-10-2020 15:19:38.602209,Postres · Helados,Mahé,15000,6000,21000
9086,9087,21-10-2020 15:19:38.982752,Pollo · Típica,Auyama,53900,3900,57800
9087,9088,21-10-2020 15:19:39.363239,Saludable · Jugos y Batidos,Berdes Drinks & Salads,34500,3500,38000
9088,9089,21-10-2020 15:19:39.643919,Saludable · Desayunos,Malú,18900,3700,22600
9089,9090,21-10-2020 15:19:40.024527,Típica,Campo Victoria,18900,3000,21900
9090,9091,21-10-2020 15:19:40.405438,Desayunos · Panadería,Choclofee,35000,4700,39700
9091,9092,21-10-2020 15:19:40.686029,Sushi · Asiática,Tu Sushi,15600,6400,22000
9092,9093,21-10-2020 15:19:40.966297,Postres · Panadería,RIGHT AWAY FOODS,29500,6600,36100
9093,9094,21-10-2020 15:19:41.296544,Hamburguesas · Panadería,NYC Burgers,13000,6200,19200
9094,9095,21-10-2020 15:19:41.677275,Desayunos · Típica,Calentao Express,9000,6000,15000
9095,9096,21-10-2020 15:19:41.907658,Mexicana,Mexicanachos,15600,3900,19500
9096,9097,21-10-2020 15:19:42.288040,Típica · Pescados y Mariscos,Arroces Mrg,13000,4300,17300
9097,9098,21-10-2020 15:19:42.519324,Desayunos · Empanadas,Empanadas Doraditas.com,24200,3000,27200
9098,9099,21-10-2020 15:19:42.849874,Postres · Café,Celestino Café,31800,5900,37700
9099,9100,21-10-2020 15:19:43.130395,Pollo · Saludable,Yerbabuena,10700,3900,14600
9100,9101,21-10-2020 15:19:43.260831,Pollo · Desayunos,Workzone,45800,3100,48900
9101,9102,21-10-2020 15:19:43.441510,Desayunos,Sr Buñuelo,23000,6400,29400
9102,9103,21-10-2020 15:19:43.772306,Desayunos,Bagel Shop,13600,3200,16800
9103,9104,21-10-2020 15:19:44.003011,Desayunos · Típica,D´Porco,37900,3900,41800
9104,9105,21-10-2020 15:19:44.183484,Café · Helados,Sofia heladería y café,53400,5800,59200
9105,9106,21-10-2020 15:19:44.564013,Desayunos,El Corral - Desayunos,39700,5000,44700
9106,9107,21-10-2020 15:19:44.794236,Italiana,Bocatto Di Passo,23000,5000,28000
9107,9108,21-10-2020 15:19:44.974548,Parrilla · Internacional,Taperia de la Plaza,23000,5700,28700
9108,9109,21-10-2020 15:19:45.155033,Desayunos · Panadería,Artesanos,11870,4300,16170
9109,9110,21-10-2020 15:19:45.385596,Desayunos · Sánduches,Frutos del Bosque,27800,3500,31300
9110,9111,21-10-2020 15:19:45.616308,Típica · Parrilla,El Santandereano,23000,5200,28200
9111,9112,21-10-2020 15:19:45.797447,Pizza · Italiana,Pisapore - Pizza,45800,6600,52400
9112,9113,21-10-2020 15:19:45.927521,Alta Cocina · Postres,La Pinta,13600,4500,18100
9113,9114,21-10-2020 15:19:46.207920,Desayunos · Típica,90 Calentados,23000,3700,26700
9114,9115,21-10-2020 15:19:46.588402,Postres,La Galeta,10700,3000,13700
9115,9116,21-10-2020 15:19:46.718752,Pollo,Señor Fantástico,35000,4700,39700
9116,9117,21-10-2020 15:19:47.099414,Hamburguesas,Burger Society,35000,4100,39100
9117,9118,21-10-2020 15:19:47.430108,Postres · Café,Celestino Café,24200,5900,30100
9118,9119,21-10-2020 15:19:47.661480,Típica · Parrilla,Typykos,17800,6000,23800
9119,9120,21-10-2020 15:19:47.841990,Típica · Pescados y Mariscos,Arroces Mrg,35000,4300,39300
9120,9121,21-10-2020 15:19:48.172536,Italiana,F*cking Good Pizza,15600,4200,19800
9121,9122,21-10-2020 15:19:48.352925,Pollo,Señor Fantástico,11870,4700,16570
9122,9123,21-10-2020 15:19:48.533256,Típica,El Cucharón - Tipica,23000,4400,27400
9123,9124,21-10-2020 15:19:48.763978,Helados,Orso To Go,9000,6800,15800
9124,9125,21-10-2020 15:19:49.044381,Desayunos,Don Leo,12500,6000,18500
9125,9126,21-10-2020 15:19:49.425287,Pollo,Oliva Va,34500,5600,40100
9126,9127,21-10-2020 15:19:49.706101,Desayunos,Archies Desayunos,39700,3100,42800
9127,9128,21-10-2020 15:19:50.036449,Parrilla,Beraca Parrilla Bbq,13600,5600,19200
9128,9129,21-10-2020 15:19:50.367012,Desayunos · Panadería,Limarys,15000,6500,21500
9129,9130,21-10-2020 15:19:50.497276,Desayunos · Helados,San Giorgio Gelateria,12500,3100,15600
9130,9131,21-10-2020 15:19:50.777810,Pescados y Mariscos,Fish Place - Del Mar,48750,5400,54150
9131,9132,21-10-2020 15:19:51.158619,Saludable,Amor Propio saludable,10700,4000,14700
9132,9133,21-10-2020 15:19:51.439411,Peruana · Internacional,La Chifería,29500,6600,36100
9133,9134,21-10-2020 15:19:51.670138,Hamburguesas,Bendito Cordero,13600,5800,19400
9134,9135,21-10-2020 15:19:52.000608,Hamburguesas · Desayunos,El Inglés Gastro Pub,24200,6600,30800
9135,9136,21-10-2020 15:19:52.381217,Típica,Baondish,39700,5800,45500
9136,9137,21-10-2020 15:19:52.712719,Desayunos,Sunny Breakfast Brunch,13600,4300,17900
9137,9138,21-10-2020 15:19:53.043327,Pollo · Sánduches,Pollos Century,27800,3000,30800
9138,9139,21-10-2020 15:19:53.374232,Típica,Salsig,9000,5600,14600
9139,9140,21-10-2020 15:19:53.554776,Desayunos · Parrilla,Mi Patria,13600,4600,18200
9140,9141,21-10-2020 15:19:53.885479,Saludable,Amor Propio saludable,34500,4000,38500
9141,9142,21-10-2020 15:19:54.216003,Helados,Buon Gelato,10700,4400,15100
9142,9143,21-10-2020 15:19:54.546674,Sushi · Asiática,Arigato,27800,5300,33100
9143,9144,21-10-2020 15:19:54.827312,Desayunos,El Corral - Desayunos,15000,5000,20000
9144,9145,21-10-2020 15:19:54.957731,Desayunos · Típica,Criollomania,29500,5200,34700
9145,9146,21-10-2020 15:19:55.238407,Desayunos · Típica,Papadió - Colombianas,15600,5700,21300
9146,9147,21-10-2020 15:19:55.569050,Desayunos · Panadería,Decofruta,12500,4700,17200
9147,9148,21-10-2020 15:19:55.799499,Asiática,Thai Station,15600,6000,21600
9148,9149,21-10-2020 15:19:56.180155,Típica · Parrilla,Parrilla Farandula Gourmet,29500,5100,34600
9149,9150,21-10-2020 15:19:56.460708,Desayunos · Típica,La Parrilla Dorada Polo,31800,6600,38400
9150,9151,21-10-2020 15:19:56.841332,Parrilla,Restaurante Bar Mi Ranchito,29500,5200,34700
9151,9152,21-10-2020 15:19:57.171820,Saludable · Desayunos,Agua Dulce,24200,3700,27900
9152,9153,21-10-2020 15:19:57.352290,Desayunos · Panadería,Limarys,39700,6500,46200
9153,9154,21-10-2020 15:19:57.482928,Postres · Desayunos,BagBog Bagels,45800,6400,52200
9154,9155,21-10-2020 15:19:57.815062,Saludable · Desayunos,La Estampilla,53900,6000,59900
9155,9156,21-10-2020 15:19:57.945411,Desayunos · Jugos y Batidos,Frutiwow,31800,4100,35900
9156,9157,21-10-2020 15:19:58.325947,Crepes,La Chabatta,31800,5900,37700
9157,9158,21-10-2020 15:19:58.506398,Postres,La Galeta,11870,3000,14870
9158,9159,21-10-2020 15:19:58.786975,Postres · Saludable,Ana Rebana,7500,6300,13800
9159,9160,21-10-2020 15:19:59.067777,Postres · Desayunos,La Folie - Postres,8900,3300,12200
9160,9161,21-10-2020 15:19:59.448626,Mexicana,Cantina La 15,15600,4300,19900
9161,9162,21-10-2020 15:19:59.779386,Desayunos · Café,Libertario Coffee Roasters,39700,4600,44300
9162,9163,21-10-2020 15:20:00.059941,Internacional,Rio Sabores y Experiencias,70000,4100,74100
9163,9164,21-10-2020 15:20:00.290745,Desayunos,Sr Buñuelo,65000,6400,71400
9164,9165,21-10-2020 15:20:00.521504,Alta Cocina · Italiana,Trattoria de la Plaza,39700,6000,45700
9165,9166,21-10-2020 15:20:00.902175,Pollo · Desayunos,Caserito Gourmet,11870,6700,18570
9166,9167,21-10-2020 15:20:01.082998,Postres · Desayunos,Sharmus,27800,6100,33900
9167,9168,21-10-2020 15:20:01.313770,Pollo,Heart & Cooking,31800,5000,36800
9168,9169,21-10-2020 15:20:01.494279,Desayunos · Comida Rápida,Chocolatto,39700,3400,43100
9169,9170,21-10-2020 15:20:01.875077,Saludable · Desayunos,Malú,23000,3700,26700
9170,9171,21-10-2020 15:20:02.155742,Internacional,La Esquina con Sabor Parrilla,35000,3000,38000
9171,9172,21-10-2020 15:20:02.486766,Postres · Desayunos,Cosmo Cookies,65000,5900,70900
9172,9173,21-10-2020 15:20:02.667226,Desayunos,El Fogón Castellano,13600,3200,16800
9173,9174,21-10-2020 15:20:02.949009,Desayunos,Butter,29500,6700,36200
9174,9175,21-10-2020 15:20:03.329739,Saludable · Desayunos,Bon Eat - Saludable,65000,4800,69800
9175,9176,21-10-2020 15:20:03.460414,Desayunos · Café,Libertario Coffee Roasters,8900,4600,13500
9176,9177,21-10-2020 15:20:03.691034,Pollo,Señor Fantástico,34500,4700,39200
9177,9178,21-10-2020 15:20:03.871377,Postres,Beiked,23000,4000,27000
9178,9179,21-10-2020 15:20:04.202322,Saludable,The Good Rice Bowls,13000,3500,16500
9179,9180,21-10-2020 15:20:04.432974,Desayunos · Parrilla,Mi Patria,12500,4600,17100
9180,9181,21-10-2020 15:20:04.613942,Pollo · Desayunos,Abasto,24300,3600,27900
9181,9182,21-10-2020 15:20:04.744510,Internacional,La Esquina con Sabor Parrilla,15000,3000,18000
9182,9183,21-10-2020 15:20:04.925324,Asiática,Thai Station,70000,6000,76000
9183,9184,21-10-2020 15:20:05.105972,Saludable · Típica,Saludable Mrg,8900,5800,14700
9184,9185,21-10-2020 15:20:05.336800,Hamburguesas · Pescados y Mariscos,El Velero,45800,6500,52300
9185,9186,21-10-2020 15:20:05.517273,Pollo · Desayunos,Piaf,15600,6500,22100
9186,9187,21-10-2020 15:20:05.647756,Desayunos · Pescados y Mariscos,Gypsy Bistro,53900,4500,58400
9187,9188,21-10-2020 15:20:05.978380,Pollo · Saludable,Gratina,53400,4200,57600
9188,9189,21-10-2020 15:20:06.308958,Desayunos · Helados,San Giorgio Gelateria,53900,3100,57000
9189,9190,21-10-2020 15:20:06.639717,Pollo · Sánduches,Pollos Century,13600,3000,16600
9190,9191,21-10-2020 15:20:06.770490,Mexicana,Cantina La 15,8900,4300,13200
9191,9192,21-10-2020 15:20:06.900911,Postres · Desayunos,KOKOA & co.,37900,4700,42600
9192,9193,21-10-2020 15:20:07.231988,Parrilla,Parrilla Pimentón,35000,3400,38400
9193,9194,21-10-2020 15:20:07.562792,Hamburguesas · Alitas,Beer,10700,6600,17300
9194,9195,21-10-2020 15:20:07.943367,Poke,Poke Go,48750,4600,53350
9195,9196,21-10-2020 15:20:08.174390,Saludable · Desayunos,Guadalupe - Fruteria,39700,5900,45600
9196,9197,21-10-2020 15:20:08.455218,Sushi,Sushi Reel,23000,4700,27700
9197,9198,21-10-2020 15:20:08.636051,Café · Helados,Sofia heladería y café,8900,5800,14700
9198,9199,21-10-2020 15:20:09.016822,Desayunos · Café,Libertario Coffee Roasters,34500,4600,39100
9199,9200,21-10-2020 15:20:09.397964,Típica,Lo Nuestro,13000,3100,16100
9200,9201,21-10-2020 15:20:09.629175,Saludable · Desayunos,Malú,45800,3700,49500
9201,9202,21-10-2020 15:20:09.960146,Postres · Desayunos,Jacques Pastelería,53400,5900,59300
9202,9203,21-10-2020 15:20:10.141079,Desayunos · Café,Moramia,13600,4700,18300
9203,9204,21-10-2020 15:20:10.371791,Mexicana,Mexicanachos,15000,3900,18900
9204,9205,21-10-2020 15:20:10.702938,Pollo,Señor Fantástico,39700,4700,44400
9205,9206,21-10-2020 15:20:11.083739,Parrilla,Coquitas,12500,5600,18100
9206,9207,21-10-2020 15:20:11.364479,Saludable · Desayunos,Re.al Alimentos Reales,23000,4000,27000
9207,9208,21-10-2020 15:20:11.545482,Desayunos · Café,Moramia,31800,4700,36500
9208,9209,21-10-2020 15:20:11.826058,Desayunos · Italiana,Rceta By Rausch,15000,3600,18600
9209,9210,21-10-2020 15:20:12.107217,Café · Helados,Sofia heladería y café,17800,5800,23600
9210,9211,21-10-2020 15:20:12.438901,Café · Helados,Sofia heladería y café,7500,5800,13300
9211,9212,21-10-2020 15:20:12.620652,Saludable · Desayunos,Distrito Gourmet,53400,3700,57100
9212,9213,21-10-2020 15:20:12.901750,Postres,Levelma,24200,6200,30400
9213,9214,21-10-2020 15:20:13.233861,Sánduches · Pescados y Mariscos,Pacific Comida de Mar,35000,4000,39000
9214,9215,21-10-2020 15:20:13.564983,Saludable · Jugos y Batidos,Berdes Drinks & Salads,39700,3500,43200
9215,9216,21-10-2020 15:20:13.795692,Desayunos · Típica,Calentao Express,37900,6000,43900
9216,9217,21-10-2020 15:20:14.076649,Postres · Desayunos,Protein Bakes,23000,5900,28900
9217,9218,21-10-2020 15:20:14.307728,Postres · Desayunos,Café Quindio,48750,5700,54450
9218,9219,21-10-2020 15:20:14.538398,Sushi · Desayunos,Maki Roll,17800,4300,22100
9219,9220,21-10-2020 15:20:14.819122,Pizza,Pizza Andante,23000,6300,29300
9220,9221,21-10-2020 15:20:15.200374,Desayunos · Parrilla,Mi Patria,8900,4600,13500
9221,9222,21-10-2020 15:20:15.431263,Alta Cocina · Parrilla,Criterión,12500,6000,18500
9222,9223,21-10-2020 15:20:15.812064,Típica · Parrilla,La Parilla de David,23000,3100,26100
9223,9224,21-10-2020 15:20:16.042842,Desayunos,Cafetería el Kippe,23000,3200,26200
9224,9225,21-10-2020 15:20:16.223696,Saludable · Desayunos,Maracuyá,34500,6700,41200
9225,9226,21-10-2020 15:20:16.605001,Pollo,Oliva Va,17800,5600,23400
9226,9227,21-10-2020 15:20:16.785840,Desayunos · Típica,Casa Vieja,7500,6000,13500
9227,9228,21-10-2020 15:20:16.916494,Sushi,Umi,31800,5600,37400
9228,9229,21-10-2020 15:20:17.247430,Pollo · China,China Tao,17800,3500,21300
9229,9230,21-10-2020 15:20:17.478452,Parrilla,OAK Ahumado y Brebajes,13000,6000,19000
9230,9231,21-10-2020 15:20:17.759044,Desayunos · Jugos y Batidos,Frutiwow,9000,4100,13100
9231,9232,21-10-2020 15:20:18.140173,Peruana · Internacional,La Chifería,35000,6600,41600
9232,9233,21-10-2020 15:20:18.322123,Desayunos,Sr Buñuelo,34500,6400,40900
9233,9234,21-10-2020 15:20:18.653093,Desayunos · Empanadas,Empanadas Doraditas.com,15600,3000,18600
9234,9235,21-10-2020 15:20:19.034148,Hamburguesas,Burger Society,23000,4100,27100
9235,9236,21-10-2020 15:20:19.315173,Típica · Parrilla,Parrilla Farandula Gourmet,11870,5100,16970
9236,9237,21-10-2020 15:20:19.596288,Desayunos · Italiana,Rceta By Rausch,29500,3600,33100
9237,9238,21-10-2020 15:20:19.927476,Saludable · Desayunos,Básico y Elemental,15600,5900,21500
9238,9239,21-10-2020 15:20:20.208600,Pollo,Oliva Va,45800,5600,51400
9239,9240,21-10-2020 15:20:20.390166,Típica,Sabrosito,7500,4000,11500
9240,9241,21-10-2020 15:20:20.771425,Postres · Desayunos,Cosmo Cookies,11870,5900,17770
9241,9242,21-10-2020 15:20:20.952091,China,China Food Col,39700,3600,43300
9242,9243,21-10-2020 15:20:21.283067,Saludable · Desayunos,Maracuyá,70000,6700,76700
9243,9244,21-10-2020 15:20:21.514078,Postres · Desayunos,KOKOA & co.,34500,4700,39200
9244,9245,21-10-2020 15:20:21.644853,Postres · Desayunos,Aury Postres - Comidas & Picadas,18900,4700,23600
9245,9246,21-10-2020 15:20:21.875606,Parrilla,Arroces Maria Paula,53900,6800,60700
9246,9247,21-10-2020 15:20:22.206819,Desayunos · Comida Rápida,Chocolatto,23000,3400,26400
9247,9248,21-10-2020 15:20:22.437906,Desayunos · Panadería,Premium Break Bakery,15600,3700,19300
9248,9249,21-10-2020 15:20:22.818913,Desayunos · Panadería,Limarys,15600,6500,22100
9249,9250,21-10-2020 15:20:22.999934,Saludable · Parrilla,The Angels Grill and Drinks,13000,6200,19200
9250,9251,21-10-2020 15:20:23.230995,Pizza · Italiana,Pisapore - Pizza,24300,6600,30900
9251,9252,21-10-2020 15:20:23.413866,Parrilla,Rústico Picadería,8900,3800,12700
9252,9253,21-10-2020 15:20:23.595163,Típica,El Cucharón - Tipica,9000,4400,13400
9253,9254,21-10-2020 15:20:23.926647,Desayunos · Panadería,Choclofee,23000,4700,27700
9254,9255,21-10-2020 15:20:24.257730,Hamburguesas · Saludable,Restaurant Inn,24300,6100,30400
9255,9256,21-10-2020 15:20:24.388602,Saludable,Hanai - Bowls Saludables,17800,5900,23700
9256,9257,21-10-2020 15:20:24.619851,Saludable · Desayunos,Libre de Culpa,31800,4000,35800
9257,9258,21-10-2020 15:20:24.950964,Pescados y Mariscos,Fish Place - Del Mar,9000,5400,14400
9258,9259,21-10-2020 15:20:25.181873,Sushi,Sushi Reel,17800,4700,22500
9259,9260,21-10-2020 15:20:25.312647,Internacional,La Esquina con Sabor Parrilla,39700,3000,42700
9260,9261,21-10-2020 15:20:25.493543,Típica · Pescados y Mariscos,La Vitualla,27800,6300,34100
9261,9262,21-10-2020 15:20:25.674250,Pizza,pizza andante,17800,4200,22000
9262,9263,21-10-2020 15:20:25.904872,Desayunos · Café,El Gualilo,13000,6200,19200
9263,9264,21-10-2020 15:20:26.135936,Saludable · Desayunos,Bon Eat - Saludable,10700,4800,15500
9264,9265,21-10-2020 15:20:26.467062,Postres · Panadería,RIGHT AWAY FOODS,23000,6600,29600
9265,9266,21-10-2020 15:20:26.698085,Típica,Carbón & Mondongos,35000,6400,41400
9266,9267,21-10-2020 15:20:26.828721,Típica,Cazuelitas 93,65000,3900,68900
9267,9268,21-10-2020 15:20:27.159918,Pescados y Mariscos,Pescadero Héroes del Mar,15000,6600,21600
9268,9269,21-10-2020 15:20:27.541150,Pollo,Heart & Cooking,13600,5000,18600
9269,9270,21-10-2020 15:20:27.671891,Desayunos,Cafetería el Kippe,35000,3200,38200
9270,9271,21-10-2020 15:20:27.802573,Típica,Sabores De Mi Tierra,53400,5400,58800
9271,9272,21-10-2020 15:20:27.983723,Internacional,La Esquina con Sabor Parrilla,29500,3000,32500
9272,9273,21-10-2020 15:20:28.365219,Típica · Parrilla,Parrilla Farandula Gourmet,23000,5100,28100
9273,9274,21-10-2020 15:20:28.547006,Desayunos,Don Leo,31800,6000,37800
9274,9275,21-10-2020 15:20:28.677779,Desayunos · Árabe,Boniato Sabores Vivos,70000,5300,75300
9275,9276,21-10-2020 15:20:28.908754,Desayunos · Sánduches,Frutos del Bosque,17800,3500,21300
9276,9277,21-10-2020 15:20:29.039448,Saludable,Hanai - Bowls Saludables,12500,5900,18400
9277,9278,21-10-2020 15:20:29.320513,Postres,Toledo Pastelería,39700,6800,46500
9278,9279,21-10-2020 15:20:29.601716,Pollo · Sánduches,Pollos Century,24300,3000,27300
9279,9280,21-10-2020 15:20:29.732752,Perros Calientes,Dog Shop - Rapida,17800,4900,22700
9280,9281,21-10-2020 15:20:29.863539,Sushi,Canoa To Go,15600,5900,21500
9281,9282,21-10-2020 15:20:30.044301,Desayunos · Típica,Papadió - Colombianas,15600,5700,21300
9282,9283,21-10-2020 15:20:30.325390,Pizza,pizza andante,39700,4200,43900
9283,9284,21-10-2020 15:20:30.706818,Parrilla,Restaurante Bar Mi Ranchito,23000,5200,28200
9284,9285,21-10-2020 15:20:30.887908,Pizza · Italiana,Pisapore - Pizza,29500,6600,36100
9285,9286,21-10-2020 15:20:31.269276,Pescados y Mariscos,Pescadero Héroes del Mar,24200,6600,30800
9286,9287,21-10-2020 15:20:31.451132,Desayunos · Café,El Gualilo,9000,6200,15200
9287,9288,21-10-2020 15:20:31.832596,Postres · Saludable,Ana Rebana,27800,6300,34100
9288,9289,21-10-2020 15:20:31.963469,Desayunos · Café,Matchacha,17800,5900,23700
9289,9290,21-10-2020 15:20:32.244949,Saludable · Parrilla,Box,15600,3700,19300
9290,9291,21-10-2020 15:20:32.375822,Típica · Parrilla,Typykos,29500,6000,35500
9291,9292,21-10-2020 15:20:32.507022,Postres · Desayunos,Jacques Pastelería,31800,5900,37700
9292,9293,21-10-2020 15:20:32.788140,Desayunos · Café,Aromacafé el Placer de Compartir,23000,5000,28000
9293,9294,21-10-2020 15:20:33.119305,Helados,Buon Gelato,65000,4400,69400
9294,9295,21-10-2020 15:20:33.450659,Pollo · Desayunos,Piaf,18900,6500,25400
9295,9296,21-10-2020 15:20:33.632844,Desayunos · Panadería,Ficchi Panadería,17800,3100,20900
9296,9297,21-10-2020 15:20:33.814607,Postres · Desayunos,Maltihelado,48750,4500,53250
9297,9298,21-10-2020 15:20:34.146915,Saludable · Desayunos,Distrito Gourmet,35000,3700,38700
9298,9299,21-10-2020 15:20:34.479229,Saludable,Hanai - Bowls Saludables,13600,5900,19500
9299,9300,21-10-2020 15:20:34.812533,Postres · Desayunos,La Folie - Postres,23000,3300,26300
9300,9301,21-10-2020 15:20:35.194728,Saludable · Parrilla,Box,65000,3700,68700
9301,9302,21-10-2020 15:20:35.427346,Pollo · Desayunos,Piaf,53400,6500,59900
9302,9303,21-10-2020 15:20:35.659622,Parrilla,Rústico Picadería,8900,3800,12700
9303,9304,21-10-2020 15:20:35.841684,Típica · Parrilla,Toya,48750,4200,52950
9304,9305,21-10-2020 15:20:36.023638,Pollo · Pescados y Mariscos,Bang Bang Rice,9000,3400,12400
9305,9306,21-10-2020 15:20:36.356532,Saludable · Parrilla,The Angels Grill and Drinks,31800,6200,38000
9306,9307,21-10-2020 15:20:36.538882,Internacional,La Esquina con Sabor Parrilla,39700,3000,42700
9307,9308,21-10-2020 15:20:36.671327,Desayunos · Comida Rápida,La Veneca,24200,6300,30500
9308,9309,21-10-2020 15:20:36.804237,Típica,El Mondongo y Mucho Mas,37900,5600,43500
9309,9310,21-10-2020 15:20:36.985640,Típica,La Cocina,18900,4600,23500
9310,9311,21-10-2020 15:20:37.117916,Típica · Pescados y Mariscos,Arroces Mrg,35000,4300,39300
9311,9312,21-10-2020 15:20:37.249300,Típica,El Mondongo y Mucho Mas,8900,5600,14500
9312,9313,21-10-2020 15:20:37.481612,Desayunos,Bagel Shop,13000,3200,16200
9313,9314,21-10-2020 15:20:37.663318,Desayunos,Sunny Breakfast Brunch,53400,4300,57700
9314,9315,21-10-2020 15:20:38.045936,Típica · Parrilla,El Santandereano,23000,5200,28200
9315,9316,21-10-2020 15:20:38.327535,Postres · Desayunos,Maltihelado,10700,4500,15200
9316,9317,21-10-2020 15:20:38.459954,Típica,Cazuelitas 93,23000,3900,26900
9317,9318,21-10-2020 15:20:38.792371,Típica,Juan Chorizo,13000,3900,16900
9318,9319,21-10-2020 15:20:39.175097,Saludable · Desayunos,Re.al Alimentos Reales,70000,4000,74000
9319,9320,21-10-2020 15:20:39.506238,Parrilla · Café,Figaro Café/ Restaurante Argentino,12500,5800,18300
9320,9321,21-10-2020 15:20:39.688333,Típica · Parrilla,Mi Ranchito Parrilla,15600,4400,20000
9321,9322,21-10-2020 15:20:40.019387,Postres · Desayunos,Buñuelos nacho,10700,6600,17300
9322,9323,21-10-2020 15:20:40.200663,Desayunos,Sunny Breakfast Brunch,35000,4300,39300
9323,9324,21-10-2020 15:20:40.331711,Saludable · Desayunos,Malú,53900,3700,57600
9324,9325,21-10-2020 15:20:40.612814,Desayunos · Comida Rápida,Chocolatto,48750,3400,52150
9325,9326,21-10-2020 15:20:40.993888,Helados,Buon Gelato,27800,4400,32200
9326,9327,21-10-2020 15:20:41.174936,Típica,Baondish,39700,5800,45500
9327,9328,21-10-2020 15:20:41.506331,Desayunos · Panadería,El Pan de Phillippe,11870,4600,16470
9328,9329,21-10-2020 15:20:41.637510,Postres,Toledo Pastelería,48750,6800,55550
9329,9330,21-10-2020 15:20:41.868579,Saludable · Desayunos,Maracuyá,15000,6700,21700
9330,9331,21-10-2020 15:20:42.150055,Postres · Desayunos,Vivalight Market.,23000,6500,29500
9331,9332,21-10-2020 15:20:42.280885,Típica,Salsig,13600,5600,19200
9332,9333,21-10-2020 15:20:42.461733,Típica · Parrilla,Typykos,11870,6000,17870
9333,9334,21-10-2020 15:20:42.842899,Saludable · Parrilla,The Angels Grill and Drinks,35000,6200,41200
9334,9335,21-10-2020 15:20:42.973724,Mexicana,Cantina La 15,65000,4300,69300
9335,9336,21-10-2020 15:20:43.204883,Saludable · Jugos y Batidos,Berdes Drinks & Salads,23000,3500,26500
9336,9337,21-10-2020 15:20:43.385762,Desayunos · Parrilla,Mi Patria,13000,4600,17600
9337,9338,21-10-2020 15:20:43.666766,Desayunos · Jugos y Batidos,Kuriwaji,17800,6300,24100
9338,9339,21-10-2020 15:20:43.898790,Desayunos,El Fogón Castellano,17800,3200,21000
9339,9340,21-10-2020 15:20:44.280544,Pizza,Pastas Laurentina,27800,4800,32600
9340,9341,21-10-2020 15:20:44.661873,Hamburguesas · Desayunos,El Inglés Gastro Pub,48750,6600,55350
9341,9342,21-10-2020 15:20:44.842719,Desayunos · Pescados y Mariscos,Luzí­a - Mediterranea,53400,5700,59100
9342,9343,21-10-2020 15:20:44.973596,Pollo · Desayunos,Workzone,23000,3100,26100
9343,9344,21-10-2020 15:20:45.154613,Mexicana,Mexicanachos,15600,3900,19500
9344,9345,21-10-2020 15:20:45.536009,Saludable · Típica,Sopas Mrg,10700,3100,13800
9345,9346,21-10-2020 15:20:45.667676,Parrilla,Carnes la Zarza,24300,4900,29200
9346,9347,21-10-2020 15:20:45.948742,Desayunos · Típica,D´Porco,31800,3900,35700
9347,9348,21-10-2020 15:20:46.129870,Postres · Panadería,RIGHT AWAY FOODS,29500,6600,36100
9348,9349,21-10-2020 15:20:46.461243,Saludable · Desayunos,Básico y elemental,10700,5000,15700
9349,9350,21-10-2020 15:20:46.842578,Desayunos · Típica,La Parrilla Dorada Polo,23000,6600,29600
9350,9351,21-10-2020 15:20:47.174030,Desayunos · Típica,Desayunadero de la 42,12500,5900,18400
9351,9352,21-10-2020 15:20:47.305394,Saludable,Hanai - Bowls Saludables,53900,5900,59800
9352,9353,21-10-2020 15:20:47.536399,Hamburguesas · Alitas,Beer,10700,6600,17300
9353,9354,21-10-2020 15:20:47.917634,Desayunos · Café,Moramia,53900,4700,58600
9354,9355,21-10-2020 15:20:48.199240,Desayunos · Italiana,Rceta By Rausch,53400,3600,57000
9355,9356,21-10-2020 15:20:48.430628,Crepes,La Chabatta,18900,5900,24800
9356,9357,21-10-2020 15:20:48.812108,Desayunos,Jacinta Arepas de Huevo,65000,4000,69000
9357,9358,21-10-2020 15:20:49.093731,Saludable · Típica,Saludable Mrg,10700,5800,16500
9358,9359,21-10-2020 15:20:49.425064,Típica,Sopitas y Más,48750,4200,52950
9359,9360,21-10-2020 15:20:49.606124,Hamburguesas · Panadería,NYC Burgers,34500,6200,40700
9360,9361,21-10-2020 15:20:49.887224,Desayunos · Jugos y Batidos,Frutiwow,23000,4100,27100
9361,9362,21-10-2020 15:20:50.118582,Saludable · Parrilla,Box,7500,3700,11200
9362,9363,21-10-2020 15:20:50.451695,Típica,La Olla de Barro,70000,5300,75300
9363,9364,21-10-2020 15:20:50.733035,Desayunos · Típica,Rojo Gourmet,29500,4700,34200
9364,9365,21-10-2020 15:20:51.114453,Saludable,MIMA,23000,3700,26700
9365,9366,21-10-2020 15:20:51.446197,Desayunos · Típica,90 Calentados,8900,3700,12600
9366,9367,21-10-2020 15:20:51.677353,Pollo · Típica,Auyama,39700,3900,43600
9367,9368,21-10-2020 15:20:52.058558,Saludable,Amor Propio saludable,39700,4000,43700
9368,9369,21-10-2020 15:20:52.339476,Desayunos · Panadería,Limarys,8900,6500,15400
9369,9370,21-10-2020 15:20:52.570675,Típica,Sabores De Mi Tierra,27800,5400,33200
9370,9371,21-10-2020 15:20:52.751944,Pollo · Saludable,Tremenda Sal y Dulce,9000,6500,15500
9371,9372,21-10-2020 15:20:52.933094,Desayunos · Panadería,El Pan de Phillippe,7500,4600,12100
9372,9373,21-10-2020 15:20:53.164372,Desayunos,La Frijolada Desayunos,8900,4400,13300
9373,9374,21-10-2020 15:20:53.395796,Mexicana,Cantina La 15,15600,4300,19900
9374,9375,21-10-2020 15:20:53.676940,Parrilla,Carnes la Zarza,23000,4900,27900
9375,9376,21-10-2020 15:20:53.958673,Saludable · Desayunos,Distrito Gourmet,12500,3700,16200
9376,9377,21-10-2020 15:20:54.141375,Postres · Desayunos,Sweet Tale,15600,5800,21400
9377,9378,21-10-2020 15:20:54.472599,Sánduches,Submarin,23000,3800,26800
9378,9379,21-10-2020 15:20:54.853594,Saludable · Desayunos,Básico y elemental,7500,5000,12500
9379,9380,21-10-2020 15:20:55.084514,Pollo · Saludable,Tremenda Sal y Dulce,45800,6500,52300
9380,9381,21-10-2020 15:20:55.365711,Jugos y Batidos,Pomponio,13000,3600,16600
9381,9382,21-10-2020 15:20:55.646921,Típica,El Mondongo y Mucho Mas,39700,5600,45300
9382,9383,21-10-2020 15:20:55.777647,Típica,Carbón & Mondongos,10700,6400,17100
9383,9384,21-10-2020 15:20:56.058830,Desayunos · Típica,Fogón Sangileño,7500,5000,12500
9384,9385,21-10-2020 15:20:56.390096,Desayunos,Sr Buñuelo,15000,6400,21400
9385,9386,21-10-2020 15:20:56.771592,Saludable · Típica,Saludable Mrg,15000,5800,20800
9386,9387,21-10-2020 15:20:57.052682,Típica,Cazuelitas 93,23000,3900,26900
9387,9388,21-10-2020 15:20:57.283991,Pizza,18 Scalini,23000,4300,27300
9388,9389,21-10-2020 15:20:57.665464,Pollo · Saludable,Tremenda Sal y Dulce,23000,6500,29500
9389,9390,21-10-2020 15:20:57.996488,Parrilla,Carnes la Zarza,7500,4900,12400
9390,9391,21-10-2020 15:20:58.177568,Típica,La Olla de Barro,27800,5300,33100
9391,9392,21-10-2020 15:20:58.308610,Saludable,Puro Verde,7500,5700,13200
9392,9393,21-10-2020 15:20:58.439683,Postres,Beiked,35000,4000,39000
9393,9394,21-10-2020 15:20:58.670778,Pizza,Pizza Andante,39700,6300,46000
9394,9395,21-10-2020 15:20:59.001861,Típica · Parrilla,La Ternera Parrilla,23000,5200,28200
9395,9396,21-10-2020 15:20:59.384230,Desayunos,Don Leo,18900,6000,24900
9396,9397,21-10-2020 15:20:59.665555,Saludable · Jugos y Batidos,Berdes Drinks & Salads,23000,3500,26500
9397,9398,21-10-2020 15:20:59.796535,Pollo · Desayunos,Workzone,24300,3100,27400
9398,9399,21-10-2020 15:21:00.127988,Típica · Pescados y Mariscos,Arroces Mrg,8900,4300,13200
9399,9400,21-10-2020 15:21:00.359147,Desayunos · Comida Rápida,La Veneca,35000,6300,41300
9400,9401,21-10-2020 15:21:00.640658,Típica,Campo Victoria,13600,3000,16600
9401,9402,21-10-2020 15:21:00.921916,Saludable · Desayunos,Maracuyá,53900,6700,60600
9402,9403,21-10-2020 15:21:01.203432,Típica,La Herencia,24200,5900,30100
9403,9404,21-10-2020 15:21:01.584646,Desayunos · Típica,Peninsula Calentados y Parrilla,53900,3400,57300
9404,9405,21-10-2020 15:21:01.865690,Desayunos,Bagel Shop,12500,3200,15700
9405,9406,21-10-2020 15:21:02.247323,Desayunos,Desayunos en Bogotá,27800,3400,31200
9406,9407,21-10-2020 15:21:02.378315,Desayunos · Comida Rápida,Chocolatto,65000,3400,68400
9407,9408,21-10-2020 15:21:02.709723,Desayunos · Empanadas,Empanadas Doraditas.com,53900,3000,56900
9408,9409,21-10-2020 15:21:02.890646,Panadería,Boul,23000,3100,26100
9409,9410,21-10-2020 15:21:03.071829,Desayunos · Panadería,El Pan de Phillippe,35000,4600,39600
9410,9411,21-10-2020 15:21:03.453421,Desayunos · Panadería,Santa Juana Food Bar,35000,5900,40900
9411,9412,21-10-2020 15:21:03.634756,Saludable · Parrilla,Box,29500,3700,33200
9412,9413,21-10-2020 15:21:03.915939,Típica,Sabores De Mi Tierra,35000,5400,40400
9413,9414,21-10-2020 15:21:04.297954,Postres · Helados,Mahé,29500,6000,35500
9414,9415,21-10-2020 15:21:04.480310,Pizza,Pastas Laurentina,17800,4800,22600
9415,9416,21-10-2020 15:21:04.861711,Saludable · Desayunos,Fresh Co,27800,5600,33400
9416,9417,21-10-2020 15:21:04.992646,Poke,Poke Go,70000,4600,74600
9417,9418,21-10-2020 15:21:05.124638,Sushi · Asiática,Arigato,7500,5300,12800
9418,9419,21-10-2020 15:21:05.406307,Postres · Desayunos,Café Quindio,12500,5700,18200
9419,9420,21-10-2020 15:21:05.738241,Desayunos · Típica,Casa Vieja,65000,6000,71000
9420,9421,21-10-2020 15:21:05.869689,Saludable,Hanai - Bowls Saludables,29500,5900,35400
9421,9422,21-10-2020 15:21:06.201114,Desayunos,Cafetería el Kippe,13000,3200,16200
9422,9423,21-10-2020 15:21:06.582491,Saludable · Desayunos,Libre de Culpa,13600,4000,17600
9423,9424,21-10-2020 15:21:06.913688,Saludable · Típica,Saludable Mrg,24300,5800,30100
9424,9425,21-10-2020 15:21:07.195008,Alta Cocina · Italiana,Trattoria de la Plaza,13000,6000,19000
9425,9426,21-10-2020 15:21:07.326646,Parrilla,Coquitas,27800,5600,33400
9426,9427,21-10-2020 15:21:07.608107,Alta Cocina · Postres,La Pinta,12500,4500,17000
9427,9428,21-10-2020 15:21:07.939792,Postres · Desayunos,Restaurante Cornelia,13600,5500,19100
9428,9429,21-10-2020 15:21:08.071143,Desayunos · Panadería,Pasteleite,17800,5900,23700
9429,9430,21-10-2020 15:21:08.302487,Postres · Desayunos,BagBog Bagels,53400,6400,59800
9430,9431,21-10-2020 15:21:08.584115,Parrilla · Internacional,Taperia de la Plaza,13600,5700,19300
9431,9432,21-10-2020 15:21:08.715258,Postres · Desayunos,Amelie Helados,13000,6400,19400
9432,9433,21-10-2020 15:21:08.946669,Postres · Desayunos,Vivalight Market.,45800,6500,52300
9433,9434,21-10-2020 15:21:09.278165,Desayunos · Café,Norma's Ice Cream Café,13600,6300,19900
9434,9435,21-10-2020 15:21:09.560821,Saludable,Hanai - Bowls Saludables,53400,5900,59300
9435,9436,21-10-2020 15:21:09.742288,Postres · Café,Loló Coffee & Snacks,13000,4600,17600
9436,9437,21-10-2020 15:21:09.923834,Hamburguesas,Monchis - Hamburguesa,12500,4300,16800
9437,9438,21-10-2020 15:21:10.255283,Saludable · Desayunos,Raices Bienestar Gourmet,7500,6600,14100
9438,9439,21-10-2020 15:21:10.436816,Desayunos · Sánduches,Garnish,17800,5200,23000
9439,9440,21-10-2020 15:21:10.668117,Desayunos · Típica,La Parrilla Dorada Polo,11870,6600,18470
9440,9441,21-10-2020 15:21:10.949440,Postres,La Galeta,18900,3000,21900
9441,9442,21-10-2020 15:21:11.180540,Saludable · Parrilla,The Angels Grill and Drinks,37900,6200,44100
9442,9443,21-10-2020 15:21:11.462064,Parrilla,Carnes la Zarza,17800,4900,22700
9443,9444,21-10-2020 15:21:11.643476,Saludable · Parrilla,Box,13600,3700,17300
9444,9445,21-10-2020 15:21:11.824854,Postres · Café,Loló Coffee & Snacks,23000,4600,27600
9445,9446,21-10-2020 15:21:11.955930,Desayunos · Panadería,Juliana Restaurante,24300,6100,30400
9446,9447,21-10-2020 15:21:12.287247,Típica,La Cocina,65000,4600,69600
9447,9448,21-10-2020 15:21:12.418682,Desayunos,Fratelli - Desayunos,39700,4600,44300
9448,9449,21-10-2020 15:21:12.800096,Típica · Parrilla,Typykos,34500,6000,40500
9449,9450,21-10-2020 15:21:13.081677,Saludable,Ventura Soup y Salad,53900,3800,57700
9450,9451,21-10-2020 15:21:13.263560,Asiática,Thai Station,37900,6000,43900
9451,9452,21-10-2020 15:21:13.645812,Desayunos · Árabe,Boniato Sabores Vivos,9000,5300,14300
9452,9453,21-10-2020 15:21:13.977861,Sushi,Kim Pop,17800,5400,23200
9453,9454,21-10-2020 15:21:14.259607,Desayunos · Típica,Criollomania,39700,5200,44900
9454,9455,21-10-2020 15:21:14.541358,Saludable · Desayunos,Guadalupe - Fruteria,70000,5900,75900
9455,9456,21-10-2020 15:21:14.873679,Sushi,Sushi Reel,23000,4700,27700
9456,9457,21-10-2020 15:21:15.155078,Comida Rápida · Perros Calientes,Similoa - Comida Rapida,65000,3700,68700
9457,9458,21-10-2020 15:21:15.336521,Saludable · Típica,Saludable Mrg,29500,5800,35300
9458,9459,21-10-2020 15:21:15.668617,Desayunos · Café,Aromacafé el Placer de Compartir,45800,5000,50800
9459,9460,21-10-2020 15:21:16.050261,Saludable · Desayunos,Distrito Gourmet,9000,3700,12700
9460,9461,21-10-2020 15:21:16.181425,Postres · Desayunos,Cosmo Cookies,35000,5900,40900
9461,9462,21-10-2020 15:21:16.413510,Sushi,Kim Pop,11870,5400,17270
9462,9463,21-10-2020 15:21:16.795319,Comida Rápida,Fiesta Digital Andrés,23000,3100,26100
9463,9464,21-10-2020 15:21:16.976385,Desayunos · Panadería,El Pan de Phillippe,12500,4600,17100
9464,9465,21-10-2020 15:21:17.358199,Saludable · Parrilla,The Angels Grill and Drinks,53400,6200,59600
9465,9466,21-10-2020 15:21:17.740023,Saludable · Desayunos,La Estampilla,10700,6000,16700
9466,9467,21-10-2020 15:21:18.071751,Desayunos · Panadería,Decofruta,53900,4700,58600
9467,9468,21-10-2020 15:21:18.453415,Desayunos · Típica,Peninsula Calentados y Parrilla,39700,3400,43100
9468,9469,21-10-2020 15:21:18.834957,Desayunos · Panadería,Pasteleite,23000,5900,28900
9469,9470,21-10-2020 15:21:19.066638,Desayunos · Panadería,Choclofee,53900,4700,58600
9470,9471,21-10-2020 15:21:19.448019,Desayunos · Panadería,Juliana Restaurante,13600,6100,19700
9471,9472,21-10-2020 15:21:19.779749,Saludable · Desayunos,Libre de Culpa,23000,4000,27000
9472,9473,21-10-2020 15:21:20.062289,Sushi · Desayunos,Maki Roll,13000,4300,17300
9473,9474,21-10-2020 15:21:20.343723,Sushi,Canoa To Go,7500,5900,13400
9474,9475,21-10-2020 15:21:20.725522,Parrilla,Coquitas,24300,5600,29900
9475,9476,21-10-2020 15:21:21.107338,Típica · Pescados y Mariscos,La Vitualla,53400,6300,59700
9476,9477,21-10-2020 15:21:21.289029,Pescados y Mariscos,Pescadero Héroes del Mar,23000,6600,29600
9477,9478,21-10-2020 15:21:21.420455,Postres,La Galeta,24300,3000,27300
9478,9479,21-10-2020 15:21:21.752392,Mexicana,Cantina La 15,17800,4300,22100
9479,9480,21-10-2020 15:21:22.034117,Saludable · Desayunos,Bon Eat - Saludable,9000,4800,13800
9480,9481,21-10-2020 15:21:22.215843,Saludable,A2manos,8900,4200,13100
9481,9482,21-10-2020 15:21:22.447884,Hamburguesas · Panadería,NYC Burgers,31800,6200,38000
9482,9483,21-10-2020 15:21:22.629841,Desayunos · Comida Rápida,Chocolatto,11870,3400,15270
9483,9484,21-10-2020 15:21:22.811422,Pollo · Típica,Auyama,23000,3900,26900
9484,9485,21-10-2020 15:21:23.043270,Pollo · Saludable,Gratina,8900,4200,13100
9485,9486,21-10-2020 15:21:23.274942,Sushi · Asiática,Tu Sushi,11870,6400,18270
9486,9487,21-10-2020 15:21:23.557091,Típica,Bendita S,23000,4600,27600
9487,9488,21-10-2020 15:21:23.939279,Postres · Panadería,RIGHT AWAY FOODS,35000,6600,41600
9488,9489,21-10-2020 15:21:24.121237,Alta Cocina · Parrilla,Criterión,53900,6000,59900
9489,9490,21-10-2020 15:21:24.503182,Típica,Sabrosito,35000,4000,39000
9490,9491,21-10-2020 15:21:24.835118,Postres · Desayunos,Sweet Tale,48750,5800,54550
9491,9492,21-10-2020 15:21:25.067924,Saludable · Desayunos,Libre de Culpa,23000,4000,27000
9492,9493,21-10-2020 15:21:25.350172,Desayunos,Cafetería el Kippe,31800,3200,35000
9493,9494,21-10-2020 15:21:25.531773,Postres · Desayunos,Maltihelados,15000,6200,21200
9494,9495,21-10-2020 15:21:25.913657,Parrilla,Carnes la Zarza,17800,4900,22700
9495,9496,21-10-2020 15:21:26.095292,Sushi · Asiática,Arigato,53900,5300,59200
9496,9497,21-10-2020 15:21:26.327115,Desayunos · Panadería,Artesanos,7500,4300,11800
9497,9498,21-10-2020 15:21:26.708970,Desayunos · Empanadas,Mis Delicias,9000,3200,12200
9498,9499,21-10-2020 15:21:27.090693,Típica · Parrilla,La Parilla de David,37900,3100,41000
9499,9500,21-10-2020 15:21:27.322557,Saludable,Hanai - Bowls Saludables,34500,5900,40400
9500,9501,21-10-2020 15:21:27.504275,Postres · Café,Celestino Café,48750,5900,54650
9501,9502,21-10-2020 15:21:27.836371,Desayunos · Típica,Peninsula Calentados y Parrilla,39700,3400,43100
9502,9503,21-10-2020 15:21:27.968368,Desayunos,Jacinta Arepas de Huevo,37900,4000,41900
9503,9504,21-10-2020 15:21:28.100128,Típica,Sabrosito,18900,4000,22900
9504,9505,21-10-2020 15:21:28.381757,Típica · Parrilla,El Santandereano,31800,5200,37000
9505,9506,21-10-2020 15:21:28.512901,Desayunos · Sánduches,Garnish,13000,5200,18200
9506,9507,21-10-2020 15:21:28.894737,Mexicana,Cantina La 15,39700,4300,44000
9507,9508,21-10-2020 15:21:29.176469,Desayunos,Bagel Shop,34500,3200,37700
9508,9509,21-10-2020 15:21:29.458401,Desayunos · Panadería,El Pan de Phillippe,27800,4600,32400
9509,9510,21-10-2020 15:21:29.840303,Pizza · Italiana,Pisapore - Pizza,10700,6600,17300
9510,9511,21-10-2020 15:21:30.123347,Desayunos,El Corral - Desayunos,35000,5000,40000
9511,9512,21-10-2020 15:21:30.354985,Pescados y Mariscos,La Gran Cazuela,34500,3200,37700
9512,9513,21-10-2020 15:21:30.486388,Saludable · Desayunos,Libre de Culpa,29500,4000,33500
9513,9514,21-10-2020 15:21:30.667865,Típica · Parrilla,Parrilla Farandula Gourmet,23000,5100,28100
9514,9515,21-10-2020 15:21:30.848998,Desayunos · Panadería,Limarys,12500,6500,19000
9515,9516,21-10-2020 15:21:31.180770,Postres · Desayunos,La Folie - Postres,8900,3300,12200
9516,9517,21-10-2020 15:21:31.512172,Desayunos · Panadería,Premium Break Bakery,31800,3700,35500
9517,9518,21-10-2020 15:21:31.793730,Saludable,Ventura Soup y Salad,37900,3800,41700
9518,9519,21-10-2020 15:21:31.975029,Sushi · Asiática,Arigato,15000,5300,20300
9519,9520,21-10-2020 15:21:32.306703,Parrilla,Campocina,37900,4600,42500
9520,9521,21-10-2020 15:21:32.538172,Parrilla,OAK Ahumado y Brebajes,39700,6000,45700
9521,9522,21-10-2020 15:21:32.769590,Desayunos · Típica,Casa Vieja,8900,6000,14900
9522,9523,21-10-2020 15:21:33.151398,Sánduches,Submarin,24300,3800,28100
9523,9524,21-10-2020 15:21:33.533530,Desayunos · Jugos y Batidos,Frutiwow,24300,4100,28400
9524,9525,21-10-2020 15:21:33.764877,Italiana,Bocatto Di Passo,7500,5000,12500
9525,9526,21-10-2020 15:21:34.096430,Postres · Desayunos,KOKOA & co.,9000,4700,13700
9526,9527,21-10-2020 15:21:34.327838,Desayunos · Comida Rápida,La Veneca,45800,6300,52100
9527,9528,21-10-2020 15:21:34.559458,Desayunos · Panadería,Pasteleite,35000,5900,40900
9528,9529,21-10-2020 15:21:34.691041,Postres · Desayunos,Vivalight Market.,53400,6500,59900
9529,9530,21-10-2020 15:21:34.822585,Desayunos · Mexicana,La Mera Mera - Mexicana,17800,3100,20900
9530,9531,21-10-2020 15:21:35.205540,Desayunos · Jugos y Batidos,Kuriwaji,15000,6300,21300
9531,9532,21-10-2020 15:21:35.487636,Desayunos,Archies Desayunos,35000,3100,38100
9532,9533,21-10-2020 15:21:35.669244,Sushi,Kim Pop,45800,5400,51200
9533,9534,21-10-2020 15:21:35.951067,Típica,Campo Victoria,17800,3000,20800
9534,9535,21-10-2020 15:21:36.083465,Desayunos,Señor Desayuno,17800,6800,24600
9535,9536,21-10-2020 15:21:36.365278,Típica,Sabores De Mi Tierra,23000,5400,28400
9536,9537,21-10-2020 15:21:36.646893,Pollo · Típica,Auyama,8900,3900,12800
9537,9538,21-10-2020 15:21:36.828573,Típica,Campo Victoria,23000,3000,26000
9538,9539,21-10-2020 15:21:37.059982,Desayunos · Típica,Rojo Gourmet,31800,4700,36500
9539,9540,21-10-2020 15:21:37.241475,Desayunos · Pescados y Mariscos,Luzí­a - Mediterranea,27800,5700,33500
9540,9541,21-10-2020 15:21:37.423207,Desayunos · Café,vereda central calle 99,35000,5700,40700
9541,9542,21-10-2020 15:21:37.655259,Pizza,18 Scalini,37900,4300,42200
9542,9543,21-10-2020 15:21:37.937115,Desayunos · Café,Libertario Coffee Roasters,70000,4600,74600
9543,9544,21-10-2020 15:21:38.219013,Parrilla · Café,Figaro Café/ Restaurante Argentino,35000,5800,40800
9544,9545,21-10-2020 15:21:38.601516,Mexicana,Hidalgo Taquería,29500,4900,34400
9545,9546,21-10-2020 15:21:38.933209,Desayunos,El Fogón Castellano,15600,3200,18800
9546,9547,21-10-2020 15:21:39.215155,Poke,Poke Go,29500,4600,34100
9547,9548,21-10-2020 15:21:39.397236,Comida Rápida,Fiesta Digital Andrés,29500,3100,32600
9548,9549,21-10-2020 15:21:39.728940,Desayunos · Panadería,Juliana Restaurante,70000,6100,76100
9549,9550,21-10-2020 15:21:39.910513,Peruana,Uma Cantina Peruana,10700,3200,13900
9550,9551,21-10-2020 15:21:40.042021,Saludable · Desayunos,Maracuyá,15600,6700,22300
9551,9552,21-10-2020 15:21:40.425009,Desayunos,La Frijolada Desayunos,53900,4400,58300
9552,9553,21-10-2020 15:21:40.556761,Pollo,Oliva Va,11870,5600,17470
9553,9554,21-10-2020 15:21:40.788548,Saludable · Desayunos,Libre de Culpa,24200,4000,28200
9554,9555,21-10-2020 15:21:41.020145,Típica · Parrilla,Toya,53400,4200,57600
9555,9556,21-10-2020 15:21:41.151710,Postres · Helados,Mahé,35000,6000,41000
9556,9557,21-10-2020 15:21:41.433456,Hamburguesas · Alitas,Beer,18900,6600,25500
9557,9558,21-10-2020 15:21:41.715506,Típica,La Herencia,10700,5900,16600
9558,9559,21-10-2020 15:21:42.047243,Saludable · Típica,Saludable Mrg,11870,5800,17670
9559,9560,21-10-2020 15:21:42.379042,Helados,Orso To Go,17800,6800,24600
9560,9561,21-10-2020 15:21:42.660919,Desayunos · Jugos y Batidos,Kuriwaji,34500,6300,40800
9561,9562,21-10-2020 15:21:42.942514,Desayunos · Típica,Cochon,39700,3300,43000
9562,9563,21-10-2020 15:21:43.224171,Saludable · Desayunos,La Cesta,53900,4700,58600
9563,9564,21-10-2020 15:21:43.355912,Desayunos · Típica,Parrilla Farandula Típico,15000,5900,20900
9564,9565,21-10-2020 15:21:43.687713,Parrilla,Coquitas,7500,5600,13100
9565,9566,21-10-2020 15:21:43.969494,Postres · Desayunos,La Folie - Postres,23000,3300,26300
9566,9567,21-10-2020 15:21:44.251083,Desayunos · Café,Libertario Coffee Roasters,11870,4600,16470
9567,9568,21-10-2020 15:21:44.382782,Desayunos · Italiana,Rceta By Rausch,23000,3600,26600
9568,9569,21-10-2020 15:21:44.564339,Sánduches · China,Peru Mix,13000,5900,18900
9569,9570,21-10-2020 15:21:44.946078,Desayunos,La Frijolada Desayunos,17800,4400,22200
9570,9571,21-10-2020 15:21:45.177913,Alta Cocina · Italiana,Trattoria de la Plaza,10700,6000,16700
9571,9572,21-10-2020 15:21:45.460869,Postres,Beiked,35000,4000,39000
9572,9573,21-10-2020 15:21:45.742693,Sushi · Asiática,Tu Sushi,39700,6400,46100
9573,9574,21-10-2020 15:21:45.924457,Postres · Desayunos,Amelie Helados,15000,6400,21400
9574,9575,21-10-2020 15:21:46.306773,Sánduches · Pescados y Mariscos,Pacific Comida de Mar,48750,4000,52750
9575,9576,21-10-2020 15:21:46.538499,Pollo · Pescados y Mariscos,Bang Bang Rice,23000,3400,26400
9576,9577,21-10-2020 15:21:46.820303,Típica · Parrilla,Typykos,13000,6000,19000
9577,9578,21-10-2020 15:21:46.952130,Pollo,Oliva Va,53400,5600,59000
9578,9579,21-10-2020 15:21:47.334139,Pollo,Chicken House,10700,4200,14900
9579,9580,21-10-2020 15:21:47.666124,Típica,La Olla de Barro,9000,5300,14300
9580,9581,21-10-2020 15:21:47.948005,Hamburguesas,Bendito Cordero,45800,5800,51600
9581,9582,21-10-2020 15:21:48.330070,Parrilla,Rústico Picadería,23000,3800,26800
9582,9583,21-10-2020 15:21:48.461862,Mexicana,La leyenda mexican kitchen,70000,3200,73200
9583,9584,21-10-2020 15:21:48.693448,Típica,Juan Chorizo,8900,3900,12800
9584,9585,21-10-2020 15:21:48.925078,Helados,Buon Gelato,39700,4400,44100
9585,9586,21-10-2020 15:21:49.157299,Sánduches · Pescados y Mariscos,Pacific Comida de Mar,48750,4000,52750
9586,9587,21-10-2020 15:21:49.439216,Pollo · Pescados y Mariscos,Bang Bang Rice,24300,3400,27700
9587,9588,21-10-2020 15:21:49.721163,Helados,Buon Gelato,48750,4400,53150
9588,9589,21-10-2020 15:21:49.852660,Postres,Beiked,53400,4000,57400
9589,9590,21-10-2020 15:21:50.134521,Postres · Café,Loló Coffee & Snacks,70000,4600,74600
9590,9591,21-10-2020 15:21:50.316142,Saludable · Desayunos,Básico y elemental,7500,5000,12500
9591,9592,21-10-2020 15:21:50.548802,Saludable,Hanai - Bowls Saludables,35000,5900,40900
9592,9593,21-10-2020 15:21:50.931424,Desayunos · Panadería,Juliana Restaurante,24200,6100,30300
9593,9594,21-10-2020 15:21:51.313818,Pollo,Chicken House,17800,4200,22000
9594,9595,21-10-2020 15:21:51.445546,Desayunos · Típica,D´Porco,12500,3900,16400
9595,9596,21-10-2020 15:21:51.727557,Desayunos · Típica,Papadió - Colombianas,45800,5700,51500
9596,9597,21-10-2020 15:21:52.009314,Típica · Parrilla,Mi Ranchito Parrilla,35000,4400,39400
9597,9598,21-10-2020 15:21:52.291275,Pollo · Saludable,Tremenda Sal y Dulce,35000,6500,41500
9598,9599,21-10-2020 15:21:52.623478,Desayunos,Cafetería el Kippe,13000,3200,16200
9599,9600,21-10-2020 15:21:52.855447,Desayunos,Fratelli - Desayunos,45800,4600,50400
9600,9601,21-10-2020 15:21:53.187384,Pollo · Desayunos,Caserito Gourmet,65000,6700,71700
9601,9602,21-10-2020 15:21:53.369352,Desayunos · Panadería,Pasteleite,23000,5900,28900
9602,9603,21-10-2020 15:21:53.651455,Postres,Beiked,17800,4000,21800
9603,9604,21-10-2020 15:21:53.933273,Pollo · Desayunos,Piaf,13600,6500,20100
9604,9605,21-10-2020 15:21:54.114666,Italiana,Bocatto Di Passo,37900,5000,42900
9605,9606,21-10-2020 15:21:54.246311,Típica,Juan Chorizo,65000,3900,68900
9606,9607,21-10-2020 15:21:54.527993,Desayunos · Café,Moramia,65000,4700,69700
9607,9608,21-10-2020 15:21:54.759775,Saludable · Desayunos,Libre de Culpa,15000,4000,19000
9608,9609,21-10-2020 15:21:55.041605,Típica,Campo Victoria,31800,3000,34800
9609,9610,21-10-2020 15:21:55.223607,Pollo · Típica,Auyama,53400,3900,57300
9610,9611,21-10-2020 15:21:55.505469,Desayunos · Típica,D'Porco - Lechona,65000,6300,71300
9611,9612,21-10-2020 15:21:55.688543,Saludable,Hanai - Bowls Saludables,17800,5900,23700
9612,9613,21-10-2020 15:21:56.020740,Saludable,MIMA,24200,3700,27900
9613,9614,21-10-2020 15:21:56.352699,Pizza · Italiana,Pisapore - Pizza,65000,6600,71600
9614,9615,21-10-2020 15:21:56.684675,Típica · Parrilla,El Portal de la Antigua,15600,5600,21200
9615,9616,21-10-2020 15:21:57.066524,Saludable · Desayunos,Re.al Alimentos Reales,53900,4000,57900
9616,9617,21-10-2020 15:21:57.298197,Saludable · Parrilla,Box,23000,3700,26700
9617,9618,21-10-2020 15:21:57.680250,Desayunos,Don Leo,10700,6000,16700
9618,9619,21-10-2020 15:21:58.012025,Típica,Campo Victoria,70000,3000,73000
9619,9620,21-10-2020 15:21:58.294322,Italiana,Bocatto Di Passo,35000,5000,40000
9620,9621,21-10-2020 15:21:58.475988,Saludable · Desayunos,Bawana - Sandwich,31800,3400,35200
9621,9622,21-10-2020 15:21:58.658201,Saludable · Desayunos,Bawana - Sandwich,31800,3400,35200
9622,9623,21-10-2020 15:21:58.889939,Hamburguesas · Saludable,Restaurant Inn,11870,6100,17970
9623,9624,21-10-2020 15:21:59.071820,Desayunos · Panadería,Le Pain Quotidien,34500,3900,38400
9624,9625,21-10-2020 15:21:59.404004,Postres · Desayunos,Protein Bakes,17800,5900,23700
9625,9626,21-10-2020 15:21:59.586434,Pescados y Mariscos,Pescadero Héroes del Mar,53900,6600,60500
9626,9627,21-10-2020 15:21:59.918665,Postres · Desayunos,Café Quindio,23000,5700,28700
9627,9628,21-10-2020 15:22:00.050450,Desayunos · Jugos y Batidos,Dont Be Hungry,48750,5600,54350
9628,9629,21-10-2020 15:22:00.232362,Pollo · Desayunos,Piaf,27800,6500,34300
9629,9630,21-10-2020 15:22:00.514444,Postres · Desayunos,Sweet Tale,15000,5800,20800
9630,9631,21-10-2020 15:22:00.747331,Típica,Sopitas y Más,13000,4200,17200
9631,9632,21-10-2020 15:22:00.979491,Pizza,Pastas Laurentina,37900,4800,42700
9632,9633,21-10-2020 15:22:01.311395,Postres · Desayunos,Maria Luisa - Postres,7500,4300,11800
9633,9634,21-10-2020 15:22:01.493268,Típica,La Olla de Barro,65000,5300,70300
9634,9635,21-10-2020 15:22:01.725034,Sushi,Kim Pop,27800,5400,33200
9635,9636,21-10-2020 15:22:01.906815,Saludable · Desayunos,Copacabana Açai Bowls,10700,3000,13700
9636,9637,21-10-2020 15:22:02.188970,Desayunos,Bagel Shop,23000,3200,26200
9637,9638,21-10-2020 15:22:02.320575,Saludable · Desayunos,Básico y Elemental,65000,5900,70900
9638,9639,21-10-2020 15:22:02.552503,Desayunos · Sánduches,Garnish,8900,5200,14100
9639,9640,21-10-2020 15:22:02.734428,Alta Cocina · Parrilla,Criterión,10700,6000,16700
9640,9641,21-10-2020 15:22:02.966443,Internacional,La Esquina con Sabor Parrilla,24300,3000,27300
9641,9642,21-10-2020 15:22:03.298430,Postres · Desayunos,Sharmus,24300,6100,30400
9642,9643,21-10-2020 15:22:03.530486,Pollo · Típica,Auyama,53900,3900,57800
9643,9644,21-10-2020 15:22:03.812488,Desayunos,El Fogón Castellano,70000,3200,73200
9644,9645,21-10-2020 15:22:04.194512,Típica,Cabrito Santandereano,37900,6600,44500
9645,9646,21-10-2020 15:22:04.476573,Desayunos,Jacinta Arepas de Huevo,70000,4000,74000
9646,9647,21-10-2020 15:22:04.608606,Desayunos · Panadería,Choclofee,12500,4700,17200
9647,9648,21-10-2020 15:22:04.790939,Desayunos · Panadería,El Pan de Phillippe,24200,4600,28800
9648,9649,21-10-2020 15:22:05.173261,Sánduches · Pescados y Mariscos,Pacific Comida de Mar,39700,4000,43700
9649,9650,21-10-2020 15:22:05.455535,Pizza,18 Scalini,48750,4300,53050
9650,9651,21-10-2020 15:22:05.687752,Desayunos,Cafetería el Kippe,9000,3200,12200
9651,9652,21-10-2020 15:22:05.821213,Típica,Campo Victoria,65000,3000,68000
9652,9653,21-10-2020 15:22:06.203749,Comida Rápida · Perros Calientes,Similoa - Comida Rapida,8900,3700,12600
9653,9654,21-10-2020 15:22:06.586289,Hamburguesas,Gofi Burger,29500,5100,34600
9654,9655,21-10-2020 15:22:06.918381,Desayunos,Sr Buñuelo,13600,6400,20000
9655,9656,21-10-2020 15:22:07.250823,Desayunos · Café,Matchacha,53400,5900,59300
9656,9657,21-10-2020 15:22:07.433325,Saludable · Desayunos,Básico y Elemental,7500,5900,13400
9657,9658,21-10-2020 15:22:07.665468,Desayunos,La Frijolada Desayunos,37900,4400,42300
9658,9659,21-10-2020 15:22:08.047804,Típica,Juan Chorizo,53400,3900,57300
9659,9660,21-10-2020 15:22:08.280235,Desayunos · Panadería,Siena Café,24300,3700,28000
9660,9661,21-10-2020 15:22:08.512496,Desayunos · Parrilla,Mi Patria,15000,4600,19600
9661,9662,21-10-2020 15:22:08.794689,Postres · Desayunos,Cosmo Cookies,35000,5900,40900
9662,9663,21-10-2020 15:22:09.076519,Hamburguesas,Burger Society,53400,4100,57500
9663,9664,21-10-2020 15:22:09.308922,Hamburguesas,Bendito Cordero,18900,5800,24700
9664,9665,21-10-2020 15:22:09.541440,Típica · Pescados y Mariscos,Arroces Mrg,37900,4300,42200
9665,9666,21-10-2020 15:22:09.723464,Típica · Pescados y Mariscos,Arroces Mrg,24200,4300,28500
9666,9667,21-10-2020 15:22:09.905548,Desayunos,Fratelli - Desayunos,15600,4600,20200
9667,9668,21-10-2020 15:22:10.288188,Desayunos · Típica,Casa Vieja,35000,6000,41000
9668,9669,21-10-2020 15:22:10.470407,Helados,Orso To Go,53900,6800,60700
9669,9670,21-10-2020 15:22:10.802522,Desayunos · Típica,La Parrilla Dorada Polo,13000,6600,19600
9670,9671,21-10-2020 15:22:10.985667,Mexicana,Hidalgo Taquería,24300,4900,29200
9671,9672,21-10-2020 15:22:11.267759,Mexicana,Mexicanachos,31800,3900,35700
9672,9673,21-10-2020 15:22:11.500100,Jugos y Batidos,Pomponio,15000,3600,18600
9673,9674,21-10-2020 15:22:11.832350,Desayunos · Café,Norma's Ice Cream Café,24300,6300,30600
9674,9675,21-10-2020 15:22:12.114688,Sushi · Asiática,Arigato,35000,5300,40300
9675,9676,21-10-2020 15:22:12.247109,Postres,Levelma,24200,6200,30400
9676,9677,21-10-2020 15:22:12.529206,Desayunos · Típica,D´Porco,65000,3900,68900
9677,9678,21-10-2020 15:22:12.761299,Postres · Desayunos,Café Quindio,13000,5700,18700
9678,9679,21-10-2020 15:22:13.093869,Desayunos · Internacional,Camilia,45800,3900,49700
9679,9680,21-10-2020 15:22:13.227047,Típica,Sabores De Mi Tierra,53400,5400,58800
9680,9681,21-10-2020 15:22:13.559639,Desayunos · Empanadas,Empanadas Doraditas.com,24300,3000,27300
9681,9682,21-10-2020 15:22:13.942111,Pizza · Italiana,Piatto - Pizza,13600,6600,20200
9682,9683,21-10-2020 15:22:14.173974,Desayunos,Sr Buñuelo,24300,6400,30700
9683,9684,21-10-2020 15:22:14.456086,Parrilla,Coquitas,53400,5600,59000
9684,9685,21-10-2020 15:22:14.688222,Parrilla · Café,Gaira Café,17800,4400,22200
9685,9686,21-10-2020 15:22:14.870173,Desayunos · Café,Norma's Ice Cream Café,24200,6300,30500
9686,9687,21-10-2020 15:22:15.001921,Desayunos,Butter,7500,6700,14200
9687,9688,21-10-2020 15:22:15.284128,Postres · Desayunos,KOKOA & co.,24200,4700,28900
9688,9689,21-10-2020 15:22:15.566300,Desayunos · Típica,D´Porco,53400,3900,57300
9689,9690,21-10-2020 15:22:15.698093,Desayunos,Sr Buñuelo,39700,6400,46100
9690,9691,21-10-2020 15:22:16.080817,Hamburguesas · Saludable,Restaurant Inn,48750,6100,54850
9691,9692,21-10-2020 15:22:16.362809,Pizza · Parrilla,Urban Lunch,12500,4000,16500
9692,9693,21-10-2020 15:22:16.645052,Desayunos · Café,El Gualilo,11870,6200,18070
9693,9694,21-10-2020 15:22:16.927280,Postres · Saludable,Ana Rebana,17800,6300,24100
9694,9695,21-10-2020 15:22:17.159577,Desayunos,Fratelli - Desayunos,37900,4600,42500
9695,9696,21-10-2020 15:22:17.341549,Sushi,Umi,35000,5600,40600
9696,9697,21-10-2020 15:22:17.623456,Comida Rápida,Fiesta Digital Andrés,34500,3100,37600
9697,9698,21-10-2020 15:22:17.906170,Mexicana,La leyenda mexican kitchen,23000,3200,26200
9698,9699,21-10-2020 15:22:18.138407,Desayunos,Bagel Shop,15600,3200,18800
9699,9700,21-10-2020 15:22:18.420763,Típica · Parrilla,Typykos,29500,6000,35500
9700,9701,21-10-2020 15:22:18.552740,Saludable,Ventura Soup y Salad,18900,3800,22700
9701,9702,21-10-2020 15:22:18.934998,Postres · Café,Loló Coffee & Snacks,34500,4600,39100
9702,9703,21-10-2020 15:22:19.167311,Desayunos · Italiana,Rceta By Rausch,35000,3600,38600
9703,9704,21-10-2020 15:22:19.399480,Postres · Panadería,RIGHT AWAY FOODS,23000,6600,29600
9704,9705,21-10-2020 15:22:19.631865,Jugos y Batidos,Pomponio,13600,3600,17200
9705,9706,21-10-2020 15:22:19.913890,Parrilla,Antojo a Domicilio,65000,5000,70000
9706,9707,21-10-2020 15:22:20.246174,Saludable · Desayunos,La Cesta,70000,4700,74700
9707,9708,21-10-2020 15:22:20.428348,Parrilla,El Tambor,15600,6800,22400
9708,9709,21-10-2020 15:22:20.710386,Parrilla,Antojo a Domicilio,17800,5000,22800
9709,9710,21-10-2020 15:22:20.942739,Típica,El Mondongo y Mucho Mas,70000,5600,75600
9710,9711,21-10-2020 15:22:21.074657,Típica,Bandejas Mrg,37900,3800,41700
9711,9712,21-10-2020 15:22:21.357590,Internacional,La Esquina con Sabor Parrilla,12500,3000,15500
9712,9713,21-10-2020 15:22:21.639819,Desayunos,Cafetería el Kippe,9000,3200,12200
9713,9714,21-10-2020 15:22:21.821905,Asiática,Thai Station,13000,6000,19000
9714,9715,21-10-2020 15:22:22.154282,Hamburguesas · Desayunos,El Inglés Gastro Pub,45800,6600,52400
9715,9716,21-10-2020 15:22:22.536556,Mexicana,Cantina La 15,53900,4300,58200
9716,9717,21-10-2020 15:22:22.668358,Hamburguesas · Panadería,NYC Burgers,15600,6200,21800
9717,9718,21-10-2020 15:22:23.000516,Típica,Sabores De Mi Tierra,35000,5400,40400
9718,9719,21-10-2020 15:22:23.182856,Hamburguesas · Panadería,NYC Burgers,24200,6200,30400
9719,9720,21-10-2020 15:22:23.465681,Parrilla,Antojo a Domicilio,35000,5000,40000
9720,9721,21-10-2020 15:22:23.748117,Postres · Panadería,RIGHT AWAY FOODS,35000,6600,41600
9721,9722,21-10-2020 15:22:24.130714,Pescados y Mariscos,Fish Place - Del Mar,34500,5400,39900
9722,9723,21-10-2020 15:22:24.262965,Postres · Panadería,RIGHT AWAY FOODS,35000,6600,41600
9723,9724,21-10-2020 15:22:24.395403,Desayunos · Empanadas,Mis Delicias,48750,3200,51950
9724,9725,21-10-2020 15:22:24.627656,Desayunos,Archies Desayunos,27800,3100,30900
9725,9726,21-10-2020 15:22:25.010203,Típica,La Cocina,18900,4600,23500
9726,9727,21-10-2020 15:22:25.292340,Parrilla,Antojo a Domicilio,53400,5000,58400
9727,9728,21-10-2020 15:22:25.474500,Jugos y Batidos,Pomponio,35000,3600,38600
9728,9729,21-10-2020 15:22:25.856805,Típica,Sabores De Mi Tierra,18900,5400,24300
9729,9730,21-10-2020 15:22:25.988890,Alta Cocina · Postres,La Pinta,53400,4500,57900
9730,9731,21-10-2020 15:22:26.373968,Postres · Desayunos,Buñuelos nacho,45800,6600,52400
9731,9732,21-10-2020 15:22:26.556287,Saludable · Típica,Sopas Mrg,53400,3100,56500
9732,9733,21-10-2020 15:22:26.938515,Pollo · Desayunos,Piaf,12500,6500,19000
9733,9734,21-10-2020 15:22:27.070532,Desayunos · Comida Rápida,La Veneca,23000,6300,29300
9734,9735,21-10-2020 15:22:27.402627,Desayunos,Bagel Shop,11870,3200,15070
9735,9736,21-10-2020 15:22:27.585592,Típica · Parrilla,La Parilla de David,53400,3100,56500
9736,9737,21-10-2020 15:22:27.768028,Saludable · Jugos y Batidos,Berdes Drinks & Salads,13600,3500,17100
9737,9738,21-10-2020 15:22:27.950176,Desayunos · Mexicana,La Mera Mera - Mexicana,17800,3100,20900
9738,9739,21-10-2020 15:22:28.232505,Desayunos · Panadería,Premium Break Bakery,53900,3700,57600
9739,9740,21-10-2020 15:22:28.464987,Café · Helados,Sofia heladería y café,7500,5800,13300
9740,9741,21-10-2020 15:22:28.648912,Pizza · Italiana,Pisapore - Pizza,17800,6600,24400
9741,9742,21-10-2020 15:22:28.931492,Saludable · Desayunos,Maracuyá,9000,6700,15700
9742,9743,21-10-2020 15:22:29.114041,Desayunos · Típica,Parrilla Farandula Típico,8900,5900,14800
9743,9744,21-10-2020 15:22:29.446641,Desayunos,Desayunos en Bogotá,7500,3400,10900
9744,9745,21-10-2020 15:22:29.829053,Desayunos · Panadería,Choclofee,9000,4700,13700
9745,9746,21-10-2020 15:22:30.061575,Pollo,Señor Fantástico,27800,4700,32500
9746,9747,21-10-2020 15:22:30.294066,Mexicana,Mexicanachos,35000,3900,38900
9747,9748,21-10-2020 15:22:30.526449,Desayunos · Típica,Calentao Express,8900,6000,14900
9748,9749,21-10-2020 15:22:30.658674,Típica,La Herencia,37900,5900,43800
9749,9750,21-10-2020 15:22:30.941016,Postres · Desayunos,Vivalight Market.,53400,6500,59900
9750,9751,21-10-2020 15:22:31.174904,Típica,Lo Nuestro,45800,3100,48900
9751,9752,21-10-2020 15:22:31.357676,Hamburguesas,Burger Society,53900,4100,58000
9752,9753,21-10-2020 15:22:31.741539,Desayunos · Café,vereda central calle 99,53400,5700,59100
9753,9754,21-10-2020 15:22:31.873624,Desayunos · Panadería,Juliana Restaurante,48750,6100,54850
9754,9755,21-10-2020 15:22:32.055689,Típica · Parrilla,Typykos,11870,6000,17870
9755,9756,21-10-2020 15:22:32.388220,Parrilla,Antojo a Domicilio,11870,5000,16870
9756,9757,21-10-2020 15:22:32.520871,Sushi,Sushi Reel,18900,4700,23600
9757,9758,21-10-2020 15:22:32.652914,Desayunos · Panadería,Limarys,39700,6500,46200
9758,9759,21-10-2020 15:22:32.884647,Típica,Carbón & Mondongos,29500,6400,35900
9759,9760,21-10-2020 15:22:33.267492,Desayunos · Típica,Fogón Sangileño,31800,5000,36800
9760,9761,21-10-2020 15:22:33.551420,Hamburguesas,Gofi Burger,18900,5100,24000
9761,9762,21-10-2020 15:22:33.683863,Desayunos · Café,vereda central calle 99,35000,5700,40700
9762,9763,21-10-2020 15:22:34.066710,Helados,Orso To Go,15600,6800,22400
9763,9764,21-10-2020 15:22:34.349070,Desayunos · Panadería,Le Pain Quotidien,65000,3900,68900
9764,9765,21-10-2020 15:22:34.581995,Sushi · Desayunos,Maki Roll,15000,4300,19300
9765,9766,21-10-2020 15:22:34.965537,Parrilla · Internacional,Taperia de la Plaza,53400,5700,59100
9766,9767,21-10-2020 15:22:35.098223,Parrilla,Restaurante Bar Mi Ranchito,48750,5200,53950
9767,9768,21-10-2020 15:22:35.381293,Helados,Buon Gelato,34500,4400,38900
9768,9769,21-10-2020 15:22:35.614106,Desayunos,El Corral - Desayunos,39700,5000,44700
9769,9770,21-10-2020 15:22:35.847008,Desayunos · Panadería,Premium Break Bakery,8900,3700,12600
9770,9771,21-10-2020 15:22:36.079039,Típica · Parrilla,La Parilla de David,8900,3100,12000
9771,9772,21-10-2020 15:22:36.211767,Postres,Toledo Pastelería,13600,6800,20400
9772,9773,21-10-2020 15:22:36.544057,Postres · Desayunos,Maltihelados,13000,6200,19200
9773,9774,21-10-2020 15:22:36.827252,Hamburguesas · Saludable,Restaurant Inn,31800,6100,37900
9774,9775,21-10-2020 15:22:37.009224,Postres · Desayunos,Buñuelos nacho,12500,6600,19100
9775,9776,21-10-2020 15:22:37.391755,Italiana,F*cking Good Pizza,23000,4200,27200
9776,9777,21-10-2020 15:22:37.774138,Alta Cocina · Italiana,Trattoria de la Plaza,24200,6000,30200
9777,9778,21-10-2020 15:22:38.006195,Típica · Pescados y Mariscos,Arroces Mrg,39700,4300,44000
9778,9779,21-10-2020 15:22:38.388611,Saludable · Desayunos,Distrito Gourmet,13000,3700,16700
9779,9780,21-10-2020 15:22:38.570927,Pollo,Chicken House,9000,4200,13200
9780,9781,21-10-2020 15:22:38.903638,Pollo · Desayunos,Abasto,39700,3600,43300
9781,9782,21-10-2020 15:22:39.085781,Típica,Sopitas y Más,18900,4200,23100
9782,9783,21-10-2020 15:22:39.368019,Sánduches,Submarin,7500,3800,11300
9783,9784,21-10-2020 15:22:39.700499,Típica · Parrilla,Mi Ranchito Parrilla,11870,4400,16270
9784,9785,21-10-2020 15:22:40.032612,Saludable · Desayunos,La Estampilla,13000,6000,19000
9785,9786,21-10-2020 15:22:40.314969,Peruana,Uma Cantina Peruana,65000,3200,68200
9786,9787,21-10-2020 15:22:40.447289,Saludable · Desayunos,Fresh Co,10700,5600,16300
9787,9788,21-10-2020 15:22:40.579532,Postres · Helados,Mahé,8900,6000,14900
9788,9789,21-10-2020 15:22:40.812034,Jugos y Batidos,Pomponio,31800,3600,35400
9789,9790,21-10-2020 15:22:41.144540,China,China Food Col,23000,3600,26600
9790,9791,21-10-2020 15:22:41.426826,Desayunos · Típica,Fogón Sangileño,48750,5000,53750
9791,9792,21-10-2020 15:22:41.809186,Postres · Café,Celestino Café,70000,5900,75900
9792,9793,21-10-2020 15:22:41.992374,Sushi,Kim Pop,23000,5400,28400
9793,9794,21-10-2020 15:22:42.124548,Hamburguesas,Monchis - Hamburguesa,15600,4300,19900
9794,9795,21-10-2020 15:22:42.407241,Sushi,Sushi Reel,37900,4700,42600
9795,9796,21-10-2020 15:22:42.639742,Desayunos · Café,El Gualilo,31800,6200,38000
9796,9797,21-10-2020 15:22:42.822307,Típica · Parrilla,Mi Ranchito Parrilla,18900,4400,23300
9797,9798,21-10-2020 15:22:43.104746,Pizza · Italiana,Piatto - Pizza,13600,6600,20200
9798,9799,21-10-2020 15:22:43.237084,Saludable,MIMA,9000,3700,12700
9799,9800,21-10-2020 15:22:43.569569,China,China Food Col,11870,3600,15470
9800,9801,21-10-2020 15:22:43.952080,Desayunos,Archies Desayunos,8900,3100,12000
9801,9802,21-10-2020 15:22:44.134727,Desayunos,Desayunos en Bogotá,10700,3400,14100
9802,9803,21-10-2020 15:22:44.267099,Desayunos · Panadería,El Pan de Phillippe,12500,4600,17100
9803,9804,21-10-2020 15:22:44.549463,Postres · Desayunos,Sharmus,11870,6100,17970
9804,9805,21-10-2020 15:22:44.681821,Postres · Desayunos,Café Quindio,53900,5700,59600
9805,9806,21-10-2020 15:22:45.014190,Desayunos,Fratelli - Desayunos,11870,4600,16470
9806,9807,21-10-2020 15:22:45.247312,Saludable · Parrilla,Box,24300,3700,28000
9807,9808,21-10-2020 15:22:45.580297,Parrilla,Antojo a Domicilio,39700,5000,44700
9808,9809,21-10-2020 15:22:45.963071,Hamburguesas · Pescados y Mariscos,El Velero,48750,6500,55250
9809,9810,21-10-2020 15:22:46.195559,Saludable · Desayunos,Básico y Elemental,53400,5900,59300
9810,9811,21-10-2020 15:22:46.528476,Típica,Sopitas y Más,70000,4200,74200
9811,9812,21-10-2020 15:22:46.761239,Hamburguesas · Alitas,Beer,39700,6600,46300
9812,9813,21-10-2020 15:22:46.894024,Pizza,Pastas Laurentina,15000,4800,19800
9813,9814,21-10-2020 15:22:47.126730,Desayunos · Típica,Papadió - Colombianas,15000,5700,20700
9814,9815,21-10-2020 15:22:47.410471,Típica,El Mondongo y Mucho Mas,7500,5600,13100
9815,9816,21-10-2020 15:22:47.643368,Saludable · Desayunos,Malú,34500,3700,38200
9816,9817,21-10-2020 15:22:48.026132,Helados,Orso To Go,48750,6800,55550
9817,9818,21-10-2020 15:22:48.208459,Desayunos · Típica,Criollomania,35000,5200,40200
9818,9819,21-10-2020 15:22:48.390882,Desayunos · Panadería,Pasteleite,24300,5900,30200
9819,9820,21-10-2020 15:22:48.773745,Postres,Beiked,13600,4000,17600
9820,9821,21-10-2020 15:22:48.956063,Postres · Café,Celestino Café,34500,5900,40400
9821,9822,21-10-2020 15:22:49.088110,Postres · Desayunos,Cosmo Cookies,13000,5900,18900
9822,9823,21-10-2020 15:22:49.320445,Postres,Beiked,10700,4000,14700
9823,9824,21-10-2020 15:22:49.553775,Postres · Desayunos,Protein Bakes,53900,5900,59800
9824,9825,21-10-2020 15:22:49.786247,Saludable · Desayunos,La Estampilla,7500,6000,13500
9825,9826,21-10-2020 15:22:50.118872,Pollo · Desayunos,Caserito Gourmet,34500,6700,41200
9826,9827,21-10-2020 15:22:50.451486,Postres · Desayunos,Gelateria Da Favola,48750,6500,55250
9827,9828,21-10-2020 15:22:50.784161,Postres · Desayunos,Cosmo Cookies,53400,5900,59300
9828,9829,21-10-2020 15:22:50.966456,Saludable,The Good Rice Bowls,11870,3500,15370
9829,9830,21-10-2020 15:22:51.198819,Típica · Pescados y Mariscos,Arroces Mrg,45800,4300,50100
9830,9831,21-10-2020 15:22:51.481062,Típica · Parrilla,El Portal de la Antigua,39700,5600,45300
9831,9832,21-10-2020 15:22:51.713702,Pollo · Desayunos,Abasto,13600,3600,17200
9832,9833,21-10-2020 15:22:52.046314,Postres · Desayunos,KOKOA & co.,8900,4700,13600
9833,9834,21-10-2020 15:22:52.190882,Desayunos,La Frijolada Desayunos,29500,4400,33900
9834,9835,21-10-2020 15:22:52.523432,Saludable · Desayunos,Copacabana Açai Bowls,39700,3000,42700
9835,9836,21-10-2020 15:22:52.905882,Desayunos · Típica,Fogón Sangileño,15600,5000,20600
9836,9837,21-10-2020 15:22:53.188166,Parrilla,Carnes la Zarza,31800,4900,36700
9837,9838,21-10-2020 15:22:53.420640,Típica,Bendita S,34500,4600,39100
9838,9839,21-10-2020 15:22:53.753117,Típica,Cabrito Santandereano,70000,6600,76600
9839,9840,21-10-2020 15:22:53.935399,Típica,Sabrosito,24300,4000,28300
9840,9841,21-10-2020 15:22:54.218143,Postres · Desayunos,Restaurante Cornelia,23000,5500,28500
9841,9842,21-10-2020 15:22:54.350416,China,China Food Col,53900,3600,57500
9842,9843,21-10-2020 15:22:54.584707,Helados,Buon Gelato,35000,4400,39400
9843,9844,21-10-2020 15:22:54.717419,Pescados y Mariscos,Fish Place - Del Mar,37900,5400,43300
9844,9845,21-10-2020 15:22:55.100197,Típica · Parrilla,Parrilla Farandula Gourmet,31800,5100,36900
9845,9846,21-10-2020 15:22:55.433554,Comida Rápida · Perros Calientes,Similoa - Comida Rapida,23000,3700,26700
9846,9847,21-10-2020 15:22:55.665945,Saludable,Amor Propio saludable,13000,4000,17000
9847,9848,21-10-2020 15:22:56.048480,Postres · Desayunos,Protein Bakes,24300,5900,30200
9848,9849,21-10-2020 15:22:56.180845,Desayunos,Don Leo,12500,6000,18500
9849,9850,21-10-2020 15:22:56.513261,Desayunos,Señor Desayuno,15000,6800,21800
9850,9851,21-10-2020 15:22:56.896008,Sánduches · China,Peru Mix,15000,5900,20900
9851,9852,21-10-2020 15:22:57.178477,Pollo · Saludable,Gratina,39700,4200,43900
9852,9853,21-10-2020 15:22:57.310803,Desayunos · Típica,Criollomania,24300,5200,29500
9853,9854,21-10-2020 15:22:57.443075,Postres · Desayunos,Maria Luisa - Postres,18900,4300,23200
9854,9855,21-10-2020 15:22:57.825874,Típica · Parrilla,Typykos,45800,6000,51800
9855,9856,21-10-2020 15:22:58.208922,Saludable · Desayunos,Básico y elemental,35000,5000,40000
9856,9857,21-10-2020 15:22:58.541587,Hamburguesas,Bendito Cordero,29500,5800,35300
9857,9858,21-10-2020 15:22:58.673589,Internacional,La Esquina con Sabor Parrilla,9000,3000,12000
9858,9859,21-10-2020 15:22:59.005725,Pollo,Chicken House,17800,4200,22000
9859,9860,21-10-2020 15:22:59.188237,Desayunos · Panadería,Pasteleite,37900,5900,43800
9860,9861,21-10-2020 15:22:59.520822,Saludable · Desayunos,Básico y Elemental,65000,5900,70900
9861,9862,21-10-2020 15:22:59.754446,Parrilla · Café,Gaira Café,34500,4400,38900
9862,9863,21-10-2020 15:23:00.036710,Helados,Orso To Go,7500,6800,14300
9863,9864,21-10-2020 15:23:00.269493,Postres · Desayunos,Gelateria Da Favola,35000,6500,41500
9864,9865,21-10-2020 15:23:00.502013,Café · Helados,Sofia heladería y café,24200,5800,30000
9865,9866,21-10-2020 15:23:00.634477,Típica,El Cucharón - Tipica,35000,4400,39400
9866,9867,21-10-2020 15:23:00.816854,Típica,Juan Chorizo,23000,3900,26900
9867,9868,21-10-2020 15:23:01.099440,Desayunos · Helados,San Giorgio Gelateria,35000,3100,38100
9868,9869,21-10-2020 15:23:01.331824,Comida Rápida · Perros Calientes,Similoa - Comida Rapida,70000,3700,73700
9869,9870,21-10-2020 15:23:01.514146,Postres · Desayunos,Buñuelos nacho,13600,6600,20200
9870,9871,21-10-2020 15:23:01.646434,Desayunos,Fratelli - Desayunos,8900,4600,13500
9871,9872,21-10-2020 15:23:01.828834,Saludable · Desayunos,Bon Eat - Saludable,9000,4800,13800
9872,9873,21-10-2020 15:23:02.112240,Típica,Bandejas Mrg,31800,3800,35600
9873,9874,21-10-2020 15:23:02.495144,Desayunos · Pescados y Mariscos,Luzí­a - Mediterranea,35000,5700,40700
9874,9875,21-10-2020 15:23:02.677798,Postres · Desayunos,Maltihelados,15000,6200,21200
9875,9876,21-10-2020 15:23:03.060816,Típica · Parrilla,La Ternera Parrilla,15000,5200,20200
9876,9877,21-10-2020 15:23:03.293783,Desayunos · Helados,San Giorgio Gelateria,15000,3100,18100
9877,9878,21-10-2020 15:23:03.476601,Desayunos · Mexicana,La Mera Mera - Mexicana,70000,3100,73100
9878,9879,21-10-2020 15:23:03.859878,Saludable · Desayunos,Guadalupe - Fruteria,13000,5900,18900
9879,9880,21-10-2020 15:23:04.192721,Perros Calientes,Dog Shop - Rapida,13600,4900,18500
9880,9881,21-10-2020 15:23:04.425673,Desayunos · Panadería,Premium Break Bakery,17800,3700,21500
9881,9882,21-10-2020 15:23:04.708501,Postres,Toledo Pastelería,29500,6800,36300
9882,9883,21-10-2020 15:23:04.942707,Postres · Desayunos,Vivalight Market.,65000,6500,71500
9883,9884,21-10-2020 15:23:05.225964,Desayunos · Sánduches,Frutos del Bosque,7500,3500,11000
9884,9885,21-10-2020 15:23:05.558832,Típica,Bandejas Mrg,23000,3800,26800
9885,9886,21-10-2020 15:23:05.842024,Mexicana,Cantina La 15,24200,4300,28500
9886,9887,21-10-2020 15:23:06.024560,Desayunos · Típica,Papadió - Colombianas,13600,5700,19300
9887,9888,21-10-2020 15:23:06.157379,Desayunos · Café,Libertario Coffee Roasters,24300,4600,28900
9888,9889,21-10-2020 15:23:06.390336,Internacional,La Esquina con Sabor Parrilla,15600,3000,18600
9889,9890,21-10-2020 15:23:06.724052,Hamburguesas · Desayunos,El Inglés Gastro Pub,65000,6600,71600
9890,9891,21-10-2020 15:23:07.057063,Postres · Desayunos,Amelie Helados,65000,6400,71400
9891,9892,21-10-2020 15:23:07.240450,Pollo,Señor Fantástico,65000,4700,69700
9892,9893,21-10-2020 15:23:07.623806,Desayunos · Típica,La Parrilla Dorada Polo,65000,6600,71600
9893,9894,21-10-2020 15:23:07.756618,Saludable,Amor Propio saludable,9000,4000,13000
9894,9895,21-10-2020 15:23:08.089776,Saludable · Desayunos,Libre de Culpa,10700,4000,14700
9895,9896,21-10-2020 15:23:08.222998,Hamburguesas · Desayunos,El Inglés Gastro Pub,13600,6600,20200
9896,9897,21-10-2020 15:23:08.606375,Pollo,Chicken House,15000,4200,19200
9897,9898,21-10-2020 15:23:08.939976,Desayunos · Café,Frambas,24200,3400,27600
9898,9899,21-10-2020 15:23:09.123024,Pollo,Señor Fantástico,23000,4700,27700
9899,9900,21-10-2020 15:23:09.406212,Saludable · Jugos y Batidos,Berdes Drinks & Salads,24300,3500,27800
9900,9901,21-10-2020 15:23:09.589035,Postres · Desayunos,KOKOA & co.,45800,4700,50500
9901,9902,21-10-2020 15:23:09.872241,Sánduches · China,Peru Mix,15000,5900,20900
9902,9903,21-10-2020 15:23:10.056710,Típica · Parrilla,El Santandereano,8900,5200,14100
9903,9904,21-10-2020 15:23:10.339519,Desayunos · Jugos y Batidos,Dont Be Hungry,7500,5600,13100
9904,9905,21-10-2020 15:23:10.522420,Típica,Sopitas y Más,13000,4200,17200
9905,9906,21-10-2020 15:23:10.855353,Típica,Cabrito Santandereano,12500,6600,19100
9906,9907,21-10-2020 15:23:11.038446,Peruana · Internacional,La Chifería,12500,6600,19100
9907,9908,21-10-2020 15:23:11.371356,Jugos y Batidos,Pomponio,31800,3600,35400
9908,9909,21-10-2020 15:23:11.504173,Sushi · Asiática,Arigato,29500,5300,34800
9909,9910,21-10-2020 15:23:11.787475,Típica,La Olla de Barro,11870,5300,17170
9910,9911,21-10-2020 15:23:12.020814,Desayunos,El Corral - Desayunos,29500,5000,34500
9911,9912,21-10-2020 15:23:12.404040,Desayunos · Parrilla,Mi Patria,23000,4600,27600
9912,9913,21-10-2020 15:23:12.786957,Postres,La Galeta,31800,3000,34800
9913,9914,21-10-2020 15:23:12.969508,Postres · Desayunos,BagBog Bagels,11870,6400,18270
9914,9915,21-10-2020 15:23:13.252096,Desayunos · Típica,Parrilla Farandula Típico,13000,5900,18900
9915,9916,21-10-2020 15:23:13.384908,Pollo · Desayunos,Piaf,39700,6500,46200
9916,9917,21-10-2020 15:23:13.617985,Pollo · Saludable,Tremenda Sal y Dulce,35000,6500,41500
9917,9918,21-10-2020 15:23:13.901020,Postres · Saludable,Ana Rebana,11870,6300,18170
9918,9919,21-10-2020 15:23:14.134259,Desayunos · Pescados y Mariscos,Gypsy Bistro,24300,4500,28800
9919,9920,21-10-2020 15:23:14.517819,Alta Cocina · Postres,La Pinta,17800,4500,22300
9920,9921,21-10-2020 15:23:14.800731,Parrilla,Beraca Parrilla Bbq,29500,5600,35100
9921,9922,21-10-2020 15:23:14.933364,Sánduches · China,Peru Mix,48750,5900,54650
9922,9923,21-10-2020 15:23:15.317308,Pollo · China,China Tao,39700,3500,43200
9923,9924,21-10-2020 15:23:15.499835,Peruana · Internacional,La Chifería,7500,6600,14100
9924,9925,21-10-2020 15:23:15.732533,Desayunos · Café,vereda central calle 99,65000,5700,70700
9925,9926,21-10-2020 15:23:15.915083,Postres · Desayunos,BagBog Bagels,12500,6400,18900
9926,9927,21-10-2020 15:23:16.047593,Típica,Bendita S,24300,4600,28900
9927,9928,21-10-2020 15:23:16.180406,Mexicana,Cantina La 15,23000,4300,27300
9928,9929,21-10-2020 15:23:16.363233,Postres · Desayunos,BagBog Bagels,12500,6400,18900
9929,9930,21-10-2020 15:23:16.746311,Desayunos,El Corral - Desayunos,17800,5000,22800
9930,9931,21-10-2020 15:23:17.129261,Saludable · Típica,Sopas Mrg,17800,3100,20900
9931,9932,21-10-2020 15:23:17.361856,Desayunos,El Fogón Castellano,23000,3200,26200
9932,9933,21-10-2020 15:23:17.494235,Desayunos · Panadería,Juliana Restaurante,15000,6100,21100
9933,9934,21-10-2020 15:23:17.876800,Parrilla,Carnes la Zarza,12500,4900,17400
9934,9935,21-10-2020 15:23:18.009358,Sánduches · Pescados y Mariscos,Pacific Comida de Mar,18900,4000,22900
9935,9936,21-10-2020 15:23:18.342182,Postres · Saludable,Ana Rebana,24300,6300,30600
9936,9937,21-10-2020 15:23:18.674900,Típica · Parrilla,Typykos,45800,6000,51800
9937,9938,21-10-2020 15:23:18.957741,Desayunos,Butter,24300,6700,31000
9938,9939,21-10-2020 15:23:19.090336,Peruana,Uma Cantina Peruana,10700,3200,13900
9939,9940,21-10-2020 15:23:19.423381,Internacional,Rio Sabores y Experiencias,24200,4100,28300
9940,9941,21-10-2020 15:23:19.606671,Asiática,TeT,53400,5900,59300
9941,9942,21-10-2020 15:23:19.789526,Internacional,La Esquina con Sabor Parrilla,39700,3000,42700
9942,9943,21-10-2020 15:23:19.972273,Saludable · Desayunos,Maracuyá,11870,6700,18570
9943,9944,21-10-2020 15:23:20.255176,Típica,Sabores De Mi Tierra,70000,5400,75400
9944,9945,21-10-2020 15:23:20.539026,Mexicana,Cantina La 15,7500,4300,11800
9945,9946,21-10-2020 15:23:20.771668,Desayunos · Típica,D´Porco,24200,3900,28100
9946,9947,21-10-2020 15:23:21.154564,Típica · Parrilla,Toya,29500,4200,33700
9947,9948,21-10-2020 15:23:21.337028,Postres · Desayunos,Maltihelados,8900,6200,15100
9948,9949,21-10-2020 15:23:21.720367,Postres · Desayunos,KOKOA & co.,35000,4700,39700
9949,9950,21-10-2020 15:23:21.903292,Parrilla,OAK Ahumado y Brebajes,15600,6000,21600
9950,9951,21-10-2020 15:23:22.136212,Típica · Parrilla,El Portal de la Antigua,7500,5600,13100
9951,9952,21-10-2020 15:23:22.519177,Típica,El Mondongo y Mucho Mas,53400,5600,59000
9952,9953,21-10-2020 15:23:22.751943,Desayunos · Típica,Criollomania,9000,5200,14200
9953,9954,21-10-2020 15:23:22.984641,Desayunos,Butter,7500,6700,14200
9954,9955,21-10-2020 15:23:23.117434,Desayunos · Café,Moramia,23000,4700,27700
9955,9956,21-10-2020 15:23:23.349911,Alta Cocina · Parrilla,Criterión,35000,6000,41000
9956,9957,21-10-2020 15:23:23.582425,Típica,El Mondongo y Mucho Mas,53400,5600,59000
9957,9958,21-10-2020 15:23:23.965437,Desayunos · Panadería,Ficchi Panadería,13600,3100,16700
9958,9959,21-10-2020 15:23:24.197986,Pollo · Sánduches,Pollos Century,17800,3000,20800
9959,9960,21-10-2020 15:23:24.430479,Pizza,Pizza Andante,70000,6300,76300
9960,9961,21-10-2020 15:23:24.563106,Saludable · Desayunos,Re.al Alimentos Reales,10700,4000,14700
9961,9962,21-10-2020 15:23:24.695798,Típica,Cazuelitas 93,15600,3900,19500
9962,9963,21-10-2020 15:23:24.878248,Hamburguesas · Pescados y Mariscos,El Velero,15600,6500,22100
9963,9964,21-10-2020 15:23:25.111298,Saludable · Jugos y Batidos,Berdes Drinks & Salads,24300,3500,27800
9964,9965,21-10-2020 15:23:25.494118,Pollo · Desayunos,Piaf,17800,6500,24300
9965,9966,21-10-2020 15:23:25.728306,Desayunos · Típica,D´Porco,34500,3900,38400
9966,9967,21-10-2020 15:23:26.061441,Postres · Desayunos,Sharmus,53400,6100,59500
9967,9968,21-10-2020 15:23:26.395013,Desayunos · Café,Frambas,53900,3400,57300
9968,9969,21-10-2020 15:23:26.727985,Postres · Desayunos,Maltihelados,53400,6200,59600
9969,9970,21-10-2020 15:23:27.010897,Hamburguesas · Panadería,NYC Burgers,39700,6200,45900
9970,9971,21-10-2020 15:23:27.293570,Típica,Bendita S,27800,4600,32400
9971,9972,21-10-2020 15:23:27.476190,Pollo · Saludable,Tremenda Sal y Dulce,27800,6500,34300
9972,9973,21-10-2020 15:23:27.759235,Desayunos · Típica,Desayunadero de la 42,53400,5900,59300
9973,9974,21-10-2020 15:23:27.992241,Postres · Desayunos,Amelie Helados,24200,6400,30600
9974,9975,21-10-2020 15:23:28.375238,Postres · Desayunos,BagBog Bagels,70000,6400,76400
9975,9976,21-10-2020 15:23:28.508220,Alta Cocina · Postres,La Pinta,24200,4500,28700
9976,9977,21-10-2020 15:23:28.641295,Hamburguesas · Pescados y Mariscos,El Velero,35000,6500,41500
9977,9978,21-10-2020 15:23:29.024079,Saludable,MIMA,31800,3700,35500
9978,9979,21-10-2020 15:23:29.306958,Pescados y Mariscos,Pescadero Héroes del Mar,35000,6600,41600
9979,9980,21-10-2020 15:23:29.589762,Desayunos · Típica,Papadió - Colombianas,17800,5700,23500
9980,9981,21-10-2020 15:23:29.772601,Sushi,Sushi Reel,39700,4700,44400
9981,9982,21-10-2020 15:23:30.105857,Alta Cocina · Postres,La Pinta,18900,4500,23400
9982,9983,21-10-2020 15:23:30.288586,Saludable · Típica,Saludable Mrg,70000,5800,75800
9983,9984,21-10-2020 15:23:30.521248,Saludable · Desayunos,Bon Eat - Saludable,15000,4800,19800
9984,9985,21-10-2020 15:23:30.855192,Típica,La Cocina,34500,4600,39100
9985,9986,21-10-2020 15:23:31.138083,Saludable,MIMA,15000,3700,18700
9986,9987,21-10-2020 15:23:31.320653,Saludable · Jugos y Batidos,Berdes Drinks & Salads,35000,3500,38500
9987,9988,21-10-2020 15:23:31.653548,Parrilla · Internacional,Taperia de la Plaza,53900,5700,59600
9988,9989,21-10-2020 15:23:31.936254,Parrilla,Coquitas,29500,5600,35100
9989,9990,21-10-2020 15:23:32.219122,Típica,Carbón & Mondongos,12500,6400,18900
9990,9991,21-10-2020 15:23:32.502172,Postres · Café,Celestino Café,31800,5900,37700
9991,9992,21-10-2020 15:23:32.885200,Típica,La Herencia,53900,5900,59800
9992,9993,21-10-2020 15:23:33.218140,Desayunos,Sunny Breakfast Brunch,23000,4300,27300
9993,9994,21-10-2020 15:23:33.551121,Postres · Panadería,RIGHT AWAY FOODS,39700,6600,46300
9994,9995,21-10-2020 15:23:33.934039,Helados,Buon Gelato,31800,4400,36200
9995,9996,21-10-2020 15:23:34.317059,Saludable,Puro Verde,9000,5700,14700
9996,9997,21-10-2020 15:23:34.499838,Pollo · Desayunos,Caserito Gourmet,45800,6700,52500
9997,9998,21-10-2020 15:23:34.632723,Sánduches · Pescados y Mariscos,Pacific Comida de Mar,23000,4000,27000
9998,9999,21-10-2020 15:23:34.865423,Asiática,TeT,23000,5900,28900
9999,10000,21-10-2020 15:23:35.248491,Postres · Desayunos,Sweet Tale,53900,5800,59700
10000,10001,21-10-2020 15:23:35.631888,Desayunos · Café,Aromacafé el Placer de Compartir,31800,5000,36800
10001,10002,21-10-2020 15:23:36.015687,Postres · Desayunos,Vivalight Market.,17800,6500,24300
10002,10003,21-10-2020 15:23:36.348719,Sushi · Desayunos,Maki Roll,10700,4300,15000
10003,10004,21-10-2020 15:23:36.531535,Sánduches · China,Peru Mix,7500,5900,13400
10004,10005,21-10-2020 15:23:36.814297,Desayunos · Típica,Alce,12500,4900,17400
10005,10006,21-10-2020 15:23:37.197379,Panadería,Boul,7500,3100,10600
10006,10007,21-10-2020 15:23:37.530427,Desayunos,Desayunos en Bogotá,23000,3400,26400
10007,10008,21-10-2020 15:23:37.663164,Sushi,Kim Pop,23000,5400,28400
10008,10009,21-10-2020 15:23:38.045862,Hamburguesas · Desayunos,El Inglés Gastro Pub,13000,6600,19600
10009,10010,21-10-2020 15:23:38.178878,Desayunos,El Corral - Desayunos,12500,5000,17500
10010,10011,21-10-2020 15:23:38.561877,Típica · Parrilla,La Parilla de David,7500,3100,10600
10011,10012,21-10-2020 15:23:38.844559,Alta Cocina · Parrilla,Criterión,39700,6000,45700
10012,10013,21-10-2020 15:23:39.127259,Desayunos · Helados,San Giorgio Gelateria,8900,3100,12000
10013,10014,21-10-2020 15:23:39.359909,Internacional,Rio Sabores y Experiencias,11870,4100,15970
10014,10015,21-10-2020 15:23:39.743208,Desayunos,La Frijolada Desayunos,45800,4400,50200
10015,10016,21-10-2020 15:23:39.926111,Desayunos,Señor Desayuno,13000,6800,19800
10016,10017,21-10-2020 15:23:40.108895,Saludable · Típica,Saludable Mrg,34500,5800,40300
10017,10018,21-10-2020 15:23:40.242054,Postres · Desayunos,Cosmo Cookies,70000,5900,75900
10018,10019,21-10-2020 15:23:40.574829,Saludable · Desayunos,Bon Eat - Saludable,7500,4800,12300
10019,10020,21-10-2020 15:23:40.857664,Sánduches · Pescados y Mariscos,Pacific Comida de Mar,24200,4000,28200
10020,10021,21-10-2020 15:23:41.041244,Desayunos · Típica,Peninsula Calentados y Parrilla,7500,3400,10900
10021,10022,21-10-2020 15:23:41.173955,Saludable · Parrilla,Box,45800,3700,49500
10022,10023,21-10-2020 15:23:41.356768,Pollo · Saludable,Yerbabuena,29500,3900,33400
10023,10024,21-10-2020 15:23:41.689901,Típica,Sabores De Mi Tierra,9000,5400,14400
10024,10025,21-10-2020 15:23:41.972576,Jugos y Batidos,Pomponio,39700,3600,43300
10025,10026,21-10-2020 15:23:42.355481,Mexicana,Mexicanachos,45800,3900,49700
10026,10027,21-10-2020 15:23:42.638600,Postres,La Galeta,35000,3000,38000
10027,10028,21-10-2020 15:23:43.021837,Postres · Desayunos,Restaurante Cornelia,13000,5500,18500
10028,10029,21-10-2020 15:23:43.254731,Típica,Bandejas Mrg,24200,3800,28000
10029,10030,21-10-2020 15:23:43.588119,Postres · Helados,Mahé,8900,6000,14900
10030,10031,21-10-2020 15:23:43.971383,Desayunos · Jugos y Batidos,Kuriwaji,8900,6300,15200
10031,10032,21-10-2020 15:23:44.254159,Típica,Bendita S,8900,4600,13500
10032,10033,21-10-2020 15:23:44.637248,Postres · Desayunos,Maria Luisa - Postres,15600,4300,19900
10033,10034,21-10-2020 15:23:44.770027,Típica · Parrilla,Toya,31800,4200,36000
10034,10035,21-10-2020 15:23:44.902409,Desayunos · Pescados y Mariscos,Luzí­a - Mediterranea,9000,5700,14700
10035,10036,21-10-2020 15:23:45.085075,Típica,El Cucharón - Tipica,35000,4400,39400
10036,10037,21-10-2020 15:23:45.317996,Desayunos · Comida Rápida,La Veneca,39700,6300,46000
10037,10038,21-10-2020 15:23:45.651265,Parrilla,Coquitas,70000,5600,75600
10038,10039,21-10-2020 15:23:45.933980,Italiana,F*cking Good Pizza,45800,4200,50000
10039,10040,21-10-2020 15:23:46.217916,Desayunos · Panadería,Pasteleite,9000,5900,14900
10040,10041,21-10-2020 15:23:46.550824,Típica · Parrilla,La Parilla de David,9000,3100,12100
10041,10042,21-10-2020 15:23:46.884126,Desayunos · Mexicana,La Mera Mera - Mexicana,15000,3100,18100
10042,10043,21-10-2020 15:23:47.017224,Típica · Parrilla,El Portal de la Antigua,39700,5600,45300
10043,10044,21-10-2020 15:23:47.350175,Pizza · Parrilla,Urban Lunch,53900,4000,57900
10044,10045,21-10-2020 15:23:47.733473,Pizza,Pizza Andante,18900,6300,25200
10045,10046,21-10-2020 15:23:47.966407,Típica · Pescados y Mariscos,La Vitualla,35000,6300,41300
10046,10047,21-10-2020 15:23:48.299379,Pizza · Parrilla,Urban Lunch,35000,4000,39000
10047,10048,21-10-2020 15:23:48.582266,Postres · Café,Celestino Café,65000,5900,70900
10048,10049,21-10-2020 15:23:48.715196,Desayunos,Sunny Breakfast Brunch,15600,4300,19900
10049,10050,21-10-2020 15:23:48.898107,Postres · Desayunos,Cosmo Cookies,53400,5900,59300
10050,10051,21-10-2020 15:23:49.281336,Alta Cocina · Italiana,Trattoria de la Plaza,8900,6000,14900
10051,10052,21-10-2020 15:23:49.614760,Típica,Sopitas y Más,27800,4200,32000
10052,10053,21-10-2020 15:23:49.998435,Saludable · Típica,Saludable Mrg,11870,5800,17670
10053,10054,21-10-2020 15:23:50.181531,Típica,Bandejas Mrg,31800,3800,35600
10054,10055,21-10-2020 15:23:50.314398,Postres · Desayunos,Maltihelados,45800,6200,52000
10055,10056,21-10-2020 15:23:50.647879,Pizza · Italiana,Pisapore - Pizza,13000,6600,19600
10056,10057,21-10-2020 15:23:50.830993,Desayunos · Pescados y Mariscos,Luzí­a - Mediterranea,8900,5700,14600
10057,10058,21-10-2020 15:23:51.114129,Postres · Helados,Mahé,15600,6000,21600
10058,10059,21-10-2020 15:23:51.398411,Pollo · Desayunos,Piaf,53900,6500,60400
10059,10060,21-10-2020 15:23:51.631806,Postres,La Galeta,24200,3000,27200
10060,10061,21-10-2020 15:23:52.015135,Postres · Desayunos,La Folie - Postres,37900,3300,41200
10061,10062,21-10-2020 15:23:52.399203,Italiana,Bocatto Di Passo,23000,5000,28000
10062,10063,21-10-2020 15:23:52.582496,Postres · Desayunos,Cosmo Cookies,29500,5900,35400
10063,10064,21-10-2020 15:23:52.865482,Postres · Desayunos,Protein Bakes,17800,5900,23700
10064,10065,21-10-2020 15:23:53.098446,Mexicana,Mexicanachos,31800,3900,35700
10065,10066,21-10-2020 15:23:53.432651,Italiana,Bocatto Di Passo,13000,5000,18000
10066,10067,21-10-2020 15:23:53.766137,Desayunos,Sr Buñuelo,29500,6400,35900
10067,10068,21-10-2020 15:23:53.899194,Saludable · Desayunos,Malú,65000,3700,68700
10068,10069,21-10-2020 15:23:54.182402,Desayunos,Butter,12500,6700,19200
10069,10070,21-10-2020 15:23:54.465785,Parrilla,Restaurante Bar Mi Ranchito,12500,5200,17700
10070,10071,21-10-2020 15:23:54.648719,Helados,Orso To Go,70000,6800,76800
10071,10072,21-10-2020 15:23:54.931905,Comida Rápida · Perros Calientes,Similoa - Comida Rapida,18900,3700,22600
10072,10073,21-10-2020 15:23:55.164925,Postres · Desayunos,Buñuelos nacho,17800,6600,24400
10073,10074,21-10-2020 15:23:55.498022,Desayunos · Jugos y Batidos,Kuriwaji,17800,6300,24100
10074,10075,21-10-2020 15:23:55.681333,Postres · Desayunos,Maltihelados,8900,6200,15100
10075,10076,21-10-2020 15:23:55.964253,Hamburguesas · Alitas,Beer,53400,6600,60000
10076,10077,21-10-2020 15:23:56.247614,Pollo · Saludable,Yerbabuena,8900,3900,12800
10077,10078,21-10-2020 15:23:56.532398,Saludable · Típica,Sopas Mrg,35000,3100,38100
10078,10079,21-10-2020 15:23:56.815675,Saludable · Desayunos,Malú,10700,3700,14400
10079,10080,21-10-2020 15:23:56.948576,Pescados y Mariscos,Pescadero Héroes del Mar,48750,6600,55350
10080,10081,21-10-2020 15:23:57.281766,Postres · Café,Celestino Café,8900,5900,14800
10081,10082,21-10-2020 15:23:57.464793,Saludable · Desayunos,Guadalupe - Fruteria,24200,5900,30100
10082,10083,21-10-2020 15:23:57.597808,Pollo · China,China Tao,35000,3500,38500
10083,10084,21-10-2020 15:23:57.780770,Desayunos · Pescados y Mariscos,Luzí­a - Mediterranea,10700,5700,16400
10084,10085,21-10-2020 15:23:57.964564,Típica · Parrilla,Mi Ranchito Parrilla,10700,4400,15100
10085,10086,21-10-2020 15:23:58.097837,Alta Cocina · Parrilla,Criterión,15000,6000,21000
10086,10087,21-10-2020 15:23:58.481089,Postres · Saludable,Ana Rebana,13000,6300,19300
10087,10088,21-10-2020 15:23:58.814178,Saludable · Desayunos,Maracuyá,31800,6700,38500
10088,10089,21-10-2020 15:23:59.047395,Parrilla,Coquitas,18900,5600,24500
10089,10090,21-10-2020 15:23:59.230378,Típica,Carbón & Mondongos,65000,6400,71400
10090,10091,21-10-2020 15:23:59.364152,Pizza · Parrilla,Urban Lunch,65000,4000,69000
10091,10092,21-10-2020 15:23:59.647541,Típica · Parrilla,Toya,53400,4200,57600
10092,10093,21-10-2020 15:23:59.880559,Desayunos,Desayunos en Bogotá,9000,3400,12400
10093,10094,21-10-2020 15:24:00.213816,Mexicana,Mexicanachos,23000,3900,26900
10094,10095,21-10-2020 15:24:00.597363,Postres · Café,Celestino Café,29500,5900,35400
10095,10096,21-10-2020 15:24:00.930544,Saludable · Desayunos,Copacabana Açai Bowls,27800,3000,30800
10096,10097,21-10-2020 15:24:01.264444,Parrilla,Parrilla Pimentón,31800,3400,35200
10097,10098,21-10-2020 15:24:01.397641,Saludable · Desayunos,Bon Eat - Saludable,29500,4800,34300
10098,10099,21-10-2020 15:24:01.782630,Saludable · Jugos y Batidos,Berdes Drinks & Salads,70000,3500,73500
10099,10100,21-10-2020 15:24:02.166265,Desayunos · Empanadas,Empanadas Doraditas.com,53900,3000,56900
10100,10101,21-10-2020 15:24:02.299446,Sushi · Asiática,Arigato,23000,5300,28300
10101,10102,21-10-2020 15:24:02.633418,Desayunos · Comida Rápida,La Veneca,23000,6300,29300
10102,10103,21-10-2020 15:24:02.816583,Alta Cocina · Postres,La Pinta,15600,4500,20100
10103,10104,21-10-2020 15:24:02.999512,Postres · Café,Loló Coffee & Snacks,9000,4600,13600
10104,10105,21-10-2020 15:24:03.232789,Pizza,18 Scalini,34500,4300,38800
10105,10106,21-10-2020 15:24:03.416326,Alta Cocina · Parrilla,Criterión,8900,6000,14900
10106,10107,21-10-2020 15:24:03.549746,Desayunos · Típica,D'Porco - Lechona,27800,6300,34100
10107,10108,21-10-2020 15:24:03.832965,Postres · Desayunos,Jacques Pastelería,23000,5900,28900
10108,10109,21-10-2020 15:24:04.216286,Postres · Desayunos,Buñuelos nacho,24200,6600,30800
10109,10110,21-10-2020 15:24:04.599709,Desayunos,Archies Desayunos,65000,3100,68100
10110,10111,21-10-2020 15:24:04.933372,Pollo · Desayunos,Candelina,15600,5300,20900
10111,10112,21-10-2020 15:24:05.066398,Típica,Cabrito Santandereano,65000,6600,71600
10112,10113,21-10-2020 15:24:05.349591,Típica · Parrilla,El Santandereano,24200,5200,29400
10113,10114,21-10-2020 15:24:05.582683,Desayunos · Típica,Desayunadero de la 42,13600,5900,19500
10114,10115,21-10-2020 15:24:05.716168,Poke,Poke Go,35000,4600,39600
10115,10116,21-10-2020 15:24:06.099594,Desayunos · Empanadas,Mis Delicias,34500,3200,37700
10116,10117,21-10-2020 15:24:06.382998,Pizza,18 Scalini,65000,4300,69300
10117,10118,21-10-2020 15:24:06.716329,Desayunos,El Corral - Desayunos,11870,5000,16870
10118,10119,21-10-2020 15:24:07.100807,Típica,Carbón & Mondongos,37900,6400,44300
10119,10120,21-10-2020 15:24:07.434414,Saludable,Hanai - Bowls Saludables,37900,5900,43800
10120,10121,21-10-2020 15:24:07.768049,Desayunos · Típica,Rojo Gourmet,53400,4700,58100
10121,10122,21-10-2020 15:24:08.001307,Postres,Levelma,48750,6200,54950
10122,10123,21-10-2020 15:24:08.234718,Sushi,Umi,24300,5600,29900
10123,10124,21-10-2020 15:24:08.618454,Pollo · Desayunos,Piaf,53400,6500,59900
10124,10125,21-10-2020 15:24:08.852112,Desayunos · Típica,Fogón Sangileño,24300,5000,29300
10125,10126,21-10-2020 15:24:09.135594,Parrilla,Campocina,12500,4600,17100
10126,10127,21-10-2020 15:24:09.269202,Pollo · Pescados y Mariscos,Bang Bang Rice,48750,3400,52150
10127,10128,21-10-2020 15:24:09.552614,Pollo · Típica,Auyama,48750,3900,52650
10128,10129,21-10-2020 15:24:09.835913,Desayunos,Señor Desayuno,23000,6800,29800
10129,10130,21-10-2020 15:24:10.219517,Saludable · Desayunos,Raices Bienestar Gourmet,53900,6600,60500
10130,10131,21-10-2020 15:24:10.453018,Saludable,The Good Rice Bowls,13600,3500,17100
10131,10132,21-10-2020 15:24:10.786406,Desayunos · Típica,Cochon,31800,3300,35100
10132,10133,21-10-2020 15:24:11.120088,Hamburguesas · Panadería,NYC Burgers,17800,6200,24000
10133,10134,21-10-2020 15:24:11.353386,Desayunos · Típica,D'Porco - Lechona,24200,6300,30500
10134,10135,21-10-2020 15:24:11.686873,Típica,Sabrosito,8900,4000,12900
10135,10136,21-10-2020 15:24:12.020206,Desayunos · Jugos y Batidos,Frutiwow,7500,4100,11600
10136,10137,21-10-2020 15:24:12.154458,Desayunos · Panadería,Siena Café,70000,3700,73700
10137,10138,21-10-2020 15:24:12.287831,Desayunos · Típica,Casa Vieja,12500,6000,18500
10138,10139,21-10-2020 15:24:12.621486,Sushi · Asiática,Arigato,27800,5300,33100
10139,10140,21-10-2020 15:24:12.954735,Desayunos · Empanadas,Mis Delicias,37900,3200,41100
10140,10141,21-10-2020 15:24:13.087851,Sánduches · China,Peru Mix,27800,5900,33700
10141,10142,21-10-2020 15:24:13.321238,Desayunos,Don Leo,10700,6000,16700
10142,10143,21-10-2020 15:24:13.655088,Postres · Desayunos,Gelateria Da Favola,17800,6500,24300
10143,10144,21-10-2020 15:24:13.889285,Desayunos · Jugos y Batidos,Kuriwaji,45800,6300,52100
10144,10145,21-10-2020 15:24:14.123289,Saludable · Desayunos,Raices Bienestar Gourmet,48750,6600,55350
10145,10146,21-10-2020 15:24:14.356918,Desayunos · Típica,Desayunadero de la 42,11870,5900,17770
10146,10147,21-10-2020 15:24:14.540383,Saludable,The Good Rice Bowls,23000,3500,26500
10147,10148,21-10-2020 15:24:14.923757,Saludable · Desayunos,Bon Eat - Saludable,53900,4800,58700
10148,10149,21-10-2020 15:24:15.157472,Saludable · Desayunos,Malú,10700,3700,14400
10149,10150,21-10-2020 15:24:15.541360,China,China Food Col,48750,3600,52350
10150,10151,21-10-2020 15:24:15.724865,Pollo · Saludable,Tremenda Sal y Dulce,31800,6500,38300
10151,10152,21-10-2020 15:24:16.058371,Crepes,La Chabatta,15600,5900,21500
10152,10153,21-10-2020 15:24:16.191739,Mexicana,Hidalgo Taquería,11870,4900,16770
10153,10154,21-10-2020 15:24:16.575229,Postres · Desayunos,BagBog Bagels,24300,6400,30700
10154,10155,21-10-2020 15:24:16.858557,Peruana · Internacional,La Chifería,13000,6600,19600
10155,10156,21-10-2020 15:24:17.042461,Desayunos · Panadería,Artesanos,12500,4300,16800
10156,10157,21-10-2020 15:24:17.428098,Desayunos · Panadería,Choclofee,35000,4700,39700
10157,10158,21-10-2020 15:24:17.611850,Pizza,Pizza Andante,13000,6300,19300
10158,10159,21-10-2020 15:24:17.995430,Típica · Parrilla,Parrilla Farandula Gourmet,27800,5100,32900
10159,10160,21-10-2020 15:24:18.229151,Comida Rápida,Fiesta Digital Andrés,15600,3100,18700
10160,10161,21-10-2020 15:24:18.562778,Típica,El Cucharón - Tipica,27800,4400,32200
10161,10162,21-10-2020 15:24:18.695869,Saludable · Típica,Sopas Mrg,27800,3100,30900
10162,10163,21-10-2020 15:24:19.079548,Saludable · Típica,Saludable Mrg,29500,5800,35300
10163,10164,21-10-2020 15:24:19.363258,Desayunos · Típica,La Frijolada,24300,4500,28800
10164,10165,21-10-2020 15:24:19.546804,Típica,Lo Nuestro,35000,3100,38100
10165,10166,21-10-2020 15:24:19.730186,Desayunos,Jacinta Arepas de Huevo,29500,4000,33500
10166,10167,21-10-2020 15:24:19.963752,Postres · Desayunos,Amelie Helados,23000,6400,29400
10167,10168,21-10-2020 15:24:20.147389,Saludable · Desayunos,Malú,53400,3700,57100
10168,10169,21-10-2020 15:24:20.281096,Saludable · Parrilla,The Angels Grill and Drinks,29500,6200,35700
10169,10170,21-10-2020 15:24:20.464685,Saludable · Desayunos,Bon Eat - Saludable,31800,4800,36600
10170,10171,21-10-2020 15:24:20.748378,Pollo · Desayunos,Candelina,53900,5300,59200
10171,10172,21-10-2020 15:24:20.981961,Parrilla,Restaurante Bar Mi Ranchito,18900,5200,24100
10172,10173,21-10-2020 15:24:21.365966,Desayunos · Jugos y Batidos,Dont Be Hungry,13000,5600,18600
10173,10174,21-10-2020 15:24:21.549158,Desayunos · Típica,D'Porco - Lechona,23000,6300,29300
10174,10175,21-10-2020 15:24:21.883033,Desayunos · Típica,Rojo Gourmet,53900,4700,58600
10175,10176,21-10-2020 15:24:22.116626,Desayunos · Café,Moramia,31800,4700,36500
10176,10177,21-10-2020 15:24:22.300528,Típica,Sopitas y Más,10700,4200,14900
10177,10178,21-10-2020 15:24:22.535173,Desayunos · Panadería,Siena Café,13000,3700,16700
10178,10179,21-10-2020 15:24:22.668637,Peruana · Internacional,La Chifería,27800,6600,34400
10179,10180,21-10-2020 15:24:23.052357,Postres,La Tertulia,35000,3400,38400
10180,10181,21-10-2020 15:24:23.286270,Saludable · Desayunos,Copacabana Açai Bowls,37900,3000,40900
10181,10182,21-10-2020 15:24:23.620354,Típica,Sopitas y Más,24200,4200,28400
10182,10183,21-10-2020 15:24:23.803982,Postres · Desayunos,La Folie - Postres,35000,3300,38300
10183,10184,21-10-2020 15:24:24.087403,Crepes,San Crepes,53400,4900,58300
10184,10185,21-10-2020 15:24:24.321226,Saludable · Desayunos,Básico y Elemental,13600,5900,19500
10185,10186,21-10-2020 15:24:24.604969,Saludable · Desayunos,Agua Dulce,53400,3700,57100
10186,10187,21-10-2020 15:24:24.888377,Saludable · Desayunos,Fresh Co,17800,5600,23400
10187,10188,21-10-2020 15:24:25.122009,Desayunos · Típica,Calentao Express,39700,6000,45700
10188,10189,21-10-2020 15:24:25.355367,Desayunos · Panadería,Premium Break Bakery,39700,3700,43400
10189,10190,21-10-2020 15:24:25.538759,Parrilla,Beraca Parrilla Bbq,9000,5600,14600
10190,10191,21-10-2020 15:24:25.922160,Hamburguesas · Desayunos,El Inglés Gastro Pub,37900,6600,44500
10191,10192,21-10-2020 15:24:26.255610,Desayunos · Típica,Rojo Gourmet,10700,4700,15400
10192,10193,21-10-2020 15:24:26.589149,Saludable · Desayunos,Re.al Alimentos Reales,35000,4000,39000
10193,10194,21-10-2020 15:24:26.973216,Típica,Campo Victoria,53400,3000,56400
10194,10195,21-10-2020 15:24:27.106629,Hamburguesas,Burger Society,9000,4100,13100
10195,10196,21-10-2020 15:24:27.340063,Desayunos · Italiana,Rceta By Rausch,10700,3600,14300
10196,10197,21-10-2020 15:24:27.624836,Desayunos,Bagel Shop,34500,3200,37700
10197,10198,21-10-2020 15:24:27.958795,Saludable · Desayunos,Raices Bienestar Gourmet,23000,6600,29600
10198,10199,21-10-2020 15:24:28.292390,Postres · Desayunos,Vivalight Market.,37900,6500,44400
10199,10200,21-10-2020 15:24:28.626559,Sushi · Asiática,Arigato,23000,5300,28300
10200,10201,21-10-2020 15:24:29.010605,Pollo · Típica,Auyama,48750,3900,52650
10201,10202,21-10-2020 15:24:29.144498,Panadería,Boul,23000,3100,26100
10202,10203,21-10-2020 15:24:29.428595,Saludable,Hanai - Bowls Saludables,10700,5900,16600
10203,10204,21-10-2020 15:24:29.612490,Saludable · Desayunos,Bon Eat - Saludable,29500,4800,34300
10204,10205,21-10-2020 15:24:29.796006,Saludable · Desayunos,La Cesta,13600,4700,18300
10205,10206,21-10-2020 15:24:30.079617,Asiática,Thai Station,23000,6000,29000
10206,10207,21-10-2020 15:24:30.463720,Postres · Desayunos,Restaurante Cornelia,7500,5500,13000
10207,10208,21-10-2020 15:24:30.847239,Típica,Salsig,34500,5600,40100
10208,10209,21-10-2020 15:24:31.080607,Crepes,San Crepes,70000,4900,74900
10209,10210,21-10-2020 15:24:31.414360,Pizza · Italiana,Piatto - Pizza,31800,6600,38400
10210,10211,21-10-2020 15:24:31.547740,Desayunos · Parrilla,Mi Patria,11870,4600,16470
10211,10212,21-10-2020 15:24:31.681225,Desayunos · Jugos y Batidos,Dont Be Hungry,13600,5600,19200
10212,10213,21-10-2020 15:24:32.014820,Saludable,Puro Verde,31800,5700,37500
10213,10214,21-10-2020 15:24:32.348475,Pizza · Italiana,Piatto - Pizza,27800,6600,34400
10214,10215,21-10-2020 15:24:32.733466,Saludable,Ventura Soup y Salad,39700,3800,43500
10215,10216,21-10-2020 15:24:32.866884,Postres · Desayunos,Jacques Pastelería,27800,5900,33700
10216,10217,21-10-2020 15:24:33.150658,Desayunos · Empanadas,Mis Delicias,11870,3200,15070
10217,10218,21-10-2020 15:24:33.334031,Parrilla,Campocina,23000,4600,27600
10218,10219,21-10-2020 15:24:33.667786,Hamburguesas · Alitas,Beer,65000,6600,71600
10219,10220,21-10-2020 15:24:33.801917,Pollo,Oliva Va,23000,5600,28600
10220,10221,21-10-2020 15:24:34.035663,Pollo · Saludable,Yerbabuena,31800,3900,35700
10221,10222,21-10-2020 15:24:34.169526,Típica,Bandejas Mrg,8900,3800,12700
10222,10223,21-10-2020 15:24:34.353317,Desayunos,Archies Desayunos,13000,3100,16100
10223,10224,21-10-2020 15:24:34.537314,Hamburguesas · Pescados y Mariscos,El Velero,45800,6500,52300
10224,10225,21-10-2020 15:24:34.821486,Desayunos · Panadería,Santa Juana Food Bar,39700,5900,45600
10225,10226,21-10-2020 15:24:35.155980,Saludable,Ventura Soup y Salad,39700,3800,43500
10226,10227,21-10-2020 15:24:35.440267,Internacional,Rio Sabores y Experiencias,48750,4100,52850
10227,10228,21-10-2020 15:24:35.674055,Postres · Desayunos,Sharmus,27800,6100,33900
10228,10229,21-10-2020 15:24:36.008472,Desayunos,El Fogón Castellano,24200,3200,27400
10229,10230,21-10-2020 15:24:36.392324,Desayunos · Panadería,Siena Café,35000,3700,38700
10230,10231,21-10-2020 15:24:36.727033,Desayunos · Café,Norma's Ice Cream Café,48750,6300,55050
10231,10232,21-10-2020 15:24:36.960839,Típica,Sabrosito,53900,4000,57900
10232,10233,21-10-2020 15:24:37.144449,Desayunos · Café,Matchacha,39700,5900,45600
10233,10234,21-10-2020 15:24:37.377885,Pizza,18 Scalini,11870,4300,16170
10234,10235,21-10-2020 15:24:37.561260,Sushi,Umi,9000,5600,14600
10235,10236,21-10-2020 15:24:37.694623,Desayunos · Jugos y Batidos,Dont Be Hungry,65000,5600,70600
10236,10237,21-10-2020 15:24:38.079259,Típica,La Olla de Barro,12500,5300,17800
10237,10238,21-10-2020 15:24:38.462974,Parrilla · Café,Gaira Café,15000,4400,19400
10238,10239,21-10-2020 15:24:38.846642,Desayunos,Archies Desayunos,70000,3100,73100
10239,10240,21-10-2020 15:24:39.080302,Desayunos · Sánduches,Danilo Colombia,29500,3300,32800
10240,10241,21-10-2020 15:24:39.214197,Postres · Café,Loló Coffee & Snacks,9000,4600,13600
10241,10242,21-10-2020 15:24:39.398079,Crepes,San Crepes,7500,4900,12400
10242,10243,21-10-2020 15:24:39.682030,Mexicana,La leyenda mexican kitchen,39700,3200,42900
10243,10244,21-10-2020 15:24:40.015578,Desayunos · Jugos y Batidos,Frutiwow,24200,4100,28300
10244,10245,21-10-2020 15:24:40.148959,Desayunos · Típica,Alce,23000,4900,27900
10245,10246,21-10-2020 15:24:40.282347,Postres,La Tertulia,9000,3400,12400
10246,10247,21-10-2020 15:24:40.465839,Pizza,pizza andante,45800,4200,50000
10247,10248,21-10-2020 15:24:40.649264,Desayunos,La Frijolada Desayunos,7500,4400,11900
10248,10249,21-10-2020 15:24:40.782538,Pollo,Oliva Va,18900,5600,24500
10249,10250,21-10-2020 15:24:41.116238,Hamburguesas,Burger Society,13000,4100,17100
10250,10251,21-10-2020 15:24:41.249915,Peruana,Uma Cantina Peruana,13000,3200,16200
10251,10252,21-10-2020 15:24:41.483724,Comida Rápida,Fiesta Digital Andrés,65000,3100,68100
10252,10253,21-10-2020 15:24:41.867762,Crepes,San Crepes,31800,4900,36700
10253,10254,21-10-2020 15:24:42.001549,Desayunos · Comida Rápida,Chocolatto,17800,3400,21200
10254,10255,21-10-2020 15:24:42.385099,Postres,La Galeta,35000,3000,38000
10255,10256,21-10-2020 15:24:42.718553,Típica · Pescados y Mariscos,Arroces Mrg,7500,4300,11800
10256,10257,21-10-2020 15:24:42.901817,Típica,Bandejas Mrg,12500,3800,16300
10257,10258,21-10-2020 15:24:43.236601,Desayunos · Sánduches,Garnish,45800,5200,51000
10258,10259,21-10-2020 15:24:43.370637,Mexicana,La leyenda mexican kitchen,48750,3200,51950
10259,10260,21-10-2020 15:24:43.554113,Postres · Desayunos,BagBog Bagels,8900,6400,15300
10260,10261,21-10-2020 15:24:43.737953,Típica,Sabores De Mi Tierra,34500,5400,39900
10261,10262,21-10-2020 15:24:44.071442,Postres · Desayunos,La Folie - Postres,12500,3300,15800
10262,10263,21-10-2020 15:24:44.204903,Mexicana,La leyenda mexican kitchen,18900,3200,22100
10263,10264,21-10-2020 15:24:44.438395,Parrilla,Arroces Maria Paula,45800,6800,52600
10264,10265,21-10-2020 15:24:44.672170,Desayunos · Panadería,Choclofee,35000,4700,39700
10265,10266,21-10-2020 15:24:44.955637,Desayunos · Jugos y Batidos,Kuriwaji,70000,6300,76300
10266,10267,21-10-2020 15:24:45.339341,Peruana,Uma Cantina Peruana,39700,3200,42900
10267,10268,21-10-2020 15:24:45.472646,Desayunos · Típica,Criollomania,65000,5200,70200
10268,10269,21-10-2020 15:24:45.706808,Postres · Saludable,Ana Rebana,45800,6300,52100
10269,10270,21-10-2020 15:24:45.990605,Típica · Parrilla,Parrilla Farandula Gourmet,53400,5100,58500
10270,10271,21-10-2020 15:24:46.174607,Desayunos · Pescados y Mariscos,Gypsy Bistro,48750,4500,53250
10271,10272,21-10-2020 15:24:46.358379,Saludable · Parrilla,Box,37900,3700,41600
10272,10273,21-10-2020 15:24:46.641993,Saludable · Desayunos,Malú,45800,3700,49500
10273,10274,21-10-2020 15:24:46.975547,Desayunos · Sánduches,Danilo Colombia,53900,3300,57200
10274,10275,21-10-2020 15:24:47.159059,Desayunos,Jacinta Arepas de Huevo,23000,4000,27000
10275,10276,21-10-2020 15:24:47.492639,Desayunos · Café,El Gualilo,23000,6200,29200
10276,10277,21-10-2020 15:24:47.876455,Desayunos · Panadería,Ficchi Panadería,13000,3100,16100
10277,10278,21-10-2020 15:24:48.009815,Postres · Desayunos,KOKOA & co.,35000,4700,39700
10278,10279,21-10-2020 15:24:48.394904,Parrilla,Carnes la Zarza,53400,4900,58300
10279,10280,21-10-2020 15:24:48.678615,Típica,Campo Victoria,35000,3000,38000
10280,10281,21-10-2020 15:24:49.062194,Sánduches,Submarin,11870,3800,15670
10281,10282,21-10-2020 15:24:49.195695,Saludable · Parrilla,Box,65000,3700,68700
10282,10283,21-10-2020 15:24:49.429252,Desayunos · Panadería,Premium Break Bakery,70000,3700,73700
10283,10284,21-10-2020 15:24:49.613278,Pollo · Pescados y Mariscos,Bang Bang Rice,23000,3400,26400
10284,10285,21-10-2020 15:24:49.846833,Postres · Desayunos,Sweet Tale,15000,5800,20800
10285,10286,21-10-2020 15:24:50.030538,Parrilla,Coquitas,11870,5600,17470
10286,10287,21-10-2020 15:24:50.214023,Postres · Desayunos,Café Quindio,70000,5700,75700
10287,10288,21-10-2020 15:24:50.397911,Típica,Juan Chorizo,70000,3900,73900
10288,10289,21-10-2020 15:24:50.631557,Asiática,TeT,15600,5900,21500
10289,10290,21-10-2020 15:24:50.965497,Desayunos · Sánduches,Frutos del Bosque,39700,3500,43200
10290,10291,21-10-2020 15:24:51.249734,Saludable · Desayunos,Guadalupe - Fruteria,23000,5900,28900
10291,10292,21-10-2020 15:24:51.533500,Sushi · Asiática,Arigato,65000,5300,70300
10292,10293,21-10-2020 15:24:51.817019,Desayunos · Café,Aromacafé el Placer de Compartir,27800,5000,32800
10293,10294,21-10-2020 15:24:52.050739,Pollo · Saludable,Tremenda Sal y Dulce,8900,6500,15400
10294,10295,21-10-2020 15:24:52.284641,Postres · Desayunos,Jacques Pastelería,11870,5900,17770
10295,10296,21-10-2020 15:24:52.619780,Pollo,Oliva Va,15600,5600,21200
10296,10297,21-10-2020 15:24:52.903764,Desayunos · Café,Frambas,11870,3400,15270
10297,10298,21-10-2020 15:24:53.137405,Saludable · Desayunos,Básico y elemental,8900,5000,13900
10298,10299,21-10-2020 15:24:53.472594,Desayunos,Jacinta Arepas de Huevo,9000,4000,13000
10299,10300,21-10-2020 15:24:53.706557,Parrilla,Restaurante Bar Mi Ranchito,18900,5200,24100
10300,10301,21-10-2020 15:24:53.990423,Internacional,La Esquina con Sabor Parrilla,53400,3000,56400
10301,10302,21-10-2020 15:24:54.124093,Sánduches · China,Peru Mix,48750,5900,54650
10302,10303,21-10-2020 15:24:54.308047,Parrilla,Arroces Maria Paula,53400,6800,60200
10303,10304,21-10-2020 15:24:54.442064,Saludable · Desayunos,Guadalupe - Fruteria,37900,5900,43800
10304,10305,21-10-2020 15:24:54.825920,Típica,Sabrosito,13600,4000,17600
10305,10306,21-10-2020 15:24:55.059352,Desayunos · Panadería,Siena Café,35000,3700,38700
10306,10307,21-10-2020 15:24:55.293239,Pollo · Saludable,Tremenda Sal y Dulce,48750,6500,55250
10307,10308,21-10-2020 15:24:55.476703,Pollo,Chicken House,24300,4200,28500
10308,10309,21-10-2020 15:24:55.760527,Típica · Parrilla,Toya,53900,4200,58100
10309,10310,21-10-2020 15:24:55.894012,Mexicana,La leyenda mexican kitchen,53400,3200,56600
10310,10311,21-10-2020 15:24:56.227761,Desayunos · Sánduches,Frutos del Bosque,15600,3500,19100
10311,10312,21-10-2020 15:24:56.461570,Típica,Lo Nuestro,11870,3100,14970
10312,10313,21-10-2020 15:24:56.845359,Parrilla,OAK Ahumado y Brebajes,11870,6000,17870
10313,10314,21-10-2020 15:24:57.079133,Típica · Parrilla,Typykos,45800,6000,51800
10314,10315,21-10-2020 15:24:57.213192,Desayunos,Sr Buñuelo,24300,6400,30700
10315,10316,21-10-2020 15:24:57.397174,Parrilla,OAK Ahumado y Brebajes,7500,6000,13500
10316,10317,21-10-2020 15:24:57.581017,Parrilla,Parrilla Pimentón,39700,3400,43100
10317,10318,21-10-2020 15:24:57.914968,Desayunos,Fratelli - Desayunos,13600,4600,18200
10318,10319,21-10-2020 15:24:58.248727,Saludable,The Good Rice Bowls,18900,3500,22400
10319,10320,21-10-2020 15:24:58.382171,Parrilla,Antojo a Domicilio,23000,5000,28000
10320,10321,21-10-2020 15:24:58.566577,Saludable · Desayunos,Malú,13000,3700,16700
10321,10322,21-10-2020 15:24:58.900226,Desayunos · Panadería,Le Pain Quotidien,35000,3900,38900
10322,10323,21-10-2020 15:24:59.284388,Saludable · Desayunos,Distrito Gourmet,24200,3700,27900
10323,10324,21-10-2020 15:24:59.468177,Saludable · Típica,Sopas Mrg,9000,3100,12100
10324,10325,21-10-2020 15:24:59.802484,Desayunos · Café,El Gualilo,24300,6200,30500
10325,10326,21-10-2020 15:25:00.086232,Pollo,Oliva Va,48750,5600,54350
10326,10327,21-10-2020 15:25:00.320031,Desayunos · Panadería,Santa Juana Food Bar,12500,5900,18400
10327,10328,21-10-2020 15:25:00.604201,Postres · Desayunos,Sharmus,13600,6100,19700
10328,10329,21-10-2020 15:25:00.888471,Poke,Poke Go,7500,4600,12100
10329,10330,21-10-2020 15:25:01.222620,Típica,Lo Nuestro,34500,3100,37600
10330,10331,21-10-2020 15:25:01.406876,Desayunos,Desayunos en Bogotá,11870,3400,15270
10331,10332,21-10-2020 15:25:01.641348,Parrilla,Arepaisa de Medellín,15600,5600,21200
10332,10333,21-10-2020 15:25:01.774832,Típica,Campo Victoria,27800,3000,30800
10333,10334,21-10-2020 15:25:01.958885,Desayunos · Panadería,El Pan de Phillippe,65000,4600,69600
10334,10335,21-10-2020 15:25:02.243051,Helados,Orso To Go,13000,6800,19800
10335,10336,21-10-2020 15:25:02.626994,Jugos y Batidos,Pomponio,53900,3600,57500
10336,10337,21-10-2020 15:25:02.810502,Desayunos · Empanadas,Mis Delicias,35000,3200,38200
10337,10338,21-10-2020 15:25:03.144515,Pollo · Sánduches,Pollos Century,53400,3000,56400
10338,10339,21-10-2020 15:25:03.378620,Postres · Desayunos,Protein Bakes,8900,5900,14800
10339,10340,21-10-2020 15:25:03.562555,Crepes,La Chabatta,34500,5900,40400
10340,10341,21-10-2020 15:25:03.746123,Típica · Parrilla,La Parilla de David,45800,3100,48900
10341,10342,21-10-2020 15:25:04.130192,Jugos y Batidos,Pomponio,29500,3600,33100
10342,10343,21-10-2020 15:25:04.364137,Desayunos · Panadería,Santa Juana Food Bar,70000,5900,75900
10343,10344,21-10-2020 15:25:04.648090,Parrilla,Parrilla Pimentón,27800,3400,31200
10344,10345,21-10-2020 15:25:04.932033,Desayunos,Bagel Shop,53900,3200,57100
10345,10346,21-10-2020 15:25:05.316328,Desayunos · Café,Norma's Ice Cream Café,35000,6300,41300
10346,10347,21-10-2020 15:25:05.450078,Asiática,Thai Station,70000,6000,76000
10347,10348,21-10-2020 15:25:05.784064,Peruana,Uma Cantina Peruana,10700,3200,13900
10348,10349,21-10-2020 15:25:06.117997,Postres,La Galeta,11870,3000,14870
10349,10350,21-10-2020 15:25:06.252201,Saludable,MIMA,34500,3700,38200
10350,10351,21-10-2020 15:25:06.536143,Desayunos · Típica,Alce,18900,4900,23800
10351,10352,21-10-2020 15:25:06.669945,Postres · Desayunos,Maltihelado,35000,4500,39500
10352,10353,21-10-2020 15:25:06.903920,Saludable,Hanai - Bowls Saludables,70000,5900,75900
10353,10354,21-10-2020 15:25:07.238009,Desayunos · Típica,Criollomania,8900,5200,14100
10354,10355,21-10-2020 15:25:07.471856,Típica,Sopitas y Más,8900,4200,13100
10355,10356,21-10-2020 15:25:07.655777,Postres · Desayunos,Aury Postres - Comidas & Picadas,18900,4700,23600
10356,10357,21-10-2020 15:25:07.839779,Sushi · Desayunos,Maki Roll,18900,4300,23200
10357,10358,21-10-2020 15:25:08.023651,Hamburguesas · Panadería,NYC Burgers,39700,6200,45900
10358,10359,21-10-2020 15:25:08.408084,Helados,Orso To Go,24200,6800,31000
10359,10360,21-10-2020 15:25:08.643387,Desayunos · Panadería,Le Pain Quotidien,27800,3900,31700
10360,10361,21-10-2020 15:25:08.927253,Saludable · Típica,Sopas Mrg,27800,3100,30900
10361,10362,21-10-2020 15:25:09.060922,Parrilla,OAK Ahumado y Brebajes,70000,6000,76000
10362,10363,21-10-2020 15:25:09.344877,Desayunos,La Frijolada Desayunos,35000,4400,39400
10363,10364,21-10-2020 15:25:09.578714,Desayunos · Pescados y Mariscos,Luzí­a - Mediterranea,53900,5700,59600
10364,10365,21-10-2020 15:25:09.862738,Típica · Parrilla,La Parilla de David,7500,3100,10600
10365,10366,21-10-2020 15:25:10.096423,Desayunos · Típica,D'Porco - Lechona,12500,6300,18800
10366,10367,21-10-2020 15:25:10.280895,Saludable · Desayunos,Guadalupe - Fruteria,37900,5900,43800
10367,10368,21-10-2020 15:25:10.464762,Postres · Café,Loló Coffee & Snacks,23000,4600,27600
10368,10369,21-10-2020 15:25:10.748651,Típica · Parrilla,El Santandereano,17800,5200,23000
10369,10370,21-10-2020 15:25:11.082592,Parrilla,OAK Ahumado y Brebajes,17800,6000,23800
10370,10371,21-10-2020 15:25:11.266619,Internacional,La Esquina con Sabor Parrilla,7500,3000,10500
10371,10372,21-10-2020 15:25:11.400334,Parrilla,Arepaisa de Medellín,31800,5600,37400
10372,10373,21-10-2020 15:25:11.534083,Típica,Sabrosito,35000,4000,39000
10373,10374,21-10-2020 15:25:11.667808,Saludable · Desayunos,Copacabana Açai Bowls,53400,3000,56400
10374,10375,21-10-2020 15:25:11.951649,Desayunos · Panadería,Juliana Restaurante,17800,6100,23900
10375,10376,21-10-2020 15:25:12.235977,Desayunos · Panadería,Pasteleite,10700,5900,16600
10376,10377,21-10-2020 15:25:12.570216,Desayunos · Café,Aromacafé el Placer de Compartir,53900,5000,58900
10377,10378,21-10-2020 15:25:12.703902,Postres · Desayunos,Sweet Tale,15000,5800,20800
10378,10379,21-10-2020 15:25:12.938201,Desayunos · Típica,Peninsula Calentados y Parrilla,70000,3400,73400
10379,10380,21-10-2020 15:25:13.121956,Desayunos,Cafetería el Kippe,53900,3200,57100
10380,10381,21-10-2020 15:25:13.356218,Típica,La Herencia,15000,5900,20900
10381,10382,21-10-2020 15:25:13.741647,Típica · Parrilla,El Santandereano,9000,5200,14200
10382,10383,21-10-2020 15:25:13.875176,Típica,El Cucharón - Tipica,31800,4400,36200
10383,10384,21-10-2020 15:25:14.009570,Postres,Beiked,13000,4000,17000
10384,10385,21-10-2020 15:25:14.293858,Típica,Bendita S,12500,4600,17100
10385,10386,21-10-2020 15:25:14.578272,Desayunos · Panadería,Le Pain Quotidien,17800,3900,21700
10386,10387,21-10-2020 15:25:14.712248,Típica,La Herencia,23000,5900,28900
10387,10388,21-10-2020 15:25:14.896667,Desayunos · Jugos y Batidos,Frutiwow,53900,4100,58000
10388,10389,21-10-2020 15:25:15.131190,Desayunos · Panadería,Decofruta,45800,4700,50500
10389,10390,21-10-2020 15:25:15.265845,Desayunos,Fratelli - Desayunos,53900,4600,58500
10390,10391,21-10-2020 15:25:15.500121,Desayunos · Sánduches,Danilo Colombia,13000,3300,16300
10391,10392,21-10-2020 15:25:15.634142,Peruana,Uma Cantina Peruana,17800,3200,21000
10392,10393,21-10-2020 15:25:15.768071,Postres · Desayunos,Maltihelado,48750,4500,53250
10393,10394,21-10-2020 15:25:15.951997,Pollo · Desayunos,Workzone,23000,3100,26100
10394,10395,21-10-2020 15:25:16.236094,Parrilla,Parrilla Pimentón,18900,3400,22300
10395,10396,21-10-2020 15:25:16.620428,Desayunos · Italiana,Rceta By Rausch,18900,3600,22500
10396,10397,21-10-2020 15:25:17.004415,Sushi,Sushi Reel,17800,4700,22500
10397,10398,21-10-2020 15:25:17.138465,Pescados y Mariscos,La Gran Cazuela,12500,3200,15700
10398,10399,21-10-2020 15:25:17.422872,Pollo · Saludable,Tremenda Sal y Dulce,15600,6500,22100
10399,10400,21-10-2020 15:25:17.556817,Desayunos · Panadería,Juliana Restaurante,31800,6100,37900
10400,10401,21-10-2020 15:25:17.941178,Jugos y Batidos,Pomponio,34500,3600,38100
10401,10402,21-10-2020 15:25:18.225908,Saludable · Desayunos,Libre de Culpa,70000,4000,74000
10402,10403,21-10-2020 15:25:18.560164,Alta Cocina · Postres,La Pinta,35000,4500,39500
10403,10404,21-10-2020 15:25:18.895132,Pollo,Señor Fantástico,15000,4700,19700
10404,10405,21-10-2020 15:25:19.078958,Típica,Cabrito Santandereano,48750,6600,55350
10405,10406,21-10-2020 15:25:19.363016,Típica · Parrilla,Mi Ranchito Parrilla,24300,4400,28700
10406,10407,21-10-2020 15:25:19.647190,Postres · Desayunos,Maltihelados,53400,6200,59600
10407,10408,21-10-2020 15:25:19.881094,Pollo · Saludable,Tremenda Sal y Dulce,15000,6500,21500
10408,10409,21-10-2020 15:25:20.265941,Hamburguesas,Gofi Burger,27800,5100,32900
10409,10410,21-10-2020 15:25:20.400004,Hamburguesas · Saludable,Restaurant Inn,23000,6100,29100
10410,10411,21-10-2020 15:25:20.684472,Parrilla,Restaurante Bar Mi Ranchito,70000,5200,75200
10411,10412,21-10-2020 15:25:21.068545,Típica,Cazuelitas 93,13000,3900,16900
10412,10413,21-10-2020 15:25:21.403089,Desayunos · Típica,Peninsula Calentados y Parrilla,70000,3400,73400
10413,10414,21-10-2020 15:25:21.787417,Típica,Sopitas y Más,70000,4200,74200
10414,10415,21-10-2020 15:25:21.971180,Típica · Parrilla,Parrilla Farandula Gourmet,24200,5100,29300
10415,10416,21-10-2020 15:25:22.155229,Asiática,Thai Station,13600,6000,19600
10416,10417,21-10-2020 15:25:22.389365,Saludable · Desayunos,Malú,17800,3700,21500
10417,10418,21-10-2020 15:25:22.723665,Crepes,San Crepes,13600,4900,18500
10418,10419,21-10-2020 15:25:23.057720,Desayunos · Típica,Peninsula Calentados y Parrilla,18900,3400,22300
10419,10420,21-10-2020 15:25:23.292247,Saludable · Desayunos,Guadalupe - Fruteria,34500,5900,40400
10420,10421,21-10-2020 15:25:23.676353,Parrilla · Café,Figaro Café/ Restaurante Argentino,39700,5800,45500
10421,10422,21-10-2020 15:25:24.011588,Desayunos,Jacinta Arepas de Huevo,11870,4000,15870
10422,10423,21-10-2020 15:25:24.246281,Pollo · Típica,Auyama,10700,3900,14600
10423,10424,21-10-2020 15:25:24.530514,Típica · Parrilla,La Parilla de David,23000,3100,26100
10424,10425,21-10-2020 15:25:24.764598,Desayunos · Típica,Casa Vieja,12500,6000,18500
10425,10426,21-10-2020 15:25:25.098841,Mexicana,La leyenda mexican kitchen,35000,3200,38200
10426,10427,21-10-2020 15:25:25.382904,Hamburguesas,Monchis - Hamburguesa,48750,4300,53050
10427,10428,21-10-2020 15:25:25.517266,Típica · Parrilla,La Parilla de David,24200,3100,27300
10428,10429,21-10-2020 15:25:25.651364,Desayunos · Café,Norma's Ice Cream Café,12500,6300,18800
10429,10430,21-10-2020 15:25:25.985945,Pollo · Pescados y Mariscos,Bang Bang Rice,13600,3400,17000
10430,10431,21-10-2020 15:25:26.220020,Postres · Desayunos,Restaurante Cornelia,11870,5500,17370
10431,10432,21-10-2020 15:25:26.605048,Desayunos,Sr Buñuelo,7500,6400,13900
10432,10433,21-10-2020 15:25:26.789476,Desayunos,Cafetería el Kippe,9000,3200,12200
10433,10434,21-10-2020 15:25:26.973500,Postres · Desayunos,Sharmus,8900,6100,15000
10434,10435,21-10-2020 15:25:27.107580,Parrilla · Café,Gaira Café,24200,4400,28600
10435,10436,21-10-2020 15:25:27.391587,Café · Helados,Sofia heladería y café,29500,5800,35300
10436,10437,21-10-2020 15:25:27.776050,Pollo · Desayunos,Workzone,70000,3100,73100
10437,10438,21-10-2020 15:25:28.110461,Hamburguesas · Alitas,Beer,13000,6600,19600
10438,10439,21-10-2020 15:25:28.445002,Desayunos · Mexicana,La Mera Mera - Mexicana,23000,3100,26100
10439,10440,21-10-2020 15:25:28.629303,Mexicana,Cantina La 15,31800,4300,36100
10440,10441,21-10-2020 15:25:28.813151,Desayunos · Típica,D'Porco - Lechona,31800,6300,38100
10441,10442,21-10-2020 15:25:29.097419,Desayunos · Panadería,El Pan de Phillippe,11870,4600,16470
10442,10443,21-10-2020 15:25:29.481673,Perros Calientes,Dog Shop - Rapida,7500,4900,12400
10443,10444,21-10-2020 15:25:29.715842,Parrilla,Carnes la Zarza,9000,4900,13900
10444,10445,21-10-2020 15:25:30.100050,Postres · Desayunos,KOKOA & co.,13000,4700,17700
10445,10446,21-10-2020 15:25:30.234397,Desayunos · Panadería,Siena Café,24200,3700,27900
10446,10447,21-10-2020 15:25:30.568636,Panadería,Boul,29500,3100,32600
10447,10448,21-10-2020 15:25:30.702576,Saludable · Desayunos,Raices Bienestar Gourmet,8900,6600,15500
10448,10449,21-10-2020 15:25:31.037002,Desayunos · Panadería,Le Pain Quotidien,37900,3900,41800
10449,10450,21-10-2020 15:25:31.171101,Pollo · Desayunos,Caserito Gourmet,35000,6700,41700
10450,10451,21-10-2020 15:25:31.555663,Pescados y Mariscos,Pescadero Héroes del Mar,13000,6600,19600
10451,10452,21-10-2020 15:25:31.740132,Pollo,Señor Fantástico,24200,4700,28900
10452,10453,21-10-2020 15:25:31.924859,Típica,Salsig,27800,5600,33400
10453,10454,21-10-2020 15:25:32.309521,Postres · Desayunos,Cosmo Cookies,8900,5900,14800
10454,10455,21-10-2020 15:25:32.493701,Postres · Desayunos,Maria Luisa - Postres,48750,4300,53050
10455,10456,21-10-2020 15:25:32.677807,Típica,Cazuelitas 93,18900,3900,22800
10456,10457,21-10-2020 15:25:33.012411,Pollo,Oliva Va,53900,5600,59500
10457,10458,21-10-2020 15:25:33.146620,Desayunos · Típica,La Parrilla Dorada Polo,45800,6600,52400
10458,10459,21-10-2020 15:25:33.330886,Saludable · Parrilla,Box,17800,3700,21500
10459,10460,21-10-2020 15:25:33.715679,Comida Rápida,Fiesta Digital Andrés,15600,3100,18700
10460,10461,21-10-2020 15:25:34.101223,Pizza · Italiana,Piatto - Pizza,13000,6600,19600
10461,10462,21-10-2020 15:25:34.436344,Desayunos,Don Leo,13000,6000,19000
10462,10463,21-10-2020 15:25:34.670974,Desayunos,Señor Desayuno,17800,6800,24600
10463,10464,21-10-2020 15:25:35.055535,Postres · Café,Celestino Café,7500,5900,13400
10464,10465,21-10-2020 15:25:35.240333,Desayunos · Típica,La Parrilla Dorada Polo,7500,6600,14100
10465,10466,21-10-2020 15:25:35.625415,Café · Helados,Sofia heladería y café,18900,5800,24700
10466,10467,21-10-2020 15:25:35.859498,Pollo · Desayunos,Abasto,35000,3600,38600
10467,10468,21-10-2020 15:25:36.193825,Pollo,Chicken House,15000,4200,19200
10468,10469,21-10-2020 15:25:36.428175,Panadería,Boul,23000,3100,26100
10469,10470,21-10-2020 15:25:36.612684,Pizza,Pizza Andante,34500,6300,40800
10470,10471,21-10-2020 15:25:36.946935,Desayunos,Cafetería el Kippe,9000,3200,12200
10471,10472,21-10-2020 15:25:37.281298,Típica,Sopitas y Más,35000,4200,39200
10472,10473,21-10-2020 15:25:37.665685,Desayunos,Bagel Shop,13000,3200,16200
10473,10474,21-10-2020 15:25:37.950199,Internacional,Rio Sabores y Experiencias,39700,4100,43800
10474,10475,21-10-2020 15:25:38.234805,Parrilla · Café,Gaira Café,37900,4400,42300
10475,10476,21-10-2020 15:25:38.469008,Desayunos · Mexicana,La Mera Mera - Mexicana,39700,3100,42800
10476,10477,21-10-2020 15:25:38.703392,Internacional,Rio Sabores y Experiencias,31800,4100,35900
10477,10478,21-10-2020 15:25:39.037595,Desayunos · Típica,D'Porco - Lechona,23000,6300,29300
10478,10479,21-10-2020 15:25:39.223168,Desayunos · Típica,Cochon,31800,3300,35100
10479,10480,21-10-2020 15:25:39.607742,Saludable,Ventura Soup y Salad,8900,3800,12700
10480,10481,21-10-2020 15:25:39.741884,Crepes,La Chabatta,35000,5900,40900
10481,10482,21-10-2020 15:25:39.925662,Desayunos · Café,Frambas,70000,3400,73400
10482,10483,21-10-2020 15:25:40.059784,Desayunos,Cafetería el Kippe,35000,3200,38200
10483,10484,21-10-2020 15:25:40.193901,Saludable · Desayunos,Básico y elemental,45800,5000,50800
10484,10485,21-10-2020 15:25:40.528005,Desayunos · Empanadas,Empanadas Doraditas.com,24300,3000,27300
10485,10486,21-10-2020 15:25:40.712225,Desayunos · Típica,La Frijolada,65000,4500,69500
10486,10487,21-10-2020 15:25:40.846284,Desayunos · Típica,Fogón Sangileño,23000,5000,28000
10487,10488,21-10-2020 15:25:41.130472,Sánduches · China,Peru Mix,13600,5900,19500
10488,10489,21-10-2020 15:25:41.265233,Parrilla,Arroces Maria Paula,9000,6800,15800
10489,10490,21-10-2020 15:25:41.649973,Hamburguesas · Pescados y Mariscos,El Velero,8900,6500,15400
10490,10491,21-10-2020 15:25:41.934041,Sushi · Asiática,Arigato,37900,5300,43200
10491,10492,21-10-2020 15:25:42.168148,Desayunos · Comida Rápida,La Veneca,37900,6300,44200
10492,10493,21-10-2020 15:25:42.502408,Crepes,San Crepes,31800,4900,36700
10493,10494,21-10-2020 15:25:42.687868,Parrilla,Antojo a Domicilio,8900,5000,13900
10494,10495,21-10-2020 15:25:42.972284,Típica · Parrilla,Mi Ranchito Parrilla,29500,4400,33900
10495,10496,21-10-2020 15:25:43.106411,Hamburguesas,Monchis - Hamburguesa,12500,4300,16800
10496,10497,21-10-2020 15:25:43.491186,Mexicana,Hidalgo Taquería,31800,4900,36700
10497,10498,21-10-2020 15:25:43.625727,Saludable,A2manos,11870,4200,16070
10498,10499,21-10-2020 15:25:43.759613,Desayunos · Típica,Parrilla Farandula Típico,18900,5900,24800
10499,10500,21-10-2020 15:25:43.894187,Postres · Desayunos,Jacques Pastelería,37900,5900,43800
10500,10501,21-10-2020 15:25:44.178527,Desayunos,Don Leo,13600,6000,19600
10501,10502,21-10-2020 15:25:44.363715,Desayunos · Típica,Rojo Gourmet,39700,4700,44400
10502,10503,21-10-2020 15:25:44.748740,Desayunos · Típica,Casa Vieja,53400,6000,59400
10503,10504,21-10-2020 15:25:44.932832,Italiana,F*cking Good Pizza,12500,4200,16700
10504,10505,21-10-2020 15:25:45.066763,Saludable,The Good Rice Bowls,24300,3500,27800
10505,10506,21-10-2020 15:25:45.200891,Comida Rápida · Perros Calientes,Similoa - Comida Rapida,35000,3700,38700
10506,10507,21-10-2020 15:25:45.535241,Hamburguesas,Burger Society,17800,4100,21900
10507,10508,21-10-2020 15:25:45.769300,Postres · Desayunos,Sharmus,29500,6100,35600
10508,10509,21-10-2020 15:25:46.153756,Parrilla,Campocina,24200,4600,28800
10509,10510,21-10-2020 15:25:46.538127,Saludable,A2manos,27800,4200,32000
10510,10511,21-10-2020 15:25:46.922757,Típica,La Herencia,29500,5900,35400
10511,10512,21-10-2020 15:25:47.107121,Saludable · Desayunos,Bon Eat - Saludable,53400,4800,58200
10512,10513,21-10-2020 15:25:47.341481,Desayunos · Parrilla,Mi Patria,23000,4600,27600
10513,10514,21-10-2020 15:25:47.476276,Postres · Helados,Mahé,23000,6000,29000
10514,10515,21-10-2020 15:25:47.861054,Pollo · Sánduches,Pollos Century,23000,3000,26000
10515,10516,21-10-2020 15:25:48.145402,Saludable · Desayunos,Re.al Alimentos Reales,37900,4000,41900
10516,10517,21-10-2020 15:25:48.430162,Desayunos · Café,vereda central calle 99,9000,5700,14700
10517,10518,21-10-2020 15:25:48.714524,Saludable · Desayunos,Re.al Alimentos Reales,23000,4000,27000
10518,10519,21-10-2020 15:25:49.048741,Desayunos · Panadería,Artesanos,13000,4300,17300
10519,10520,21-10-2020 15:25:49.182862,Postres · Desayunos,La Folie - Postres,18900,3300,22200
10520,10521,21-10-2020 15:25:49.316993,Alta Cocina · Italiana,Trattoria de la Plaza,37900,6000,43900
10521,10522,21-10-2020 15:25:49.652516,Típica,Bendita S,15600,4600,20200
10522,10523,21-10-2020 15:25:50.037466,Hamburguesas,Bendito Cordero,13600,5800,19400
10523,10524,21-10-2020 15:25:50.171489,Postres · Desayunos,Aury Postres - Comidas & Picadas,39700,4700,44400
10524,10525,21-10-2020 15:25:50.305603,Postres · Desayunos,Buñuelos nacho,10700,6600,17300
10525,10526,21-10-2020 15:25:50.589632,Desayunos · Mexicana,La Mera Mera - Mexicana,35000,3100,38100
10526,10527,21-10-2020 15:25:50.974214,Saludable,MIMA,15000,3700,18700
10527,10528,21-10-2020 15:25:51.158320,Postres,La Tertulia,37900,3400,41300
10528,10529,21-10-2020 15:25:51.342718,Típica,Lo Nuestro,18900,3100,22000
10529,10530,21-10-2020 15:25:51.727188,Típica · Parrilla,Typykos,7500,6000,13500
10530,10531,21-10-2020 15:25:52.111911,Desayunos · Pescados y Mariscos,Gypsy Bistro,15000,4500,19500
10531,10532,21-10-2020 15:25:52.296063,Parrilla,Coquitas,13000,5600,18600
10532,10533,21-10-2020 15:25:52.480437,Desayunos · Panadería,Artesanos,15600,4300,19900
10533,10534,21-10-2020 15:25:52.665156,Helados,Orso To Go,53900,6800,60700
10534,10535,21-10-2020 15:25:53.049607,Desayunos · Típica,Papadió - Colombianas,24200,5700,29900
10535,10536,21-10-2020 15:25:53.183711,Alta Cocina · Postres,La Pinta,35000,4500,39500
10536,10537,21-10-2020 15:25:53.518272,Saludable · Típica,Saludable Mrg,27800,5800,33600
10537,10538,21-10-2020 15:25:53.852701,Parrilla,Rústico Picadería,37900,3800,41700
10538,10539,21-10-2020 15:25:54.036841,Saludable,The Good Rice Bowls,27800,3500,31300
10539,10540,21-10-2020 15:25:54.171044,Típica,La Olla de Barro,24300,5300,29600
10540,10541,21-10-2020 15:25:54.555775,Saludable,The Good Rice Bowls,45800,3500,49300
10541,10542,21-10-2020 15:25:54.941569,Parrilla,Arepaisa de Medellín,18900,5600,24500
10542,10543,21-10-2020 15:25:55.276491,Desayunos · Café,Matchacha,27800,5900,33700
10543,10544,21-10-2020 15:25:55.661033,Crepes,San Crepes,23000,4900,27900
10544,10545,21-10-2020 15:25:55.845697,Pollo · Desayunos,Workzone,7500,3100,10600
10545,10546,21-10-2020 15:25:56.080028,Postres · Desayunos,KOKOA & co.,13000,4700,17700
10546,10547,21-10-2020 15:25:56.264338,Desayunos · Comida Rápida,Chocolatto,24300,3400,27700
10547,10548,21-10-2020 15:25:56.598929,Desayunos · Típica,D'Porco - Lechona,10700,6300,17000
10548,10549,21-10-2020 15:25:56.883401,Típica · Parrilla,El Santandereano,53900,5200,59100
10549,10550,21-10-2020 15:25:57.067546,Desayunos · Café,Libertario Coffee Roasters,15000,4600,19600
10550,10551,21-10-2020 15:25:57.352108,Pizza,18 Scalini,13600,4300,17900
10551,10552,21-10-2020 15:25:57.636710,Postres · Helados,Mahé,27800,6000,33800
10552,10553,21-10-2020 15:25:57.771586,Pizza,Pizza Andante,7500,6300,13800
10553,10554,21-10-2020 15:25:58.106540,Postres · Desayunos,KOKOA & co.,23000,4700,27700
10554,10555,21-10-2020 15:25:58.291393,Crepes,La Chabatta,53900,5900,59800
10555,10556,21-10-2020 15:25:58.576140,Típica,Salsig,15600,5600,21200
10556,10557,21-10-2020 15:25:58.710881,Saludable,Hanai - Bowls Saludables,8900,5900,14800
10557,10558,21-10-2020 15:25:59.045867,Típica · Pescados y Mariscos,Arroces Mrg,27800,4300,32100
10558,10559,21-10-2020 15:25:59.280219,Pollo · Saludable,Gratina,29500,4200,33700
10559,10560,21-10-2020 15:25:59.414844,Pollo · Típica,Auyama,13000,3900,16900
10560,10561,21-10-2020 15:25:59.649380,Pescados y Mariscos,Pescadero Héroes del Mar,53900,6600,60500
10561,10562,21-10-2020 15:25:59.783479,Postres · Desayunos,BagBog Bagels,24300,6400,30700
10562,10563,21-10-2020 15:26:00.168342,Saludable · Típica,Sopas Mrg,12500,3100,15600
10563,10564,21-10-2020 15:26:00.352471,Postres · Desayunos,Protein Bakes,11870,5900,17770
10564,10565,21-10-2020 15:26:00.536760,Desayunos · Panadería,Decofruta,23000,4700,27700
10565,10566,21-10-2020 15:26:00.820961,Desayunos · Comida Rápida,Chocolatto,65000,3400,68400
10566,10567,21-10-2020 15:26:01.005213,Italiana,Bocatto Di Passo,65000,5000,70000
10567,10568,21-10-2020 15:26:01.189422,Sushi,Kim Pop,27800,5400,33200
10568,10569,21-10-2020 15:26:01.574626,Típica · Parrilla,El Santandereano,37900,5200,43100
10569,10570,21-10-2020 15:26:01.710250,Café · Helados,Sofia heladería y café,23000,5800,28800
10570,10571,21-10-2020 15:26:02.095254,Desayunos,Butter,15600,6700,22300
10571,10572,21-10-2020 15:26:02.229791,Desayunos · Panadería,Limarys,35000,6500,41500
10572,10573,21-10-2020 15:26:02.363941,Internacional,Rio Sabores y Experiencias,53400,4100,57500
10573,10574,21-10-2020 15:26:02.548256,Pollo · Desayunos,Candelina,34500,5300,39800
10574,10575,21-10-2020 15:26:02.832850,Sushi · Asiática,Arigato,70000,5300,75300
10575,10576,21-10-2020 15:26:03.117950,Pollo · Desayunos,Caserito Gourmet,10700,6700,17400
10576,10577,21-10-2020 15:26:03.453023,Desayunos · Típica,Fogón Sangileño,70000,5000,75000
10577,10578,21-10-2020 15:26:03.737450,Hamburguesas,Burger Society,65000,4100,69100
10578,10579,21-10-2020 15:26:03.972411,Hamburguesas,Burger Society,31800,4100,35900
10579,10580,21-10-2020 15:26:04.357329,Pizza,Pizza Andante,65000,6300,71300
10580,10581,21-10-2020 15:26:04.591718,Helados,Orso To Go,8900,6800,15700
10581,10582,21-10-2020 15:26:04.776288,Pollo · Desayunos,Abasto,29500,3600,33100
10582,10583,21-10-2020 15:26:05.110939,Postres · Desayunos,Aury Postres - Comidas & Picadas,13000,4700,17700
10583,10584,21-10-2020 15:26:05.396814,Postres,Levelma,29500,6200,35700
10584,10585,21-10-2020 15:26:05.531541,Postres · Café,Celestino Café,70000,5900,75900
10585,10586,21-10-2020 15:26:05.715946,Parrilla,Arepaisa de Medellín,12500,5600,18100
10586,10587,21-10-2020 15:26:05.901108,Saludable · Típica,Sopas Mrg,24300,3100,27400
10587,10588,21-10-2020 15:26:06.085523,Saludable · Desayunos,Libre de Culpa,35000,4000,39000
10588,10589,21-10-2020 15:26:06.270274,Hamburguesas · Pescados y Mariscos,El Velero,24200,6500,30700
10589,10590,21-10-2020 15:26:06.655013,Comida Rápida,Fiesta Digital Andrés,9000,3100,12100
10590,10591,21-10-2020 15:26:06.939884,Hamburguesas · Desayunos,El Inglés Gastro Pub,53900,6600,60500
10591,10592,21-10-2020 15:26:07.074303,Desayunos · Árabe,Boniato Sabores Vivos,70000,5300,75300
10592,10593,21-10-2020 15:26:07.409718,Típica,Sopitas y Más,15600,4200,19800
10593,10594,21-10-2020 15:26:07.645217,Desayunos · Típica,La Parrilla Dorada Polo,27800,6600,34400
10594,10595,21-10-2020 15:26:07.879742,Típica,Carbón & Mondongos,39700,6400,46100
10595,10596,21-10-2020 15:26:08.014149,Típica · Parrilla,Typykos,27800,6000,33800
10596,10597,21-10-2020 15:26:08.399319,Desayunos,La Frijolada Desayunos,31800,4400,36200
10597,10598,21-10-2020 15:26:08.584035,Saludable · Desayunos,Re.al Alimentos Reales,9000,4000,13000
10598,10599,21-10-2020 15:26:08.718970,Parrilla,Parrilla Pimentón,7500,3400,10900
10599,10600,21-10-2020 15:26:09.104077,Desayunos · Típica,Fogón Sangileño,27800,5000,32800
10600,10601,21-10-2020 15:26:09.289244,Desayunos · Jugos y Batidos,Frutiwow,35000,4100,39100
10601,10602,21-10-2020 15:26:09.523865,Postres · Desayunos,BagBog Bagels,23000,6400,29400
10602,10603,21-10-2020 15:26:09.858839,Desayunos · Típica,D'Porco - Lechona,35000,6300,41300
10603,10604,21-10-2020 15:26:10.196512,Saludable,Puro Verde,34500,5700,40200
10604,10605,21-10-2020 15:26:10.432286,Desayunos · Típica,Parrilla Farandula Típico,24200,5900,30100
10605,10606,21-10-2020 15:26:10.566808,Internacional,La Esquina con Sabor Parrilla,23000,3000,26000
10606,10607,21-10-2020 15:26:10.701488,Pollo · Saludable,Tremenda Sal y Dulce,45800,6500,52300
10607,10608,21-10-2020 15:26:11.035842,Parrilla · Café,Gaira Café,70000,4400,74400
10608,10609,21-10-2020 15:26:11.270422,Pollo · Desayunos,Abasto,35000,3600,38600
10609,10610,21-10-2020 15:26:11.455004,Desayunos · Panadería,Le Pain Quotidien,35000,3900,38900
10610,10611,21-10-2020 15:26:11.739708,Típica · Parrilla,Parrilla Farandula Gourmet,17800,5100,22900
10611,10612,21-10-2020 15:26:12.074511,Desayunos,El Corral - Desayunos,53900,5000,58900
10612,10613,21-10-2020 15:26:12.459412,Parrilla · Café,Figaro Café/ Restaurante Argentino,9000,5800,14800
10613,10614,21-10-2020 15:26:12.593899,Saludable,A2manos,35000,4200,39200
10614,10615,21-10-2020 15:26:12.728420,Postres · Desayunos,Café Quindio,53400,5700,59100
10615,10616,21-10-2020 15:26:13.113440,Desayunos · Sánduches,Danilo Colombia,18900,3300,22200
10616,10617,21-10-2020 15:26:13.248089,Desayunos,Fratelli - Desayunos,65000,4600,69600
10617,10618,21-10-2020 15:26:13.633291,Saludable · Desayunos,Re.al Alimentos Reales,29500,4000,33500
10618,10619,21-10-2020 15:26:14.017869,Pollo · Desayunos,Caserito Gourmet,13600,6700,20300
10619,10620,21-10-2020 15:26:14.252541,Desayunos · Café,Norma's Ice Cream Café,35000,6300,41300
10620,10621,21-10-2020 15:26:14.387904,Asiática,TeT,15600,5900,21500
10621,10622,21-10-2020 15:26:14.573322,Desayunos · Panadería,Juliana Restaurante,35000,6100,41100
10622,10623,21-10-2020 15:26:14.758469,Saludable,The Good Rice Bowls,23000,3500,26500
10623,10624,21-10-2020 15:26:15.143436,Pollo · Saludable,Yerbabuena,37900,3900,41800
10624,10625,21-10-2020 15:26:15.328098,Mexicana,Hidalgo Taquería,17800,4900,22700
10625,10626,21-10-2020 15:26:15.614151,Típica,La Olla de Barro,45800,5300,51100
10626,10627,21-10-2020 15:26:15.798807,Mexicana,La leyenda mexican kitchen,48750,3200,51950
10627,10628,21-10-2020 15:26:16.133731,Poke,Poke Go,70000,4600,74600
10628,10629,21-10-2020 15:26:16.317999,Hamburguesas · Desayunos,El Inglés Gastro Pub,8900,6600,15500
10629,10630,21-10-2020 15:26:16.702596,Hamburguesas · Saludable,Restaurant Inn,9000,6100,15100
10630,10631,21-10-2020 15:26:16.887014,Desayunos · Panadería,Ficchi Panadería,10700,3100,13800
10631,10632,21-10-2020 15:26:17.171647,Peruana · Internacional,La Chifería,31800,6600,38400
10632,10633,21-10-2020 15:26:17.356396,Desayunos · Pescados y Mariscos,Luzí­a - Mediterranea,45800,5700,51500
10633,10634,21-10-2020 15:26:17.591028,Postres · Desayunos,Gelateria Da Favola,53900,6500,60400
10634,10635,21-10-2020 15:26:17.775768,Desayunos · Panadería,Decofruta,7500,4700,12200
10635,10636,21-10-2020 15:26:17.910397,Pescados y Mariscos,Pescadero Héroes del Mar,13000,6600,19600
10636,10637,21-10-2020 15:26:18.095072,Desayunos · Sánduches,Danilo Colombia,35000,3300,38300
10637,10638,21-10-2020 15:26:18.479766,Típica,Baondish,24300,5800,30100
10638,10639,21-10-2020 15:26:18.664719,Pollo · Saludable,Gratina,15000,4200,19200
10639,10640,21-10-2020 15:26:18.799137,Sushi,Umi,8900,5600,14500
10640,10641,21-10-2020 15:26:19.134266,Postres · Desayunos,Jacques Pastelería,39700,5900,45600
10641,10642,21-10-2020 15:26:19.419132,Desayunos · Jugos y Batidos,Kuriwaji,53400,6300,59700
10642,10643,21-10-2020 15:26:19.704172,Pollo · China,China Tao,39700,3500,43200
10643,10644,21-10-2020 15:26:20.039440,Típica · Parrilla,Parrilla Farandula Gourmet,23000,5100,28100
10644,10645,21-10-2020 15:26:20.174461,Postres,La Galeta,24200,3000,27200
10645,10646,21-10-2020 15:26:20.359196,Desayunos · Empanadas,Mis Delicias,10700,3200,13900
10646,10647,21-10-2020 15:26:20.494241,Desayunos · Café,El Gualilo,7500,6200,13700
10647,10648,21-10-2020 15:26:20.730294,Desayunos · Típica,90 Calentados,29500,3700,33200
10648,10649,21-10-2020 15:26:21.115773,Poke,Poke Go,29500,4600,34100
10649,10650,21-10-2020 15:26:21.451284,Postres · Desayunos,Maltihelado,31800,4500,36300
10650,10651,21-10-2020 15:26:21.637015,Desayunos · Empanadas,Mis Delicias,65000,3200,68200
10651,10652,21-10-2020 15:26:22.022936,Desayunos · Italiana,Rceta By Rausch,37900,3600,41500
10652,10653,21-10-2020 15:26:22.208605,Saludable · Desayunos,Bon Eat - Saludable,31800,4800,36600
10653,10654,21-10-2020 15:26:22.594028,Saludable · Desayunos,Básico y elemental,12500,5000,17500
10654,10655,21-10-2020 15:26:22.729109,Desayunos · Italiana,Rceta By Rausch,24300,3600,27900
10655,10656,21-10-2020 15:26:23.064195,Pescados y Mariscos,Pescadero Héroes del Mar,23000,6600,29600
10656,10657,21-10-2020 15:26:23.299454,Postres · Café,Celestino Café,8900,5900,14800
10657,10658,21-10-2020 15:26:23.684562,Típica,Salsig,35000,5600,40600
10658,10659,21-10-2020 15:26:23.819403,Postres · Desayunos,Maria Luisa - Postres,23000,4300,27300
10659,10660,21-10-2020 15:26:24.004637,Postres · Helados,Mahé,15000,6000,21000
10660,10661,21-10-2020 15:26:24.389891,Saludable,Amor Propio saludable,31800,4000,35800
10661,10662,21-10-2020 15:26:24.625503,Típica,Juan Chorizo,45800,3900,49700
10662,10663,21-10-2020 15:26:24.910933,Desayunos,Bagel Shop,24300,3200,27500
10663,10664,21-10-2020 15:26:25.146343,Saludable · Desayunos,Fresh Co,70000,5600,75600
10664,10665,21-10-2020 15:26:25.281588,Desayunos · Típica,Calentao Express,9000,6000,15000
10665,10666,21-10-2020 15:26:25.466930,Postres · Desayunos,Jacques Pastelería,15600,5900,21500
10666,10667,21-10-2020 15:26:25.753044,Pollo · Desayunos,Workzone,15600,3100,18700
10667,10668,21-10-2020 15:26:26.088245,Desayunos · Típica,Rojo Gourmet,8900,4700,13600
10668,10669,21-10-2020 15:26:26.223216,Desayunos · Sánduches,Garnish,8900,5200,14100
10669,10670,21-10-2020 15:26:26.408734,Típica · Parrilla,La Parilla de David,53400,3100,56500
10670,10671,21-10-2020 15:26:26.743826,Hamburguesas · Panadería,NYC Burgers,13000,6200,19200
10671,10672,21-10-2020 15:26:27.129514,Pizza,18 Scalini,45800,4300,50100
10672,10673,21-10-2020 15:26:27.414950,Desayunos · Pescados y Mariscos,Gypsy Bistro,27800,4500,32300
10673,10674,21-10-2020 15:26:27.750172,Hamburguesas · Pescados y Mariscos,El Velero,13600,6500,20100
10674,10675,21-10-2020 15:26:27.984928,Desayunos,Fratelli - Desayunos,48750,4600,53350
10675,10676,21-10-2020 15:26:28.119800,Pizza,Pastas Laurentina,13600,4800,18400
10676,10677,21-10-2020 15:26:28.254870,Desayunos · Café,Matchacha,35000,5900,40900
10677,10678,21-10-2020 15:26:28.440173,Postres · Desayunos,Café Quindio,53900,5700,59600
10678,10679,21-10-2020 15:26:28.626105,Postres · Desayunos,Restaurante Cornelia,45800,5500,51300
10679,10680,21-10-2020 15:26:28.812252,Pollo · Desayunos,Abasto,45800,3600,49400
10680,10681,21-10-2020 15:26:28.948008,Desayunos · Café,Frambas,24300,3400,27700
10681,10682,21-10-2020 15:26:29.234887,Sánduches · China,Peru Mix,15000,5900,20900
10682,10683,21-10-2020 15:26:29.420932,Hamburguesas · Saludable,Restaurant Inn,53400,6100,59500
10683,10684,21-10-2020 15:26:29.807096,Peruana · Internacional,La Chifería,13000,6600,19600
10684,10685,21-10-2020 15:26:30.193025,Típica,Salsig,13600,5600,19200
10685,10686,21-10-2020 15:26:30.579133,Italiana,Bocatto Di Passo,53400,5000,58400
10686,10687,21-10-2020 15:26:30.714891,Pollo,Oliva Va,10700,5600,16300
10687,10688,21-10-2020 15:26:31.099775,Postres · Desayunos,La Folie - Postres,53900,3300,57200
10688,10689,21-10-2020 15:26:31.485897,Desayunos,El Corral - Desayunos,37900,5000,42900
10689,10690,21-10-2020 15:26:31.721487,Desayunos · Panadería,Le Pain Quotidien,70000,3900,73900
10690,10691,21-10-2020 15:26:31.907651,Desayunos,Archies Desayunos,45800,3100,48900
10691,10692,21-10-2020 15:26:32.042782,Postres · Panadería,RIGHT AWAY FOODS,11870,6600,18470
10692,10693,21-10-2020 15:26:32.329055,Crepes,San Crepes,31800,4900,36700
10693,10694,21-10-2020 15:26:32.564121,Parrilla · Café,Gaira Café,24300,4400,28700
10694,10695,21-10-2020 15:26:32.950144,Sánduches · Pescados y Mariscos,Pacific Comida de Mar,23000,4000,27000
10695,10696,21-10-2020 15:26:33.084804,Poke,Poke Go,11870,4600,16470
10696,10697,21-10-2020 15:26:33.471410,Peruana,Uma Cantina Peruana,11870,3200,15070
10697,10698,21-10-2020 15:26:33.806598,Desayunos,La Frijolada Desayunos,27800,4400,32200
10698,10699,21-10-2020 15:26:33.991999,Desayunos · Típica,Casa Vieja,70000,6000,76000
10699,10700,21-10-2020 15:26:34.227059,Postres · Desayunos,Aury Postres - Comidas & Picadas,23000,4700,27700
10700,10701,21-10-2020 15:26:34.462170,Pizza · Italiana,Pisapore - Pizza,48750,6600,55350
10701,10702,21-10-2020 15:26:34.847024,China,China Food Col,24300,3600,27900
10702,10703,21-10-2020 15:26:35.031929,Saludable · Desayunos,Guadalupe - Fruteria,34500,5900,40400
10703,10704,21-10-2020 15:26:35.366875,Desayunos · Típica,Casa Vieja,13600,6000,19600
10704,10705,21-10-2020 15:26:35.651840,Típica,La Herencia,35000,5900,40900
10705,10706,21-10-2020 15:26:35.936744,Desayunos,Cafetería el Kippe,13000,3200,16200
10706,10707,21-10-2020 15:26:36.122753,Crepes,La Chabatta,9000,5900,14900
10707,10708,21-10-2020 15:26:36.357515,Típica · Pescados y Mariscos,Arroces Mrg,53900,4300,58200
10708,10709,21-10-2020 15:26:36.542141,Desayunos,Fratelli - Desayunos,24300,4600,28900
10709,10710,21-10-2020 15:26:36.777017,Típica · Parrilla,Mi Ranchito Parrilla,7500,4400,11900
10710,10711,21-10-2020 15:26:37.061972,Desayunos · Café,Frambas,31800,3400,35200
10711,10712,21-10-2020 15:26:37.447225,Pollo · Desayunos,Caserito Gourmet,17800,6700,24500
10712,10713,21-10-2020 15:26:37.731975,Postres · Desayunos,Maltihelado,34500,4500,39000
10713,10714,21-10-2020 15:26:38.016801,Comida Rápida,Fiesta Digital Andrés,53400,3100,56500
10714,10715,21-10-2020 15:26:38.351703,Típica,Sabores De Mi Tierra,48750,5400,54150
10715,10716,21-10-2020 15:26:38.586374,Desayunos · Café,Moramia,9000,4700,13700
10716,10717,21-10-2020 15:26:38.921434,Postres,Beiked,70000,4000,74000
10717,10718,21-10-2020 15:26:39.056635,Saludable · Desayunos,La Cesta,18900,4700,23600
10718,10719,21-10-2020 15:26:39.191311,Parrilla,Antojo a Domicilio,23000,5000,28000
10719,10720,21-10-2020 15:26:39.426895,Postres · Desayunos,BagBog Bagels,48750,6400,55150
10720,10721,21-10-2020 15:26:39.611914,Saludable · Desayunos,Agua Dulce,12500,3700,16200
10721,10722,21-10-2020 15:26:39.847456,Pollo · Desayunos,Workzone,24300,3100,27400
10722,10723,21-10-2020 15:26:40.133014,Poke,Poke Go,15000,4600,19600
10723,10724,21-10-2020 15:26:40.468122,Desayunos · Panadería,Juliana Restaurante,10700,6100,16800
10724,10725,21-10-2020 15:26:40.603399,Pollo · Saludable,Yerbabuena,29500,3900,33400
10725,10726,21-10-2020 15:26:40.838382,Desayunos,Fratelli - Desayunos,7500,4600,12100
10726,10727,21-10-2020 15:26:41.225218,Peruana,Masivo,35000,5800,40800
10727,10728,21-10-2020 15:26:41.410379,Postres · Desayunos,Vivalight Market.,24300,6500,30800
10728,10729,21-10-2020 15:26:41.645341,Mexicana,La leyenda mexican kitchen,18900,3200,22100
10729,10730,21-10-2020 15:26:41.779905,Desayunos,Fratelli - Desayunos,45800,4600,50400
10730,10731,21-10-2020 15:26:41.965008,Crepes,La Chabatta,15000,5900,20900
10731,10732,21-10-2020 15:26:42.300171,Pizza,pizza andante,39700,4200,43900
10732,10733,21-10-2020 15:26:42.585187,Desayunos · Jugos y Batidos,Frutiwow,53900,4100,58000
10733,10734,21-10-2020 15:26:42.819867,Pizza · Parrilla,Urban Lunch,13000,4000,17000
10734,10735,21-10-2020 15:26:43.104712,Comida Rápida · Perros Calientes,Similoa - Comida Rapida,23000,3700,26700
10735,10736,21-10-2020 15:26:43.439616,Desayunos · Café,Norma's Ice Cream Café,11870,6300,18170
10736,10737,21-10-2020 15:26:43.674444,Desayunos · Jugos y Batidos,Kuriwaji,31800,6300,38100
10737,10738,21-10-2020 15:26:43.859134,Desayunos · Típica,Fogón Sangileño,37900,5000,42900
10738,10739,21-10-2020 15:26:44.043846,Postres · Desayunos,BagBog Bagels,15600,6400,22000
10739,10740,21-10-2020 15:26:44.328693,Hamburguesas · Desayunos,El Inglés Gastro Pub,8900,6600,15500
10740,10741,21-10-2020 15:26:44.463680,Panadería,Boul,11870,3100,14970
10741,10742,21-10-2020 15:26:44.798448,Internacional,La Esquina con Sabor Parrilla,24300,3000,27300
10742,10743,21-10-2020 15:26:45.033453,Desayunos,Don Leo,31800,6000,37800
10743,10744,21-10-2020 15:26:45.218176,Saludable · Desayunos,Bawana - Sandwich,18900,3400,22300
10744,10745,21-10-2020 15:26:45.503791,Postres · Desayunos,Protein Bakes,12500,5900,18400
10745,10746,21-10-2020 15:26:45.739765,Alta Cocina · Postres,La Pinta,53900,4500,58400
10746,10747,21-10-2020 15:26:45.875251,Postres,Toledo Pastelería,37900,6800,44700
10747,10748,21-10-2020 15:26:46.010040,Desayunos,El Corral - Desayunos,24300,5000,29300
10748,10749,21-10-2020 15:26:46.144804,Desayunos · Pescados y Mariscos,Gypsy Bistro,7500,4500,12000
10749,10750,21-10-2020 15:26:46.380554,Desayunos · Café,Aromacafé el Placer de Compartir,10700,5000,15700
10750,10751,21-10-2020 15:26:46.615974,Pizza · Italiana,Piatto - Pizza,29500,6600,36100
10751,10752,21-10-2020 15:26:46.951623,Saludable,A2manos,15600,4200,19800
10752,10753,21-10-2020 15:26:47.237230,Desayunos,Sunny Breakfast Brunch,13600,4300,17900
10753,10754,21-10-2020 15:26:47.572268,Postres · Desayunos,Vivalight Market.,13000,6500,19500
10754,10755,21-10-2020 15:26:47.857247,Desayunos · Típica,D´Porco,17800,3900,21700
10755,10756,21-10-2020 15:26:48.042072,Típica · Parrilla,El Santandereano,18900,5200,24100
10756,10757,21-10-2020 15:26:48.326915,Postres · Desayunos,Cosmo Cookies,35000,5900,40900
10757,10758,21-10-2020 15:26:48.461775,Postres · Desayunos,Amelie Helados,48750,6400,55150
10758,10759,21-10-2020 15:26:48.696519,Postres · Desayunos,Protein Bakes,39700,5900,45600
10759,10760,21-10-2020 15:26:48.931469,Parrilla,Parrilla Pimentón,7500,3400,10900
10760,10761,21-10-2020 15:26:49.116544,Desayunos · Café,Matchacha,53900,5900,59800
10761,10762,21-10-2020 15:26:49.401838,Sánduches · Pescados y Mariscos,Pacific Comida de Mar,11870,4000,15870
10762,10763,21-10-2020 15:26:49.787164,Saludable · Desayunos,Distrito Gourmet,24300,3700,28000
10763,10764,21-10-2020 15:26:49.922264,Típica,El Mondongo y Mucho Mas,8900,5600,14500
10764,10765,21-10-2020 15:26:50.307599,Típica · Parrilla,El Portal de la Antigua,11870,5600,17470
10765,10766,21-10-2020 15:26:50.643105,Saludable,Amor Propio saludable,24200,4000,28200
10766,10767,21-10-2020 15:26:51.028494,Desayunos · Típica,Fogón Sangileño,29500,5000,34500
10767,10768,21-10-2020 15:26:51.213723,Desayunos · Panadería,Le Pain Quotidien,35000,3900,38900
10768,10769,21-10-2020 15:26:51.600013,Saludable,Puro Verde,23000,5700,28700
10769,10770,21-10-2020 15:26:51.785019,Postres,Toledo Pastelería,48750,6800,55550
10770,10771,21-10-2020 15:26:52.170270,Desayunos · Panadería,Choclofee,13000,4700,17700
10771,10772,21-10-2020 15:26:52.405726,Saludable,A2manos,39700,4200,43900
10772,10773,21-10-2020 15:26:52.741297,Pescados y Mariscos,Pescadero Héroes del Mar,65000,6600,71600
10773,10774,21-10-2020 15:26:52.926619,Desayunos · Sánduches,Danilo Colombia,17800,3300,21100
10774,10775,21-10-2020 15:26:53.261819,Postres · Desayunos,Amelie Helados,13600,6400,20000
10775,10776,21-10-2020 15:26:53.396982,Típica · Pescados y Mariscos,Arroces Mrg,27800,4300,32100
10776,10777,21-10-2020 15:26:53.782633,Postres · Desayunos,Sweet Tale,31800,5800,37600
10777,10778,21-10-2020 15:26:53.967576,Pollo · China,China Tao,23000,3500,26500
10778,10779,21-10-2020 15:26:54.152573,Desayunos · Internacional,Camilia,23000,3900,26900
10779,10780,21-10-2020 15:26:54.487843,Jugos y Batidos,Pomponio,45800,3600,49400
10780,10781,21-10-2020 15:26:54.722985,Pollo · Saludable,Yerbabuena,48750,3900,52650
10781,10782,21-10-2020 15:26:55.108455,Saludable · Desayunos,Básico y elemental,7500,5000,12500
10782,10783,21-10-2020 15:26:55.393739,Saludable · Desayunos,Fresh Co,34500,5600,40100
10783,10784,21-10-2020 15:26:55.528692,Desayunos · Panadería,Ficchi Panadería,65000,3100,68100
10784,10785,21-10-2020 15:26:55.763762,Desayunos · Típica,D'Porco - Lechona,13600,6300,19900
10785,10786,21-10-2020 15:26:55.998922,Sushi,Umi,7500,5600,13100
10786,10787,21-10-2020 15:26:56.284225,Desayunos · Panadería,Decofruta,65000,4700,69700
10787,10788,21-10-2020 15:26:56.419863,Desayunos · Típica,Fogón Sangileño,53400,5000,58400
10788,10789,21-10-2020 15:26:56.554817,Saludable,The Good Rice Bowls,15000,3500,18500
10789,10790,21-10-2020 15:26:56.790892,Postres,Beiked,18900,4000,22900
10790,10791,21-10-2020 15:26:56.925824,Desayunos · Típica,Papadió - Colombianas,23000,5700,28700
10791,10792,21-10-2020 15:26:57.311477,Pollo,Heart & Cooking,12500,5000,17500
10792,10793,21-10-2020 15:26:57.446789,Saludable,Amor Propio saludable,18900,4000,22900
10793,10794,21-10-2020 15:26:57.782022,Típica,El Mondongo y Mucho Mas,11870,5600,17470
10794,10795,21-10-2020 15:26:58.117312,Postres,Toledo Pastelería,35000,6800,41800
10795,10796,21-10-2020 15:26:58.502324,Mexicana,Mexicanachos,17800,3900,21700
10796,10797,21-10-2020 15:26:58.887307,Pollo · Saludable,Tremenda Sal y Dulce,17800,6500,24300
10797,10798,21-10-2020 15:26:59.272759,Desayunos · Panadería,Ficchi Panadería,17800,3100,20900
10798,10799,21-10-2020 15:26:59.608150,Parrilla,Antojo a Domicilio,27800,5000,32800
10799,10800,21-10-2020 15:26:59.893339,Pollo · Típica,Auyama,37900,3900,41800
10800,10801,21-10-2020 15:27:00.278520,Mexicana,Cantina La 15,48750,4300,53050
10801,10802,21-10-2020 15:27:00.563963,Hamburguesas · Pescados y Mariscos,El Velero,13600,6500,20100
10802,10803,21-10-2020 15:27:00.749261,Mexicana,Cantina La 15,24200,4300,28500
10803,10804,21-10-2020 15:27:01.034298,Internacional,Rio Sabores y Experiencias,23000,4100,27100
10804,10805,21-10-2020 15:27:01.419680,Pollo · Desayunos,Caserito Gourmet,24300,6700,31000
10805,10806,21-10-2020 15:27:01.755112,Desayunos · Café,Matchacha,7500,5900,13400
10806,10807,21-10-2020 15:27:02.091297,Desayunos,Sunny Breakfast Brunch,37900,4300,42200
10807,10808,21-10-2020 15:27:02.326514,Desayunos · Panadería,Ficchi Panadería,29500,3100,32600
10808,10809,21-10-2020 15:27:02.461902,Desayunos,La Frijolada Desayunos,65000,4400,69400
10809,10810,21-10-2020 15:27:02.797372,Parrilla,Rústico Picadería,35000,3800,38800
10810,10811,21-10-2020 15:27:03.132307,Saludable · Desayunos,Fresh Co,35000,5600,40600
10811,10812,21-10-2020 15:27:03.367468,Postres · Desayunos,Restaurante Cornelia,45800,5500,51300
10812,10813,21-10-2020 15:27:03.602530,Desayunos · Parrilla,Mi Patria,27800,4600,32400
10813,10814,21-10-2020 15:27:03.737455,Típica,Cabrito Santandereano,31800,6600,38400
10814,10815,21-10-2020 15:27:04.072446,Saludable · Desayunos,Básico y elemental,24200,5000,29200
10815,10816,21-10-2020 15:27:04.257637,Sushi,Umi,29500,5600,35100
10816,10817,21-10-2020 15:27:04.492606,Desayunos · Típica,La Frijolada,39700,4500,44200
10817,10818,21-10-2020 15:27:04.627758,Desayunos · Sánduches,Danilo Colombia,11870,3300,15170
10818,10819,21-10-2020 15:27:04.862674,Comida Rápida,Fiesta Digital Andrés,24200,3100,27300
10819,10820,21-10-2020 15:27:05.147728,Mexicana,Cantina La 15,13600,4300,17900
10820,10821,21-10-2020 15:27:05.533475,Internacional,La Esquina con Sabor Parrilla,9000,3000,12000
10821,10822,21-10-2020 15:27:05.768758,Alta Cocina · Parrilla,Criterión,29500,6000,35500
10822,10823,21-10-2020 15:27:06.004221,Postres,La Tertulia,11870,3400,15270
10823,10824,21-10-2020 15:27:06.339133,Parrilla,Carnes la Zarza,12500,4900,17400
10824,10825,21-10-2020 15:27:06.725067,Comida Rápida · Perros Calientes,Similoa - Comida Rapida,12500,3700,16200
10825,10826,21-10-2020 15:27:06.960237,Desayunos · Típica,Peninsula Calentados y Parrilla,24300,3400,27700
10826,10827,21-10-2020 15:27:07.246598,Saludable · Parrilla,The Angels Grill and Drinks,7500,6200,13700
10827,10828,21-10-2020 15:27:07.432456,Típica,La Cocina,24300,4600,28900
10828,10829,21-10-2020 15:27:07.717906,Desayunos,Bagel Shop,34500,3200,37700
10829,10830,21-10-2020 15:27:07.953266,Sánduches · Pescados y Mariscos,Pacific Comida de Mar,24200,4000,28200
10830,10831,21-10-2020 15:27:08.289012,Desayunos · Jugos y Batidos,Dont Be Hungry,13000,5600,18600
10831,10832,21-10-2020 15:27:08.524361,Saludable,Puro Verde,13600,5700,19300
10832,10833,21-10-2020 15:27:08.859842,Desayunos · Típica,Criollomania,45800,5200,51000
10833,10834,21-10-2020 15:27:08.994931,Desayunos · Típica,Parrilla Farandula Típico,31800,5900,37700
10834,10835,21-10-2020 15:27:09.280289,Pollo · Saludable,Tremenda Sal y Dulce,12500,6500,19000
10835,10836,21-10-2020 15:27:09.565466,Desayunos · Panadería,Siena Café,37900,3700,41600
10836,10837,21-10-2020 15:27:09.750672,Pollo · Desayunos,Workzone,53900,3100,57000
10837,10838,21-10-2020 15:27:09.885676,Parrilla,Beraca Parrilla Bbq,11870,5600,17470
10838,10839,21-10-2020 15:27:10.120792,Postres · Desayunos,Maltihelado,23000,4500,27500
10839,10840,21-10-2020 15:27:10.255987,Hamburguesas,Monchis - Hamburguesa,10700,4300,15000
10840,10841,21-10-2020 15:27:10.491205,Desayunos · Típica,Criollomania,13600,5200,18800
10841,10842,21-10-2020 15:27:10.776215,Pollo · Sánduches,Pollos Century,53900,3000,56900
10842,10843,21-10-2020 15:27:11.061684,Alta Cocina · Parrilla,Criterión,13000,6000,19000
10843,10844,21-10-2020 15:27:11.397118,Jugos y Batidos,Pomponio,45800,3600,49400
10844,10845,21-10-2020 15:27:11.532661,Asiática,Thai Station,10700,6000,16700
10845,10846,21-10-2020 15:27:11.718093,Comida Rápida · Perros Calientes,Similoa - Comida Rapida,15600,3700,19300
10846,10847,21-10-2020 15:27:11.903294,Típica,Sabrosito,70000,4000,74000
10847,10848,21-10-2020 15:27:12.138939,Típica,Lo Nuestro,53400,3100,56500
10848,10849,21-10-2020 15:27:12.426076,Postres · Desayunos,Cosmo Cookies,23000,5900,28900
10849,10850,21-10-2020 15:27:12.811521,Pollo · Saludable,Tremenda Sal y Dulce,23000,6500,29500
10850,10851,21-10-2020 15:27:12.997072,Pizza · Italiana,Piatto - Pizza,35000,6600,41600
10851,10852,21-10-2020 15:27:13.233463,Típica,El Cucharón - Tipica,31800,4400,36200
10852,10853,21-10-2020 15:27:13.619776,Postres · Desayunos,Maria Luisa - Postres,39700,4300,44000
10853,10854,21-10-2020 15:27:13.755301,Desayunos · Árabe,Boniato Sabores Vivos,23000,5300,28300
10854,10855,21-10-2020 15:27:13.890632,Postres · Desayunos,Sweet Tale,11870,5800,17670
10855,10856,21-10-2020 15:27:14.076270,Típica · Pescados y Mariscos,La Vitualla,53900,6300,60200
10856,10857,21-10-2020 15:27:14.312160,Típica,Juan Chorizo,35000,3900,38900
10857,10858,21-10-2020 15:27:14.497631,Típica · Parrilla,El Santandereano,37900,5200,43100
10858,10859,21-10-2020 15:27:14.683053,Desayunos · Típica,Papadió - Colombianas,15000,5700,20700
10859,10860,21-10-2020 15:27:15.018558,Panadería,Boul,45800,3100,48900
10860,10861,21-10-2020 15:27:15.154045,Saludable · Desayunos,Re.al Alimentos Reales,23000,4000,27000
10861,10862,21-10-2020 15:27:15.440068,Desayunos · Típica,Alce,39700,4900,44600
10862,10863,21-10-2020 15:27:15.575932,Desayunos · Típica,Rojo Gourmet,37900,4700,42600
10863,10864,21-10-2020 15:27:15.811768,Típica,Sopitas y Más,39700,4200,43900
10864,10865,21-10-2020 15:27:15.997595,Típica,El Cucharón - Tipica,24200,4400,28600
10865,10866,21-10-2020 15:27:16.183197,Típica,Lo Nuestro,70000,3100,73100
10866,10867,21-10-2020 15:27:16.318616,Típica,El Mondongo y Mucho Mas,18900,5600,24500
10867,10868,21-10-2020 15:27:16.604245,Típica,Juan Chorizo,34500,3900,38400
10868,10869,21-10-2020 15:27:16.739887,Desayunos · Italiana,Rceta By Rausch,12500,3600,16100
10869,10870,21-10-2020 15:27:17.075173,Parrilla,Parrilla Pimentón,27800,3400,31200
10870,10871,21-10-2020 15:27:17.210683,Parrilla,El Tambor,70000,6800,76800
10871,10872,21-10-2020 15:27:17.496746,Pizza,pizza andante,34500,4200,38700
10872,10873,21-10-2020 15:27:17.732208,Típica,Cazuelitas 93,11870,3900,15770
10873,10874,21-10-2020 15:27:17.867232,Desayunos · Helados,San Giorgio Gelateria,17800,3100,20900
10874,10875,21-10-2020 15:27:18.252669,Pescados y Mariscos,Fish Place - Del Mar,53400,5400,58800
10875,10876,21-10-2020 15:27:18.538302,Desayunos · Empanadas,Empanadas Doraditas.com,37900,3000,40900
10876,10877,21-10-2020 15:27:18.923743,Asiática,TeT,17800,5900,23700
10877,10878,21-10-2020 15:27:19.209260,Desayunos · Típica,Criollomania,48750,5200,53950
10878,10879,21-10-2020 15:27:19.444535,Típica,Bandejas Mrg,13600,3800,17400
10879,10880,21-10-2020 15:27:19.829932,Saludable · Típica,Saludable Mrg,39700,5800,45500
10880,10881,21-10-2020 15:27:20.165247,Saludable · Desayunos,Guadalupe - Fruteria,11870,5900,17770
10881,10882,21-10-2020 15:27:20.350181,Típica,La Olla de Barro,15000,5300,20300
10882,10883,21-10-2020 15:27:20.485079,Desayunos · Internacional,Camilia,18900,3900,22800
10883,10884,21-10-2020 15:27:20.770544,Típica · Parrilla,La Parilla de David,27800,3100,30900
10884,10885,21-10-2020 15:27:20.956035,Desayunos · Jugos y Batidos,Kuriwaji,23000,6300,29300
10885,10886,21-10-2020 15:27:21.341416,Saludable,A2manos,11870,4200,16070
10886,10887,21-10-2020 15:27:21.576525,Alta Cocina · Italiana,Trattoria de la Plaza,15000,6000,21000
10887,10888,21-10-2020 15:27:21.912138,Saludable · Desayunos,Guadalupe - Fruteria,24200,5900,30100
10888,10889,21-10-2020 15:27:22.197662,Desayunos · Panadería,Decofruta,12500,4700,17200
10889,10890,21-10-2020 15:27:22.534222,Típica · Parrilla,La Parilla de David,65000,3100,68100
10890,10891,21-10-2020 15:27:22.719836,Típica,Lo Nuestro,29500,3100,32600
10891,10892,21-10-2020 15:27:23.055241,Hamburguesas · Desayunos,El Inglés Gastro Pub,31800,6600,38400
10892,10893,21-10-2020 15:27:23.441326,Desayunos,Señor Desayuno,39700,6800,46500
10893,10894,21-10-2020 15:27:23.677000,Típica · Parrilla,Toya,23000,4200,27200
10894,10895,21-10-2020 15:27:24.012919,Desayunos,Archies Desayunos,10700,3100,13800
10895,10896,21-10-2020 15:27:24.148282,Desayunos,Jacinta Arepas de Huevo,15000,4000,19000
10896,10897,21-10-2020 15:27:24.534115,Parrilla,Campocina,9000,4600,13600
10897,10898,21-10-2020 15:27:24.669338,Saludable · Desayunos,Fresh Co,23000,5600,28600
10898,10899,21-10-2020 15:27:24.954804,Parrilla,Arroces Maria Paula,34500,6800,41300
10899,10900,21-10-2020 15:27:25.340308,Pizza · Italiana,Pisapore - Pizza,17800,6600,24400
10900,10901,21-10-2020 15:27:25.675616,Pollo · China,China Tao,37900,3500,41400
10901,10902,21-10-2020 15:27:25.861033,Sushi,Umi,29500,5600,35100
10902,10903,21-10-2020 15:27:26.196556,Pollo · Desayunos,Abasto,15600,3600,19200
10903,10904,21-10-2020 15:27:26.582179,Postres · Desayunos,Sharmus,27800,6100,33900
10904,10905,21-10-2020 15:27:26.867756,Postres · Saludable,Ana Rebana,8900,6300,15200
10905,10906,21-10-2020 15:27:27.153252,Desayunos,Butter,39700,6700,46400
10906,10907,21-10-2020 15:27:27.438953,Desayunos · Panadería,Decofruta,37900,4700,42600
10907,10908,21-10-2020 15:27:27.575442,Hamburguesas · Pescados y Mariscos,El Velero,23000,6500,29500
10908,10909,21-10-2020 15:27:27.911022,Postres · Desayunos,Maltihelados,12500,6200,18700
10909,10910,21-10-2020 15:27:28.247081,Peruana,Masivo,17800,5800,23600
10910,10911,21-10-2020 15:27:28.483158,Saludable · Desayunos,Libre de Culpa,45800,4000,49800
10911,10912,21-10-2020 15:27:28.618641,Desayunos,Fratelli - Desayunos,35000,4600,39600
10912,10913,21-10-2020 15:27:29.004255,Internacional,La Esquina con Sabor Parrilla,18900,3000,21900
10913,10914,21-10-2020 15:27:29.339650,Desayunos · Café,Aromacafé el Placer de Compartir,29500,5000,34500
10914,10915,21-10-2020 15:27:29.524984,Desayunos,El Fogón Castellano,9000,3200,12200
10915,10916,21-10-2020 15:27:29.660227,Postres,La Galeta,9000,3000,12000
10916,10917,21-10-2020 15:27:29.845640,Pescados y Mariscos,La Gran Cazuela,15000,3200,18200
10917,10918,21-10-2020 15:27:30.130902,Típica,Baondish,34500,5800,40300
10918,10919,21-10-2020 15:27:30.466331,Desayunos · Panadería,Pasteleite,23000,5900,28900
10919,10920,21-10-2020 15:27:30.801909,Saludable,Amor Propio saludable,12500,4000,16500
10920,10921,21-10-2020 15:27:31.187649,Típica · Parrilla,El Portal de la Antigua,34500,5600,40100
10921,10922,21-10-2020 15:27:31.573034,Parrilla,Arroces Maria Paula,24300,6800,31100
10922,10923,21-10-2020 15:27:31.958609,Desayunos · Árabe,Boniato Sabores Vivos,13000,5300,18300
10923,10924,21-10-2020 15:27:32.093828,Desayunos · Panadería,El Pan de Phillippe,65000,4600,69600
10924,10925,21-10-2020 15:27:32.329519,Hamburguesas,Monchis - Hamburguesa,24300,4300,28600
10925,10926,21-10-2020 15:27:32.564702,Panadería,Boul,7500,3100,10600
10926,10927,21-10-2020 15:27:32.901756,Panadería,Boul,24300,3100,27400
10927,10928,21-10-2020 15:27:33.187423,Desayunos,Desayunos en Bogotá,37900,3400,41300
10928,10929,21-10-2020 15:27:33.523352,Saludable · Típica,Saludable Mrg,35000,5800,40800
10929,10930,21-10-2020 15:27:33.809315,Jugos y Batidos,Pomponio,23000,3600,26600
10930,10931,21-10-2020 15:27:34.144773,Postres,Toledo Pastelería,53400,6800,60200
10931,10932,21-10-2020 15:27:34.330074,Postres · Desayunos,Restaurante Cornelia,45800,5500,51300
10932,10933,21-10-2020 15:27:34.565499,Parrilla,Restaurante Bar Mi Ranchito,18900,5200,24100
10933,10934,21-10-2020 15:27:34.800754,Saludable · Desayunos,Fresh Co,53900,5600,59500
10934,10935,21-10-2020 15:27:35.086341,Postres · Desayunos,Maria Luisa - Postres,10700,4300,15000
10935,10936,21-10-2020 15:27:35.422235,Desayunos · Panadería,Pasteleite,45800,5900,51700
10936,10937,21-10-2020 15:27:35.758315,Desayunos,Archies Desayunos,34500,3100,37600
10937,10938,21-10-2020 15:27:36.043768,Típica · Parrilla,La Ternera Parrilla,13600,5200,18800
10938,10939,21-10-2020 15:27:36.179240,Saludable · Desayunos,Bawana - Sandwich,35000,3400,38400
10939,10940,21-10-2020 15:27:36.514754,Postres · Desayunos,KOKOA & co.,23000,4700,27700
10940,10941,21-10-2020 15:27:36.750258,Desayunos · Café,Moramia,13600,4700,18300
10941,10942,21-10-2020 15:27:37.135788,Mexicana,Cantina La 15,17800,4300,22100
10942,10943,21-10-2020 15:27:37.521768,Saludable · Desayunos,Raices Bienestar Gourmet,31800,6600,38400
10943,10944,21-10-2020 15:27:37.807185,Postres · Desayunos,Sweet Tale,15000,5800,20800
10944,10945,21-10-2020 15:27:38.094056,Desayunos · Panadería,Ficchi Panadería,24300,3100,27400
10945,10946,21-10-2020 15:27:38.229671,Sánduches · Pescados y Mariscos,Pacific Comida de Mar,53400,4000,57400
10946,10947,21-10-2020 15:27:38.415331,Típica,Juan Chorizo,39700,3900,43600
10947,10948,21-10-2020 15:27:38.750891,Desayunos,Cafetería el Kippe,12500,3200,15700
10948,10949,21-10-2020 15:27:38.886344,Internacional,La Esquina con Sabor Parrilla,17800,3000,20800
10949,10950,21-10-2020 15:27:39.171988,Postres · Desayunos,Café Quindio,24300,5700,30000
10950,10951,21-10-2020 15:27:39.557855,Helados,Buon Gelato,53900,4400,58300
10951,10952,21-10-2020 15:27:39.893634,Saludable,A2manos,9000,4200,13200
10952,10953,21-10-2020 15:27:40.279492,Desayunos · Café,Libertario Coffee Roasters,37900,4600,42500
10953,10954,21-10-2020 15:27:40.515007,Saludable,The Good Rice Bowls,15600,3500,19100
10954,10955,21-10-2020 15:27:40.750563,Postres · Helados,Mahé,39700,6000,45700
10955,10956,21-10-2020 15:27:40.935710,Parrilla,Coquitas,31800,5600,37400
10956,10957,21-10-2020 15:27:41.321366,Desayunos · Típica,Casa Vieja,53900,6000,59900
10957,10958,21-10-2020 15:27:41.556687,Mexicana,Cantina La 15,35000,4300,39300
10958,10959,21-10-2020 15:27:41.942288,Desayunos · Jugos y Batidos,Frutiwow,18900,4100,23000
10959,10960,21-10-2020 15:27:42.277867,Postres,La Galeta,34500,3000,37500
10960,10961,21-10-2020 15:27:42.613620,Parrilla,Carnes la Zarza,13000,4900,17900
10961,10962,21-10-2020 15:27:42.848859,Mexicana,Cantina La 15,13000,4300,17300
10962,10963,21-10-2020 15:27:43.235632,Desayunos · Café,Norma's Ice Cream Café,8900,6300,15200
10963,10964,21-10-2020 15:27:43.621760,Desayunos · Típica,Criollomania,15600,5200,20800
10964,10965,21-10-2020 15:27:43.957566,Típica · Parrilla,La Ternera Parrilla,34500,5200,39700
10965,10966,21-10-2020 15:27:44.143152,Sánduches · Pescados y Mariscos,Pacific Comida de Mar,8900,4000,12900
10966,10967,21-10-2020 15:27:44.429303,Desayunos · Típica,90 Calentados,15000,3700,18700
10967,10968,21-10-2020 15:27:44.615001,Parrilla,Carnes la Zarza,53900,4900,58800
10968,10969,21-10-2020 15:27:44.800512,Postres · Desayunos,Maria Luisa - Postres,13600,4300,17900
10969,10970,21-10-2020 15:27:45.035869,Crepes,La Chabatta,23000,5900,28900
10970,10971,21-10-2020 15:27:45.271550,Saludable,Puro Verde,65000,5700,70700
10971,10972,21-10-2020 15:27:45.658052,Típica,Baondish,13600,5800,19400
10972,10973,21-10-2020 15:27:45.793732,Postres · Desayunos,Amelie Helados,23000,6400,29400
10973,10974,21-10-2020 15:27:45.979065,Típica,Juan Chorizo,17800,3900,21700
10974,10975,21-10-2020 15:27:46.314898,Parrilla,Beraca Parrilla Bbq,23000,5600,28600
10975,10976,21-10-2020 15:27:46.550552,Desayunos · Típica,Criollomania,37900,5200,43100
10976,10977,21-10-2020 15:27:46.835911,Desayunos · Empanadas,Mis Delicias,34500,3200,37700
10977,10978,21-10-2020 15:27:47.221925,Sánduches · Pescados y Mariscos,Pacific Comida de Mar,24300,4000,28300
10978,10979,21-10-2020 15:27:47.608263,Crepes,La Chabatta,29500,5900,35400
10979,10980,21-10-2020 15:27:47.994035,Pollo · Desayunos,Caserito Gourmet,65000,6700,71700
10980,10981,21-10-2020 15:27:48.179617,Desayunos · Jugos y Batidos,Frutiwow,35000,4100,39100
10981,10982,21-10-2020 15:27:48.416140,Desayunos · Pescados y Mariscos,Luzí­a - Mediterranea,70000,5700,75700
10982,10983,21-10-2020 15:27:48.752161,Asiática,Thai Station,65000,6000,71000
10983,10984,21-10-2020 15:27:48.937807,China,China Food Col,24200,3600,27800
10984,10985,21-10-2020 15:27:49.273689,Saludable · Desayunos,Bon Eat - Saludable,31800,4800,36600
10985,10986,21-10-2020 15:27:49.559505,Típica,Bandejas Mrg,11870,3800,15670
10986,10987,21-10-2020 15:27:49.895651,Desayunos · Comida Rápida,Chocolatto,17800,3400,21200
10987,10988,21-10-2020 15:27:50.181378,Poke,Poke Go,18900,4600,23500
10988,10989,21-10-2020 15:27:50.417437,Postres · Desayunos,BagBog Bagels,27800,6400,34200
10989,10990,21-10-2020 15:27:50.803300,Típica,Campo Victoria,29500,3000,32500
10990,10991,21-10-2020 15:27:51.039189,Saludable · Jugos y Batidos,Berdes Drinks & Salads,39700,3500,43200
10991,10992,21-10-2020 15:27:51.275106,Desayunos · Pescados y Mariscos,Gypsy Bistro,39700,4500,44200
10992,10993,21-10-2020 15:27:51.510809,Pollo,Señor Fantástico,24200,4700,28900
10993,10994,21-10-2020 15:27:51.746706,Postres · Desayunos,Café Quindio,18900,5700,24600
10994,10995,21-10-2020 15:27:52.132524,Postres,La Tertulia,13000,3400,16400
10995,10996,21-10-2020 15:27:52.368119,Postres · Desayunos,Maria Luisa - Postres,35000,4300,39300
10996,10997,21-10-2020 15:27:52.504018,Peruana · Internacional,La Chifería,7500,6600,14100
10997,10998,21-10-2020 15:27:52.739707,Parrilla,Campocina,53400,4600,58000
10998,10999,21-10-2020 15:27:53.075563,Desayunos · Sánduches,Garnish,23000,5200,28200
10999,11000,21-10-2020 15:27:53.463014,Desayunos · Típica,D´Porco,9000,3900,12900
11000,11001,21-10-2020 15:27:53.649564,Saludable,Puro Verde,70000,5700,75700
11001,11002,21-10-2020 15:27:53.835205,Postres,Levelma,9000,6200,15200
11002,11003,21-10-2020 15:27:53.971047,Hamburguesas · Pescados y Mariscos,El Velero,23000,6500,29500
11003,11004,21-10-2020 15:27:54.156615,Desayunos,Archies Desayunos,8900,3100,12000
11004,11005,21-10-2020 15:27:54.542428,Desayunos · Café,Matchacha,31800,5900,37700
11005,11006,21-10-2020 15:27:54.877880,Desayunos · Helados,San Giorgio Gelateria,37900,3100,41000
11006,11007,21-10-2020 15:27:55.213738,Desayunos,Butter,48750,6700,55450
11007,11008,21-10-2020 15:27:55.599682,Asiática,TeT,29500,5900,35400
11008,11009,21-10-2020 15:27:55.986001,Crepes,La Chabatta,53400,5900,59300
11009,11010,21-10-2020 15:27:56.271663,Desayunos · Típica,Criollomania,39700,5200,44900
11010,11011,21-10-2020 15:27:56.557494,Saludable · Desayunos,Malú,53400,3700,57100
11011,11012,21-10-2020 15:27:56.943201,Típica · Parrilla,La Ternera Parrilla,35000,5200,40200
11012,11013,21-10-2020 15:27:57.128944,Parrilla,Arroces Maria Paula,15600,6800,22400
11013,11014,21-10-2020 15:27:57.415024,Desayunos · Panadería,Pasteleite,53400,5900,59300
11014,11015,21-10-2020 15:27:57.700830,Perros Calientes,Dog Shop - Rapida,27800,4900,32700
11015,11016,21-10-2020 15:27:57.986631,Postres · Desayunos,Maltihelados,23000,6200,29200
11016,11017,21-10-2020 15:27:58.222291,Típica,El Mondongo y Mucho Mas,35000,5600,40600
11017,11018,21-10-2020 15:27:58.558736,Desayunos · Típica,Casa Vieja,18900,6000,24900
11018,11019,21-10-2020 15:27:58.694354,Saludable · Desayunos,Básico y elemental,9000,5000,14000
11019,11020,21-10-2020 15:27:59.030052,Helados,Buon Gelato,23000,4400,27400
11020,11021,21-10-2020 15:27:59.416155,Típica,Campo Victoria,10700,3000,13700
11021,11022,21-10-2020 15:27:59.802070,Desayunos · Panadería,Artesanos,65000,4300,69300
11022,11023,21-10-2020 15:28:00.087689,Desayunos · Empanadas,Mis Delicias,45800,3200,49000
11023,11024,21-10-2020 15:28:00.424001,Pizza,pizza andante,12500,4200,16700
11024,11025,21-10-2020 15:28:00.610013,Desayunos · Típica,La Frijolada,15000,4500,19500
11025,11026,21-10-2020 15:28:00.996060,Pollo,Señor Fantástico,17800,4700,22500
11026,11027,21-10-2020 15:28:01.382019,Postres · Desayunos,La Folie - Postres,70000,3300,73300
11027,11028,21-10-2020 15:28:01.517912,Desayunos · Típica,Criollomania,13600,5200,18800
11028,11029,21-10-2020 15:28:01.653780,Desayunos · Típica,Peninsula Calentados y Parrilla,37900,3400,41300
11029,11030,21-10-2020 15:28:01.839312,Desayunos,Bagel Shop,15600,3200,18800
11030,11031,21-10-2020 15:28:02.225489,Desayunos · Empanadas,Empanadas Doraditas.com,8900,3000,11900
11031,11032,21-10-2020 15:28:02.360914,Desayunos · Jugos y Batidos,Dont Be Hungry,45800,5600,51400
11032,11033,21-10-2020 15:28:02.747016,Desayunos · Típica,La Frijolada,35000,4500,39500
11033,11034,21-10-2020 15:28:03.082843,Desayunos · Típica,Desayunadero de la 42,35000,5900,40900
11034,11035,21-10-2020 15:28:03.419110,Desayunos,Bagel Shop,65000,3200,68200
11035,11036,21-10-2020 15:28:03.706361,Desayunos · Panadería,Ficchi Panadería,15000,3100,18100
11036,11037,21-10-2020 15:28:04.042568,Sushi,Kim Pop,35000,5400,40400
11037,11038,21-10-2020 15:28:04.328230,Desayunos,El Fogón Castellano,10700,3200,13900
11038,11039,21-10-2020 15:28:04.513961,Pollo,Señor Fantástico,15600,4700,20300
11039,11040,21-10-2020 15:28:04.800118,Típica · Parrilla,El Santandereano,27800,5200,33000
11040,11041,21-10-2020 15:28:05.036266,Parrilla · Café,Figaro Café/ Restaurante Argentino,9000,5800,14800
11041,11042,21-10-2020 15:28:05.322024,Desayunos · Panadería,Juliana Restaurante,27800,6100,33900
11042,11043,21-10-2020 15:28:05.507771,Típica,Juan Chorizo,24200,3900,28100
11043,11044,21-10-2020 15:28:05.693743,Desayunos · Típica,D'Porco - Lechona,13000,6300,19300
11044,11045,21-10-2020 15:28:05.930042,Desayunos · Típica,Calentao Express,24300,6000,30300
11045,11046,21-10-2020 15:28:06.115859,Saludable · Desayunos,Raices Bienestar Gourmet,53400,6600,60000
11046,11047,21-10-2020 15:28:06.252033,Saludable · Desayunos,Re.al Alimentos Reales,65000,4000,69000
11047,11048,21-10-2020 15:28:06.537989,Desayunos · Pescados y Mariscos,Gypsy Bistro,8900,4500,13400
11048,11049,21-10-2020 15:28:06.724105,Alta Cocina · Parrilla,Criterión,23000,6000,29000
11049,11050,21-10-2020 15:28:07.060878,Saludable · Desayunos,Libre de Culpa,34500,4000,38500
11050,11051,21-10-2020 15:28:07.247912,Desayunos · Café,Frambas,31800,3400,35200
11051,11052,21-10-2020 15:28:07.534303,Desayunos · Empanadas,Empanadas Doraditas.com,53900,3000,56900
11052,11053,21-10-2020 15:28:07.870269,Postres · Desayunos,Maltihelados,8900,6200,15100
11053,11054,21-10-2020 15:28:08.156294,Parrilla,Carnes la Zarza,24300,4900,29200
11054,11055,21-10-2020 15:28:08.542392,Típica,Sabores De Mi Tierra,12500,5400,17900
11055,11056,21-10-2020 15:28:08.879115,Hamburguesas,Bendito Cordero,24300,5800,30100
11056,11057,21-10-2020 15:28:09.215319,Típica,Bandejas Mrg,23000,3800,26800
11057,11058,21-10-2020 15:28:09.601534,Saludable · Desayunos,Bawana - Sandwich,31800,3400,35200
11058,11059,21-10-2020 15:28:09.937703,Típica,Carbón & Mondongos,45800,6400,52200
11059,11060,21-10-2020 15:28:10.124051,Saludable · Desayunos,Malú,7500,3700,11200
11060,11061,21-10-2020 15:28:10.410570,China,China Food Col,11870,3600,15470
11061,11062,21-10-2020 15:28:10.646874,Pollo,Chicken House,11870,4200,16070
11062,11063,21-10-2020 15:28:10.932730,Saludable · Desayunos,Distrito Gourmet,34500,3700,38200
11063,11064,21-10-2020 15:28:11.168791,Crepes,La Chabatta,53400,5900,59300
11064,11065,21-10-2020 15:28:11.554620,Desayunos · Típica,La Frijolada,7500,4500,12000
11065,11066,21-10-2020 15:28:11.940515,Desayunos · Típica,D´Porco,48750,3900,52650
11066,11067,21-10-2020 15:28:12.077073,Helados,Orso To Go,29500,6800,36300
11067,11068,21-10-2020 15:28:12.262904,Desayunos · Típica,La Parrilla Dorada Polo,53400,6600,60000
11068,11069,21-10-2020 15:28:12.498486,Postres · Desayunos,Maltihelados,24300,6200,30500
11069,11070,21-10-2020 15:28:12.834624,Desayunos,El Corral - Desayunos,18900,5000,23900
11070,11071,21-10-2020 15:28:13.171028,Desayunos,Don Leo,35000,6000,41000
11071,11072,21-10-2020 15:28:13.407459,Postres · Desayunos,Maltihelado,13600,4500,18100
11072,11073,21-10-2020 15:28:13.743774,Hamburguesas,Bendito Cordero,35000,5800,40800
11073,11074,21-10-2020 15:28:14.031255,China,China Food Col,35000,3600,38600
11074,11075,21-10-2020 15:28:14.167372,Hamburguesas · Alitas,Beer,53900,6600,60500
11075,11076,21-10-2020 15:28:14.453765,Hamburguesas,Burger Society,7500,4100,11600
11076,11077,21-10-2020 15:28:14.839999,Pollo · Desayunos,Candelina,45800,5300,51100
11077,11078,21-10-2020 15:28:15.176951,Desayunos · Panadería,Decofruta,23000,4700,27700
11078,11079,21-10-2020 15:28:15.414667,Desayunos · Típica,90 Calentados,9000,3700,12700
11079,11080,21-10-2020 15:28:15.652529,Parrilla,Restaurante Bar Mi Ranchito,29500,5200,34700
11080,11081,21-10-2020 15:28:15.939136,Postres · Desayunos,Aury Postres - Comidas & Picadas,53400,4700,58100
11081,11082,21-10-2020 15:28:16.125975,Alta Cocina · Postres,La Pinta,13600,4500,18100
11082,11083,21-10-2020 15:28:16.462436,Mexicana,La leyenda mexican kitchen,9000,3200,12200
11083,11084,21-10-2020 15:28:16.698754,Pizza · Parrilla,Urban Lunch,70000,4000,74000
11084,11085,21-10-2020 15:28:17.084918,Saludable · Desayunos,Bawana - Sandwich,37900,3400,41300
11085,11086,21-10-2020 15:28:17.371163,Saludable · Desayunos,Bon Eat - Saludable,65000,4800,69800
11086,11087,21-10-2020 15:28:17.707298,Asiática,Thai Station,23000,6000,29000
11087,11088,21-10-2020 15:28:18.043669,Desayunos · Panadería,Artesanos,65000,4300,69300
11088,11089,21-10-2020 15:28:18.229812,Pollo · Desayunos,Piaf,31800,6500,38300
11089,11090,21-10-2020 15:28:18.416412,Desayunos · Sánduches,Frutos del Bosque,13000,3500,16500
11090,11091,21-10-2020 15:28:18.702786,Típica,Carbón & Mondongos,24200,6400,30600
11091,11092,21-10-2020 15:28:19.040021,Postres · Helados,Mahé,15600,6000,21600
11092,11093,21-10-2020 15:28:19.376076,Pescados y Mariscos,Fish Place - Del Mar,35000,5400,40400
11093,11094,21-10-2020 15:28:19.712678,Saludable · Desayunos,Fresh Co,48750,5600,54350
11094,11095,21-10-2020 15:28:19.949342,Parrilla,Parrilla Pimentón,48750,3400,52150
11095,11096,21-10-2020 15:28:20.285935,Desayunos · Café,El Gualilo,17800,6200,24000
11096,11097,21-10-2020 15:28:20.622685,Crepes,San Crepes,65000,4900,69900
11097,11098,21-10-2020 15:28:20.859030,Postres · Desayunos,Sweet Tale,13000,5800,18800
11098,11099,21-10-2020 15:28:21.046016,Típica,Baondish,45800,5800,51600
11099,11100,21-10-2020 15:28:21.282756,Desayunos · Típica,La Parrilla Dorada Polo,53900,6600,60500
11100,11101,21-10-2020 15:28:21.469019,Postres · Desayunos,KOKOA & co.,29500,4700,34200
11101,11102,21-10-2020 15:28:21.756061,Típica,Sabores De Mi Tierra,13600,5400,19000
11102,11103,21-10-2020 15:28:21.892313,Sushi,Sushi Reel,70000,4700,74700
11103,11104,21-10-2020 15:28:22.178663,Crepes,San Crepes,34500,4900,39400
11104,11105,21-10-2020 15:28:22.365566,Parrilla,Antojo a Domicilio,13600,5000,18600
11105,11106,21-10-2020 15:28:22.651869,Desayunos · Café,El Gualilo,24300,6200,30500
11106,11107,21-10-2020 15:28:22.938360,Saludable,Hanai - Bowls Saludables,24200,5900,30100
11107,11108,21-10-2020 15:28:23.125087,Pizza · Italiana,Pisapore - Pizza,27800,6600,34400
11108,11109,21-10-2020 15:28:23.261788,Pescados y Mariscos,Pescadero Héroes del Mar,15000,6600,21600
11109,11110,21-10-2020 15:28:23.548440,Postres · Panadería,RIGHT AWAY FOODS,35000,6600,41600
11110,11111,21-10-2020 15:28:23.684955,Saludable · Típica,Sopas Mrg,53900,3100,57000
11111,11112,21-10-2020 15:28:23.871044,Parrilla · Café,Figaro Café/ Restaurante Argentino,23000,5800,28800
11112,11113,21-10-2020 15:28:24.007159,Parrilla,Arepaisa de Medellín,11870,5600,17470
11113,11114,21-10-2020 15:28:24.144399,Sánduches · Pescados y Mariscos,Pacific Comida de Mar,24200,4000,28200
11114,11115,21-10-2020 15:28:24.480783,Saludable · Desayunos,Básico y Elemental,13600,5900,19500
11115,11116,21-10-2020 15:28:24.716767,Desayunos · Típica,La Parrilla Dorada Polo,23000,6600,29600
11116,11117,21-10-2020 15:28:25.053510,Típica · Parrilla,El Santandereano,37900,5200,43100
11117,11118,21-10-2020 15:28:25.189368,Típica,Sopitas y Más,15600,4200,19800
11118,11119,21-10-2020 15:28:25.375606,Panadería,Boul,35000,3100,38100
11119,11120,21-10-2020 15:28:25.612184,Saludable · Desayunos,Distrito Gourmet,17800,3700,21500
11120,11121,21-10-2020 15:28:25.848430,Postres · Panadería,RIGHT AWAY FOODS,37900,6600,44500
11121,11122,21-10-2020 15:28:25.984186,Desayunos · Parrilla,Mi Patria,37900,4600,42500
11122,11123,21-10-2020 15:28:26.320513,Desayunos · Típica,D'Porco - Lechona,23000,6300,29300
11123,11124,21-10-2020 15:28:26.506344,Asiática,Thai Station,27800,6000,33800
11124,11125,21-10-2020 15:28:26.842714,Desayunos · Típica,Casa Vieja,24200,6000,30200
11125,11126,21-10-2020 15:28:27.028340,Desayunos · Panadería,Choclofee,12500,4700,17200
11126,11127,21-10-2020 15:28:27.314364,Pollo · Desayunos,Caserito Gourmet,11870,6700,18570
11127,11128,21-10-2020 15:28:27.500229,Postres · Desayunos,Maltihelado,53400,4500,57900
11128,11129,21-10-2020 15:28:27.786562,Parrilla · Café,Figaro Café/ Restaurante Argentino,53400,5800,59200
11129,11130,21-10-2020 15:28:27.922548,Típica,Sabores De Mi Tierra,17800,5400,23200
11130,11131,21-10-2020 15:28:28.058377,Sushi,Sushi Reel,23000,4700,27700
11131,11132,21-10-2020 15:28:28.294338,Pollo · Sánduches,Pollos Century,37900,3000,40900
11132,11133,21-10-2020 15:28:28.580173,Desayunos · Jugos y Batidos,Frutiwow,18900,4100,23000
11133,11134,21-10-2020 15:28:28.966351,Saludable,Amor Propio saludable,70000,4000,74000
11134,11135,21-10-2020 15:28:29.203921,Saludable · Desayunos,Bon Eat - Saludable,31800,4800,36600
11135,11136,21-10-2020 15:28:29.589890,Típica,Sabrosito,23000,4000,27000
11136,11137,21-10-2020 15:28:29.776304,Saludable · Desayunos,Bon Eat - Saludable,53400,4800,58200
11137,11138,21-10-2020 15:28:30.062541,Mexicana,La leyenda mexican kitchen,13600,3200,16800
11138,11139,21-10-2020 15:28:30.348773,Asiática,TeT,24200,5900,30100
11139,11140,21-10-2020 15:28:30.584585,Desayunos · Sánduches,Garnish,17800,5200,23000
11140,11141,21-10-2020 15:28:30.820566,Pizza,pizza andante,31800,4200,36000
11141,11142,21-10-2020 15:28:31.207140,Desayunos · Típica,Rojo Gourmet,35000,4700,39700
11142,11143,21-10-2020 15:28:31.494155,Postres · Desayunos,Buñuelos nacho,53900,6600,60500
11143,11144,21-10-2020 15:28:31.631306,Mexicana,Mexicanachos,24200,3900,28100
11144,11145,21-10-2020 15:28:31.818415,Hamburguesas,Monchis - Hamburguesa,31800,4300,36100
11145,11146,21-10-2020 15:28:31.955244,Postres · Desayunos,KOKOA & co.,11870,4700,16570
11146,11147,21-10-2020 15:28:32.342241,Desayunos,Butter,27800,6700,34500
11147,11148,21-10-2020 15:28:32.578950,Desayunos · Panadería,Juliana Restaurante,48750,6100,54850
11148,11149,21-10-2020 15:28:32.915749,Saludable · Desayunos,Fresh Co,45800,5600,51400
11149,11150,21-10-2020 15:28:33.102873,Pizza · Italiana,Piatto - Pizza,10700,6600,17300
11150,11151,21-10-2020 15:28:33.490228,Saludable · Desayunos,La Estampilla,53900,6000,59900
11151,11152,21-10-2020 15:28:33.877291,Pizza,Pastas Laurentina,9000,4800,13800
11152,11153,21-10-2020 15:28:34.265599,Postres,Beiked,8900,4000,12900
11153,11154,21-10-2020 15:28:34.652697,Desayunos · Café,Moramia,13600,4700,18300
11154,11155,21-10-2020 15:28:34.839321,Desayunos · Panadería,Le Pain Quotidien,65000,3900,68900
11155,11156,21-10-2020 15:28:35.225841,Desayunos · Panadería,Juliana Restaurante,9000,6100,15100
11156,11157,21-10-2020 15:28:35.463051,Saludable,Hanai - Bowls Saludables,35000,5900,40900
11157,11158,21-10-2020 15:28:35.649305,Parrilla,Antojo a Domicilio,18900,5000,23900
11158,11159,21-10-2020 15:28:35.835906,Desayunos · Típica,Parrilla Farandula Típico,53400,5900,59300
11159,11160,21-10-2020 15:28:36.172174,Mexicana,Mexicanachos,53400,3900,57300
11160,11161,21-10-2020 15:28:36.509059,Mexicana,Hidalgo Taquería,34500,4900,39400
11161,11162,21-10-2020 15:28:36.795274,Crepes,La Chabatta,31800,5900,37700
11162,11163,21-10-2020 15:28:37.182188,Desayunos · Sánduches,Frutos del Bosque,37900,3500,41400
11163,11164,21-10-2020 15:28:37.376980,Sushi · Asiática,Tu Sushi,70000,6400,76400
11164,11165,21-10-2020 15:28:37.613992,Desayunos,Butter,15600,6700,22300
11165,11166,21-10-2020 15:28:38.000794,Parrilla,Carnes la Zarza,65000,4900,69900
11166,11167,21-10-2020 15:28:38.137496,Alta Cocina · Italiana,Trattoria de la Plaza,35000,6000,41000
11167,11168,21-10-2020 15:28:38.373405,Desayunos · Típica,90 Calentados,15000,3700,18700
11168,11169,21-10-2020 15:28:38.659295,Típica,Cazuelitas 93,15000,3900,18900
11169,11170,21-10-2020 15:28:38.795174,Desayunos · Sánduches,Frutos del Bosque,39700,3500,43200
11170,11171,21-10-2020 15:28:39.181244,Desayunos · Panadería,Premium Break Bakery,17800,3700,21500
11171,11172,21-10-2020 15:28:39.368404,Saludable,MIMA,17800,3700,21500
11172,11173,21-10-2020 15:28:39.604682,Asiática,TeT,53400,5900,59300
11173,11174,21-10-2020 15:28:39.890673,Desayunos · Típica,La Parrilla Dorada Polo,10700,6600,17300
11174,11175,21-10-2020 15:28:40.176802,Desayunos · Empanadas,Empanadas Doraditas.com,39700,3000,42700
11175,11176,21-10-2020 15:28:40.563277,Desayunos · Panadería,Ficchi Panadería,34500,3100,37600
11176,11177,21-10-2020 15:28:40.699565,Asiática,Thai Station,11870,6000,17870
11177,11178,21-10-2020 15:28:40.835306,Café · Helados,Sofia heladería y café,18900,5800,24700
11178,11179,21-10-2020 15:28:41.071384,Postres · Desayunos,Café Quindio,29500,5700,35200
11179,11180,21-10-2020 15:28:41.458078,Típica,El Cucharón - Tipica,65000,4400,69400
11180,11181,21-10-2020 15:28:41.594350,Saludable · Desayunos,Distrito Gourmet,37900,3700,41600
11181,11182,21-10-2020 15:28:41.980764,Pescados y Mariscos,Fish Place - Del Mar,48750,5400,54150
11182,11183,21-10-2020 15:28:42.366964,Pollo · Desayunos,Caserito Gourmet,35000,6700,41700
11183,11184,21-10-2020 15:28:42.502659,Desayunos,Sunny Breakfast Brunch,8900,4300,13200
11184,11185,21-10-2020 15:28:42.638474,Postres · Desayunos,Café Quindio,23000,5700,28700
11185,11186,21-10-2020 15:28:42.774295,Sushi,Umi,31800,5600,37400
11186,11187,21-10-2020 15:28:42.909953,Desayunos · Típica,Casa Vieja,13000,6000,19000
11187,11188,21-10-2020 15:28:43.045783,Café · Helados,Sofia heladería y café,23000,5800,28800
11188,11189,21-10-2020 15:28:43.332241,Saludable · Desayunos,Básico y Elemental,18900,5900,24800
11189,11190,21-10-2020 15:28:43.668347,Sushi,Sushi Reel,39700,4700,44400
11190,11191,21-10-2020 15:28:43.804433,Pizza,Pastas Laurentina,39700,4800,44500
11191,11192,21-10-2020 15:28:44.140603,Postres · Desayunos,Protein Bakes,24300,5900,30200
11192,11193,21-10-2020 15:28:44.477959,Desayunos · Café,El Gualilo,9000,6200,15200
11193,11194,21-10-2020 15:28:44.714160,Desayunos · Empanadas,Empanadas Doraditas.com,29500,3000,32500
11194,11195,21-10-2020 15:28:45.000121,Pizza,Pastas Laurentina,70000,4800,74800
11195,11196,21-10-2020 15:28:45.386422,Saludable · Desayunos,Básico y elemental,23000,5000,28000
11196,11197,21-10-2020 15:28:45.623001,Parrilla,Restaurante Bar Mi Ranchito,13600,5200,18800
11197,11198,21-10-2020 15:28:45.809087,Saludable · Desayunos,Malú,29500,3700,33200
11198,11199,21-10-2020 15:28:46.045584,Café · Helados,Sofia heladería y café,35000,5800,40800
11199,11200,21-10-2020 15:28:46.281804,Asiática,TeT,31800,5900,37700
11200,11201,21-10-2020 15:28:46.668223,Desayunos · Típica,La Frijolada,35000,4500,39500
11201,11202,21-10-2020 15:28:47.004551,Saludable · Desayunos,Bon Eat - Saludable,15000,4800,19800
11202,11203,21-10-2020 15:28:47.341303,Desayunos · Panadería,Decofruta,37900,4700,42600
11203,11204,21-10-2020 15:28:47.527282,Desayunos · Típica,Alce,12500,4900,17400
11204,11205,21-10-2020 15:28:47.713381,Desayunos,Archies Desayunos,24200,3100,27300
11205,11206,21-10-2020 15:28:47.949594,Desayunos · Mexicana,La Mera Mera - Mexicana,27800,3100,30900
11206,11207,21-10-2020 15:28:48.285538,Mexicana,Mexicanachos,70000,3900,73900
11207,11208,21-10-2020 15:28:48.421600,Desayunos · Típica,Alce,24300,4900,29200
11208,11209,21-10-2020 15:28:48.607576,Típica,Lo Nuestro,45800,3100,48900
11209,11210,21-10-2020 15:28:48.843698,Desayunos · Panadería,Premium Break Bakery,53900,3700,57600
11210,11211,21-10-2020 15:28:49.029915,Desayunos · Parrilla,Mi Patria,24300,4600,28900
11211,11212,21-10-2020 15:28:49.365827,Desayunos · Café,El Gualilo,15600,6200,21800
11212,11213,21-10-2020 15:28:49.703066,Típica · Parrilla,La Parilla de David,39700,3100,42800
11213,11214,21-10-2020 15:28:49.838919,Parrilla,Campocina,15600,4600,20200
11214,11215,21-10-2020 15:28:50.125179,Desayunos,La Frijolada Desayunos,37900,4400,42300
11215,11216,21-10-2020 15:28:50.361337,Típica,Bandejas Mrg,17800,3800,21600
11216,11217,21-10-2020 15:28:50.497030,Parrilla,Antojo a Domicilio,27800,5000,32800
11217,11218,21-10-2020 15:28:50.733538,Saludable · Desayunos,La Cesta,53900,4700,58600
11218,11219,21-10-2020 15:28:51.019462,Saludable · Jugos y Batidos,Berdes Drinks & Salads,35000,3500,38500
11219,11220,21-10-2020 15:28:51.205609,Sánduches · China,Peru Mix,12500,5900,18400
11220,11221,21-10-2020 15:28:51.492051,Parrilla · Internacional,Taperia de la Plaza,23000,5700,28700
11221,11222,21-10-2020 15:28:51.878488,Pollo,Señor Fantástico,15000,4700,19700
11222,11223,21-10-2020 15:28:52.164752,Típica,El Mondongo y Mucho Mas,53400,5600,59000
11223,11224,21-10-2020 15:28:52.501254,Desayunos,Archies Desayunos,12500,3100,15600
11224,11225,21-10-2020 15:28:52.787509,Peruana,Uma Cantina Peruana,9000,3200,12200
11225,11226,21-10-2020 15:28:53.073508,Postres · Desayunos,KOKOA & co.,48750,4700,53450
11226,11227,21-10-2020 15:28:53.259474,Típica,El Cucharón - Tipica,34500,4400,38900
11227,11228,21-10-2020 15:28:53.645946,Saludable,Ventura Soup y Salad,24200,3800,28000
11228,11229,21-10-2020 15:28:53.782148,Postres · Desayunos,La Folie - Postres,48750,3300,52050
11229,11230,21-10-2020 15:28:54.018228,Desayunos · Helados,San Giorgio Gelateria,23000,3100,26100
11230,11231,21-10-2020 15:28:54.254446,Perros Calientes,Dog Shop - Rapida,35000,4900,39900
11231,11232,21-10-2020 15:28:54.391162,Desayunos · Típica,La Parrilla Dorada Polo,12500,6600,19100
11232,11233,21-10-2020 15:28:54.577390,Sushi · Desayunos,Maki Roll,8900,4300,13200
11233,11234,21-10-2020 15:28:54.964480,Postres · Desayunos,Maria Luisa - Postres,23000,4300,27300
11234,11235,21-10-2020 15:28:55.100487,Desayunos · Sánduches,Danilo Colombia,65000,3300,68300
11235,11236,21-10-2020 15:28:55.236793,Pollo · China,China Tao,27800,3500,31300
11236,11237,21-10-2020 15:28:55.423239,Pizza · Parrilla,Urban Lunch,24300,4000,28300
11237,11238,21-10-2020 15:28:55.709688,Desayunos · Internacional,Camilia,31800,3900,35700
11238,11239,21-10-2020 15:28:55.845653,Postres · Helados,Mahé,7500,6000,13500
11239,11240,21-10-2020 15:28:56.132142,Típica · Pescados y Mariscos,La Vitualla,65000,6300,71300
11240,11241,21-10-2020 15:28:56.318737,Típica · Pescados y Mariscos,La Vitualla,13600,6300,19900
11241,11242,21-10-2020 15:28:56.605206,Pescados y Mariscos,La Gran Cazuela,18900,3200,22100
11242,11243,21-10-2020 15:28:56.941518,Postres · Desayunos,KOKOA & co.,9000,4700,13700
11243,11244,21-10-2020 15:28:57.178024,Desayunos,El Fogón Castellano,27800,3200,31000
11244,11245,21-10-2020 15:28:57.564548,Desayunos · Panadería,Artesanos,31800,4300,36100
11245,11246,21-10-2020 15:28:57.901552,Parrilla · Internacional,Taperia de la Plaza,65000,5700,70700
11246,11247,21-10-2020 15:28:58.238620,Desayunos · Sánduches,Danilo Colombia,23000,3300,26300
11247,11248,21-10-2020 15:28:58.524783,Desayunos · Sánduches,Danilo Colombia,45800,3300,49100
11248,11249,21-10-2020 15:28:58.661250,Pollo · Desayunos,Abasto,45800,3600,49400
11249,11250,21-10-2020 15:28:59.047948,Desayunos · Italiana,Rceta By Rausch,13600,3600,17200
11250,11251,21-10-2020 15:28:59.384362,Sushi,Umi,23000,5600,28600
11251,11252,21-10-2020 15:28:59.721159,Desayunos · Típica,Casa Vieja,35000,6000,41000
11252,11253,21-10-2020 15:28:59.957547,Postres · Desayunos,Jacques Pastelería,27800,5900,33700
11253,11254,21-10-2020 15:29:00.093544,Mexicana,Mexicanachos,34500,3900,38400
11254,11255,21-10-2020 15:29:00.279888,Desayunos,El Corral - Desayunos,70000,5000,75000
11255,11256,21-10-2020 15:29:00.666162,Asiática,TeT,53900,5900,59800
11256,11257,21-10-2020 15:29:01.002493,Desayunos · Típica,Rojo Gourmet,24200,4700,28900
11257,11258,21-10-2020 15:29:01.338617,Pollo · Desayunos,Caserito Gourmet,13600,6700,20300
11258,11259,21-10-2020 15:29:01.474773,Saludable · Desayunos,La Estampilla,34500,6000,40500
11259,11260,21-10-2020 15:29:01.860808,Saludable · Jugos y Batidos,Berdes Drinks & Salads,70000,3500,73500
11260,11261,21-10-2020 15:29:02.247181,Desayunos · Panadería,Juliana Restaurante,27800,6100,33900
11261,11262,21-10-2020 15:29:02.433231,Pollo · Desayunos,Abasto,9000,3600,12600
11262,11263,21-10-2020 15:29:02.669602,Desayunos · Típica,Desayunadero de la 42,29500,5900,35400
11263,11264,21-10-2020 15:29:02.955763,Poke,Poke Go,8900,4600,13500
11264,11265,21-10-2020 15:29:03.141956,Desayunos · Café,Moramia,37900,4700,42600
11265,11266,21-10-2020 15:29:03.528604,Hamburguesas · Saludable,Restaurant Inn,29500,6100,35600
11266,11267,21-10-2020 15:29:03.715000,Parrilla,Antojo a Domicilio,34500,5000,39500
11267,11268,21-10-2020 15:29:03.850918,Postres · Saludable,Ana Rebana,27800,6300,34100
11268,11269,21-10-2020 15:29:04.037295,Típica · Parrilla,Parrilla Farandula Gourmet,29500,5100,34600
11269,11270,21-10-2020 15:29:04.173312,Desayunos,El Fogón Castellano,17800,3200,21000
11270,11271,21-10-2020 15:29:04.559503,Parrilla · Café,Gaira Café,53900,4400,58300
11271,11272,21-10-2020 15:29:04.695659,Típica,La Herencia,35000,5900,40900
11272,11273,21-10-2020 15:29:04.981966,Sushi · Asiática,Arigato,35000,5300,40300
11273,11274,21-10-2020 15:29:05.319367,Desayunos · Jugos y Batidos,Dont Be Hungry,15000,5600,20600
11274,11275,21-10-2020 15:29:05.505781,Saludable · Desayunos,Raices Bienestar Gourmet,8900,6600,15500
11275,11276,21-10-2020 15:29:05.691902,Desayunos · Panadería,Siena Café,48750,3700,52450
11276,11277,21-10-2020 15:29:06.078312,Desayunos · Sánduches,Danilo Colombia,27800,3300,31100
11277,11278,21-10-2020 15:29:06.265051,Postres · Desayunos,Vivalight Market.,70000,6500,76500
11278,11279,21-10-2020 15:29:06.401180,Desayunos,El Corral - Desayunos,53900,5000,58900
11279,11280,21-10-2020 15:29:06.637438,Pollo · Desayunos,Piaf,12500,6500,19000
11280,11281,21-10-2020 15:29:06.823480,Desayunos,Jacinta Arepas de Huevo,15000,4000,19000
11281,11282,21-10-2020 15:29:06.959540,Desayunos · Panadería,Pasteleite,11870,5900,17770
11282,11283,21-10-2020 15:29:07.246063,Pollo · Pescados y Mariscos,Bang Bang Rice,23000,3400,26400
11283,11284,21-10-2020 15:29:07.532465,Desayunos,Bagel Shop,45800,3200,49000
11284,11285,21-10-2020 15:29:07.868848,Saludable · Desayunos,Bon Eat - Saludable,9000,4800,13800
11285,11286,21-10-2020 15:29:08.055082,Típica,Baondish,9000,5800,14800
11286,11287,21-10-2020 15:29:08.341603,Típica,Bendita S,23000,4600,27600
11287,11288,21-10-2020 15:29:08.528294,Saludable · Desayunos,Distrito Gourmet,31800,3700,35500
11288,11289,21-10-2020 15:29:08.864717,Desayunos · Jugos y Batidos,Kuriwaji,18900,6300,25200
11289,11290,21-10-2020 15:29:09.101028,Desayunos · Típica,Fogón Sangileño,70000,5000,75000
11290,11291,21-10-2020 15:29:09.487536,Desayunos · Parrilla,Mi Patria,11870,4600,16470
11291,11292,21-10-2020 15:29:09.723960,Saludable · Desayunos,Maracuyá,15000,6700,21700
11292,11293,21-10-2020 15:29:09.860311,Postres · Panadería,RIGHT AWAY FOODS,15600,6600,22200
11293,11294,21-10-2020 15:29:10.097157,Sushi,Kim Pop,24200,5400,29600
11294,11295,21-10-2020 15:29:10.384481,Típica,Sabrosito,31800,4000,35800
11295,11296,21-10-2020 15:29:10.670927,Desayunos · Café,Libertario Coffee Roasters,13600,4600,18200
11296,11297,21-10-2020 15:29:11.007457,Pollo,Chicken House,65000,4200,69200
11297,11298,21-10-2020 15:29:11.243714,Desayunos · Típica,Cochon,23000,3300,26300
11298,11299,21-10-2020 15:29:11.630568,Mexicana,Mexicanachos,35000,3900,38900
11299,11300,21-10-2020 15:29:11.967349,Saludable,Ventura Soup y Salad,12500,3800,16300
11300,11301,21-10-2020 15:29:12.353987,Desayunos · Panadería,El Pan de Phillippe,45800,4600,50400
11301,11302,21-10-2020 15:29:12.490600,Postres · Desayunos,Sweet Tale,45800,5800,51600
11302,11303,21-10-2020 15:29:12.727512,Típica,Sopitas y Más,29500,4200,33700
11303,11304,21-10-2020 15:29:12.963910,Pollo,Oliva Va,11870,5600,17470
11304,11305,21-10-2020 15:29:13.100108,Desayunos · Panadería,Decofruta,9000,4700,13700
11305,11306,21-10-2020 15:29:13.386376,Sushi,Canoa To Go,13600,5900,19500
11306,11307,21-10-2020 15:29:13.672569,Mexicana,Cantina La 15,9000,4300,13300
11307,11308,21-10-2020 15:29:13.808665,Saludable · Desayunos,Bon Eat - Saludable,13000,4800,17800
11308,11309,21-10-2020 15:29:14.044961,Parrilla · Café,Figaro Café/ Restaurante Argentino,12500,5800,18300
11309,11310,21-10-2020 15:29:14.281419,Postres · Desayunos,Buñuelos nacho,65000,6600,71600
11310,11311,21-10-2020 15:29:14.667917,Mexicana,Mexicanachos,65000,3900,68900
11311,11312,21-10-2020 15:29:15.054336,Hamburguesas,Bendito Cordero,13000,5800,18800
11312,11313,21-10-2020 15:29:15.340786,Postres · Desayunos,Maria Luisa - Postres,31800,4300,36100
11313,11314,21-10-2020 15:29:15.728314,Saludable · Desayunos,Malú,23000,3700,26700
11314,11315,21-10-2020 15:29:16.115225,Hamburguesas · Desayunos,El Inglés Gastro Pub,29500,6600,36100
11315,11316,21-10-2020 15:29:16.502131,Desayunos · Árabe,Boniato Sabores Vivos,15600,5300,20900
11316,11317,21-10-2020 15:29:16.689049,Helados,Buon Gelato,24300,4400,28700
11317,11318,21-10-2020 15:29:17.076005,Pollo,Heart & Cooking,35000,5000,40000
11318,11319,21-10-2020 15:29:17.362566,Postres,La Tertulia,23000,3400,26400
11319,11320,21-10-2020 15:29:17.699392,Saludable · Desayunos,Bon Eat - Saludable,35000,4800,39800
11320,11321,21-10-2020 15:29:17.886195,Hamburguesas · Pescados y Mariscos,El Velero,8900,6500,15400
11321,11322,21-10-2020 15:29:18.123148,Típica,La Olla de Barro,24300,5300,29600
11322,11323,21-10-2020 15:29:18.309898,Parrilla · Café,Figaro Café/ Restaurante Argentino,34500,5800,40300
11323,11324,21-10-2020 15:29:18.446276,Alta Cocina · Italiana,Trattoria de la Plaza,34500,6000,40500
11324,11325,21-10-2020 15:29:18.783114,Pizza,pizza andante,24300,4200,28500
11325,11326,21-10-2020 15:29:19.170153,Típica,Sopitas y Más,13000,4200,17200
11326,11327,21-10-2020 15:29:19.556954,Parrilla,OAK Ahumado y Brebajes,65000,6000,71000
11327,11328,21-10-2020 15:29:19.944060,Desayunos · Árabe,Boniato Sabores Vivos,70000,5300,75300
11328,11329,21-10-2020 15:29:20.230906,Pizza,Pizza Andante,10700,6300,17000
11329,11330,21-10-2020 15:29:20.367198,Desayunos · Mexicana,La Mera Mera - Mexicana,7500,3100,10600
11330,11331,21-10-2020 15:29:20.503843,Pescados y Mariscos,La Gran Cazuela,34500,3200,37700
11331,11332,21-10-2020 15:29:20.741290,Desayunos,Desayunos en Bogotá,18900,3400,22300
11332,11333,21-10-2020 15:29:21.027937,Italiana,F*cking Good Pizza,15600,4200,19800
11333,11334,21-10-2020 15:29:21.164465,Desayunos · Típica,Casa Vieja,24200,6000,30200
11334,11335,21-10-2020 15:29:21.501268,Parrilla · Café,Figaro Café/ Restaurante Argentino,39700,5800,45500
11335,11336,21-10-2020 15:29:21.787570,Desayunos · Típica,Calentao Express,15000,6000,21000
11336,11337,21-10-2020 15:29:22.174284,Parrilla,Rústico Picadería,45800,3800,49600
11337,11338,21-10-2020 15:29:22.311022,Desayunos · Típica,90 Calentados,53400,3700,57100
11338,11339,21-10-2020 15:29:22.597893,Saludable · Desayunos,Libre de Culpa,65000,4000,69000
11339,11340,21-10-2020 15:29:22.984835,Típica,Bendita S,35000,4600,39600
11340,11341,21-10-2020 15:29:23.121384,Parrilla,Arepaisa de Medellín,13600,5600,19200
11341,11342,21-10-2020 15:29:23.307908,Típica,Campo Victoria,39700,3000,42700
11342,11343,21-10-2020 15:29:23.445288,China,China Food Col,70000,3600,73600
11343,11344,21-10-2020 15:29:23.782346,Postres,La Tertulia,13000,3400,16400
11344,11345,21-10-2020 15:29:24.119265,Desayunos · Pescados y Mariscos,Luzí­a - Mediterranea,53400,5700,59100
11345,11346,21-10-2020 15:29:24.505986,Saludable · Desayunos,Libre de Culpa,27800,4000,31800
11346,11347,21-10-2020 15:29:24.892862,Postres,Toledo Pastelería,15000,6800,21800
11347,11348,21-10-2020 15:29:25.129407,Postres,Toledo Pastelería,35000,6800,41800
11348,11349,21-10-2020 15:29:25.315754,Sushi,Kim Pop,11870,5400,17270
11349,11350,21-10-2020 15:29:25.502299,Desayunos,Fratelli - Desayunos,39700,4600,44300
11350,11351,21-10-2020 15:29:25.689038,Mexicana,Cantina La 15,48750,4300,53050
11351,11352,21-10-2020 15:29:25.876575,Postres · Desayunos,Sweet Tale,27800,5800,33600
11352,11353,21-10-2020 15:29:26.013090,Típica · Parrilla,Parrilla Farandula Gourmet,37900,5100,43000
11353,11354,21-10-2020 15:29:26.249511,Desayunos · Jugos y Batidos,Kuriwaji,35000,6300,41300
11354,11355,21-10-2020 15:29:26.586204,Desayunos,El Corral - Desayunos,35000,5000,40000
11355,11356,21-10-2020 15:29:26.922963,Desayunos · Panadería,Decofruta,23000,4700,27700
11356,11357,21-10-2020 15:29:27.259860,Desayunos,Bagel Shop,53400,3200,56600
11357,11358,21-10-2020 15:29:27.546565,Hamburguesas,Gofi Burger,29500,5100,34600
11358,11359,21-10-2020 15:29:27.682914,Hamburguesas · Saludable,Restaurant Inn,11870,6100,17970
11359,11360,21-10-2020 15:29:28.069634,Saludable · Desayunos,Guadalupe - Fruteria,29500,5900,35400
11360,11361,21-10-2020 15:29:28.256158,Postres · Desayunos,Maltihelado,13600,4500,18100
11361,11362,21-10-2020 15:29:28.442886,Desayunos · Café,Norma's Ice Cream Café,13000,6300,19300
11362,11363,21-10-2020 15:29:28.629467,Postres · Desayunos,Maltihelado,35000,4500,39500
11363,11364,21-10-2020 15:29:28.966473,Típica,Salsig,10700,5600,16300
11364,11365,21-10-2020 15:29:29.353615,Desayunos · Típica,90 Calentados,13600,3700,17300
11365,11366,21-10-2020 15:29:29.590331,Postres · Desayunos,Vivalight Market.,11870,6500,18370
11366,11367,21-10-2020 15:29:29.977210,Desayunos · Típica,Fogón Sangileño,18900,5000,23900
11367,11368,21-10-2020 15:29:30.163909,Desayunos · Panadería,Limarys,70000,6500,76500
11368,11369,21-10-2020 15:29:30.500866,Pollo · China,China Tao,8900,3500,12400
11369,11370,21-10-2020 15:29:30.737440,Italiana,F*cking Good Pizza,37900,4200,42100
11370,11371,21-10-2020 15:29:31.124318,Mexicana,Mexicanachos,65000,3900,68900
11371,11372,21-10-2020 15:29:31.260946,Desayunos · Jugos y Batidos,Frutiwow,18900,4100,23000
11372,11373,21-10-2020 15:29:31.497470,Asiática,Thai Station,9000,6000,15000
11373,11374,21-10-2020 15:29:31.633859,Típica,La Herencia,17800,5900,23700
11374,11375,21-10-2020 15:29:31.820375,Saludable · Típica,Sopas Mrg,15600,3100,18700
11375,11376,21-10-2020 15:29:32.056763,Mexicana,Cantina La 15,13600,4300,17900
11376,11377,21-10-2020 15:29:32.344051,Saludable · Desayunos,La Estampilla,8900,6000,14900
11377,11378,21-10-2020 15:29:32.681041,Comida Rápida · Perros Calientes,Similoa - Comida Rapida,15000,3700,18700
11378,11379,21-10-2020 15:29:32.917964,Típica,Sabrosito,70000,4000,74000
11379,11380,21-10-2020 15:29:33.304660,Saludable · Típica,Saludable Mrg,53900,5800,59700
11380,11381,21-10-2020 15:29:33.591424,Desayunos · Típica,90 Calentados,24200,3700,27900
11381,11382,21-10-2020 15:29:33.878160,Postres · Desayunos,Maria Luisa - Postres,27800,4300,32100
11382,11383,21-10-2020 15:29:34.065052,Internacional,La Esquina con Sabor Parrilla,8900,3000,11900
11383,11384,21-10-2020 15:29:34.451763,Saludable · Desayunos,La Cesta,45800,4700,50500
11384,11385,21-10-2020 15:29:34.738278,Desayunos · Típica,Criollomania,10700,5200,15900
11385,11386,21-10-2020 15:29:35.024899,Postres · Desayunos,Sharmus,48750,6100,54850
11386,11387,21-10-2020 15:29:35.411891,Peruana,Masivo,37900,5800,43700
11387,11388,21-10-2020 15:29:35.648828,Saludable · Parrilla,Box,48750,3700,52450
11388,11389,21-10-2020 15:29:35.935527,Postres · Café,Loló Coffee & Snacks,24300,4600,28900
11389,11390,21-10-2020 15:29:36.223577,Desayunos · Jugos y Batidos,Dont Be Hungry,45800,5600,51400
11390,11391,21-10-2020 15:29:36.610447,Postres,La Tertulia,37900,3400,41300
11391,11392,21-10-2020 15:29:36.947241,Saludable · Típica,Sopas Mrg,27800,3100,30900
11392,11393,21-10-2020 15:29:37.334600,Típica,Lo Nuestro,65000,3100,68100
11393,11394,21-10-2020 15:29:37.671248,Desayunos · Árabe,Boniato Sabores Vivos,17800,5300,23100
11394,11395,21-10-2020 15:29:37.957806,Sushi,Canoa To Go,34500,5900,40400
11395,11396,21-10-2020 15:29:38.344626,Parrilla,Carnes la Zarza,37900,4900,42800
11396,11397,21-10-2020 15:29:38.481411,Pollo · Pescados y Mariscos,Bang Bang Rice,7500,3400,10900
11397,11398,21-10-2020 15:29:38.717833,Pollo · Desayunos,Abasto,29500,3600,33100
11398,11399,21-10-2020 15:29:39.104766,Hamburguesas,Monchis - Hamburguesa,13000,4300,17300
11399,11400,21-10-2020 15:29:39.441678,Típica · Parrilla,Parrilla Farandula Gourmet,7500,5100,12600
11400,11401,21-10-2020 15:29:39.578492,Sánduches · China,Peru Mix,13600,5900,19500
11401,11402,21-10-2020 15:29:39.865530,Desayunos,Bagel Shop,39700,3200,42900
11402,11403,21-10-2020 15:29:40.102456,Típica,Bandejas Mrg,15000,3800,18800
11403,11404,21-10-2020 15:29:40.439248,Desayunos · Típica,Calentao Express,65000,6000,71000
11404,11405,21-10-2020 15:29:40.726293,Sushi · Asiática,Tu Sushi,13000,6400,19400
11405,11406,21-10-2020 15:29:41.112884,Desayunos · Típica,90 Calentados,45800,3700,49500
11406,11407,21-10-2020 15:29:41.450836,Desayunos · Típica,Calentao Express,7500,6000,13500
11407,11408,21-10-2020 15:29:41.837658,Típica,La Olla de Barro,13000,5300,18300
11408,11409,21-10-2020 15:29:42.224639,Crepes,La Chabatta,15600,5900,21500
11409,11410,21-10-2020 15:29:42.411755,Desayunos · Sánduches,Garnish,24200,5200,29400
11410,11411,21-10-2020 15:29:42.598284,Típica · Pescados y Mariscos,La Vitualla,39700,6300,46000
11411,11412,21-10-2020 15:29:42.935146,Hamburguesas,Bendito Cordero,27800,5800,33600
11412,11413,21-10-2020 15:29:43.272013,Típica · Pescados y Mariscos,Arroces Mrg,11870,4300,16170
11413,11414,21-10-2020 15:29:43.459090,Pollo · Desayunos,Workzone,70000,3100,73100
11414,11415,21-10-2020 15:29:43.645925,Postres,La Tertulia,48750,3400,52150
11415,11416,21-10-2020 15:29:43.982672,Desayunos,El Fogón Castellano,35000,3200,38200
11416,11417,21-10-2020 15:29:44.369337,Parrilla,Arepaisa de Medellín,48750,5600,54350
11417,11418,21-10-2020 15:29:44.506081,Desayunos · Típica,La Parrilla Dorada Polo,17800,6600,24400
11418,11419,21-10-2020 15:29:44.892959,Desayunos,Señor Desayuno,12500,6800,19300
11419,11420,21-10-2020 15:29:45.230158,Desayunos · Mexicana,La Mera Mera - Mexicana,45800,3100,48900
11420,11421,21-10-2020 15:29:45.567208,Típica,Baondish,8900,5800,14700
11421,11422,21-10-2020 15:29:45.953791,Crepes,La Chabatta,13600,5900,19500
11422,11423,21-10-2020 15:29:46.190407,Saludable · Desayunos,Copacabana Açai Bowls,15000,3000,18000
11423,11424,21-10-2020 15:29:46.528375,Desayunos · Panadería,El Pan de Phillippe,13000,4600,17600
11424,11425,21-10-2020 15:29:46.765217,Desayunos · Panadería,Juliana Restaurante,12500,6100,18600
11425,11426,21-10-2020 15:29:46.951934,Desayunos,Archies Desayunos,7500,3100,10600
11426,11427,21-10-2020 15:29:47.138610,Típica · Pescados y Mariscos,Arroces Mrg,13000,4300,17300
11427,11428,21-10-2020 15:29:47.375579,Típica,El Mondongo y Mucho Mas,37900,5600,43500
11428,11429,21-10-2020 15:29:47.662247,Desayunos · Panadería,El Pan de Phillippe,13000,4600,17600
11429,11430,21-10-2020 15:29:47.948814,Saludable · Desayunos,Malú,17800,3700,21500
11430,11431,21-10-2020 15:29:48.285651,Desayunos,El Corral - Desayunos,70000,5000,75000
11431,11432,21-10-2020 15:29:48.622643,Postres · Desayunos,BagBog Bagels,9000,6400,15400
11432,11433,21-10-2020 15:29:48.959246,Saludable,MIMA,45800,3700,49500
11433,11434,21-10-2020 15:29:49.346377,Postres · Desayunos,Maltihelados,11870,6200,18070
11434,11435,21-10-2020 15:29:49.483060,Pizza · Italiana,Piatto - Pizza,70000,6600,76600
11435,11436,21-10-2020 15:29:49.719776,Desayunos · Típica,Rojo Gourmet,45800,4700,50500
11436,11437,21-10-2020 15:29:49.856464,Desayunos · Jugos y Batidos,Frutiwow,10700,4100,14800
11437,11438,21-10-2020 15:29:49.992900,Pollo,Oliva Va,35000,5600,40600
11438,11439,21-10-2020 15:29:50.279804,Desayunos · Panadería,Ficchi Panadería,18900,3100,22000
11439,11440,21-10-2020 15:29:50.616721,Postres · Desayunos,Sharmus,53900,6100,60000
11440,11441,21-10-2020 15:29:50.903629,Saludable,Amor Propio saludable,11870,4000,15870
11441,11442,21-10-2020 15:29:51.140498,Desayunos · Típica,Parrilla Farandula Típico,37900,5900,43800
11442,11443,21-10-2020 15:29:51.428063,Postres · Panadería,RIGHT AWAY FOODS,39700,6600,46300
11443,11444,21-10-2020 15:29:51.816324,Postres · Desayunos,Maltihelados,53900,6200,60100
11444,11445,21-10-2020 15:29:52.153320,Pollo · Saludable,Tremenda Sal y Dulce,15600,6500,22100
11445,11446,21-10-2020 15:29:52.340048,Desayunos · Parrilla,Mi Patria,23000,4600,27600
11446,11447,21-10-2020 15:29:52.476693,Postres · Café,Celestino Café,53400,5900,59300
11447,11448,21-10-2020 15:29:52.713566,Postres · Desayunos,Sweet Tale,65000,5800,70800
11448,11449,21-10-2020 15:29:53.000072,Desayunos · Parrilla,Mi Patria,27800,4600,32400
11449,11450,21-10-2020 15:29:53.337301,Desayunos · Comida Rápida,Chocolatto,35000,3400,38400
11450,11451,21-10-2020 15:29:53.624587,Desayunos · Panadería,Santa Juana Food Bar,18900,5900,24800
11451,11452,21-10-2020 15:29:53.911779,Desayunos · Comida Rápida,La Veneca,7500,6300,13800
11452,11453,21-10-2020 15:29:54.249316,Postres · Desayunos,Gelateria Da Favola,48750,6500,55250
11453,11454,21-10-2020 15:29:54.435999,Postres · Panadería,RIGHT AWAY FOODS,35000,6600,41600
11454,11455,21-10-2020 15:29:54.572634,Saludable · Desayunos,Bawana - Sandwich,23000,3400,26400
11455,11456,21-10-2020 15:29:54.959553,Saludable · Desayunos,Bon Eat - Saludable,53900,4800,58700
11456,11457,21-10-2020 15:29:55.346569,Saludable · Desayunos,Raices Bienestar Gourmet,13000,6600,19600
11457,11458,21-10-2020 15:29:55.683311,Típica,La Olla de Barro,29500,5300,34800
11458,11459,21-10-2020 15:29:56.020159,Pizza,Pastas Laurentina,39700,4800,44500
11459,11460,21-10-2020 15:29:56.407377,Pollo · Sánduches,Pollos Century,9000,3000,12000
11460,11461,21-10-2020 15:29:56.644202,Postres · Desayunos,Cosmo Cookies,23000,5900,28900
11461,11462,21-10-2020 15:29:56.982135,Postres · Desayunos,Sharmus,17800,6100,23900
11462,11463,21-10-2020 15:29:57.369176,Saludable · Desayunos,Libre de Culpa,13600,4000,17600
11463,11464,21-10-2020 15:29:57.555956,Saludable · Desayunos,La Cesta,35000,4700,39700
11464,11465,21-10-2020 15:29:57.843168,Saludable · Jugos y Batidos,Berdes Drinks & Salads,15600,3500,19100
11465,11466,21-10-2020 15:29:58.179686,Saludable · Desayunos,Básico y elemental,53900,5000,58900
11466,11467,21-10-2020 15:29:58.566912,Típica · Parrilla,Typykos,23000,6000,29000
11467,11468,21-10-2020 15:29:58.753479,Pollo · Desayunos,Candelina,39700,5300,45000
11468,11469,21-10-2020 15:29:58.940135,Desayunos · Café,Frambas,39700,3400,43100
11469,11470,21-10-2020 15:29:59.277516,Desayunos · Jugos y Batidos,Dont Be Hungry,35000,5600,40600
11470,11471,21-10-2020 15:29:59.564742,Saludable · Desayunos,Básico y Elemental,35000,5900,40900
11471,11472,21-10-2020 15:29:59.851381,Desayunos · Café,Libertario Coffee Roasters,27800,4600,32400
11472,11473,21-10-2020 15:30:00.238668,Internacional,La Esquina con Sabor Parrilla,27800,3000,30800
11473,11474,21-10-2020 15:30:00.525574,Postres · Desayunos,Sharmus,13600,6100,19700
11474,11475,21-10-2020 15:30:00.812203,Saludable,Puro Verde,23000,5700,28700
11475,11476,21-10-2020 15:30:01.199305,Saludable · Desayunos,La Cesta,24300,4700,29000
11476,11477,21-10-2020 15:30:01.386203,Desayunos · Panadería,Limarys,29500,6500,36000
11477,11478,21-10-2020 15:30:01.673364,Desayunos,Archies Desayunos,15000,3100,18100
11478,11479,21-10-2020 15:30:01.960202,Típica,El Cucharón - Tipica,17800,4400,22200
11479,11480,21-10-2020 15:30:02.198364,Típica,Bendita S,23000,4600,27600
11480,11481,21-10-2020 15:30:02.535796,Saludable · Desayunos,Básico y Elemental,13600,5900,19500
11481,11482,21-10-2020 15:30:02.773376,Desayunos · Panadería,Decofruta,15000,4700,19700
11482,11483,21-10-2020 15:30:03.160597,Pollo · China,China Tao,37900,3500,41400
11483,11484,21-10-2020 15:30:03.298017,Postres · Desayunos,KOKOA & co.,24300,4700,29000
11484,11485,21-10-2020 15:30:03.685391,Postres,Beiked,31800,4000,35800
11485,11486,21-10-2020 15:30:04.072597,Desayunos · Panadería,Santa Juana Food Bar,12500,5900,18400
11486,11487,21-10-2020 15:30:04.459952,Saludable,MIMA,13600,3700,17300
11487,11488,21-10-2020 15:30:04.647172,Típica,Campo Victoria,48750,3000,51750
11488,11489,21-10-2020 15:30:04.784153,Italiana,F*cking Good Pizza,13600,4200,17800
11489,11490,21-10-2020 15:30:05.171172,Desayunos · Típica,Peninsula Calentados y Parrilla,53400,3400,56800
11490,11491,21-10-2020 15:30:05.308055,Hamburguesas,Burger Society,45800,4100,49900
11491,11492,21-10-2020 15:30:05.545037,Típica · Parrilla,Toya,15600,4200,19800
11492,11493,21-10-2020 15:30:05.681682,Desayunos,Sunny Breakfast Brunch,53900,4300,58200
11493,11494,21-10-2020 15:30:05.868633,Pizza,Pastas Laurentina,23000,4800,27800
11494,11495,21-10-2020 15:30:06.056789,China,China Food Col,34500,3600,38100
11495,11496,21-10-2020 15:30:06.394023,Peruana · Internacional,La Chifería,12500,6600,19100
11496,11497,21-10-2020 15:30:06.531099,Hamburguesas · Saludable,Restaurant Inn,24200,6100,30300
11497,11498,21-10-2020 15:30:06.918247,Pollo · Pescados y Mariscos,Bang Bang Rice,31800,3400,35200
11498,11499,21-10-2020 15:30:07.206221,Alta Cocina · Postres,La Pinta,15000,4500,19500
11499,11500,21-10-2020 15:30:07.393225,Desayunos · Típica,90 Calentados,34500,3700,38200
11500,11501,21-10-2020 15:30:07.630873,Pollo · Desayunos,Candelina,11870,5300,17170
11501,11502,21-10-2020 15:30:07.968310,Saludable · Desayunos,Bawana - Sandwich,17800,3400,21200
11502,11503,21-10-2020 15:30:08.105679,Desayunos · Sánduches,Danilo Colombia,13600,3300,16900
11503,11504,21-10-2020 15:30:08.393081,Postres · Desayunos,BagBog Bagels,29500,6400,35900
11504,11505,21-10-2020 15:30:08.579914,Italiana,Bocatto Di Passo,15000,5000,20000
11505,11506,21-10-2020 15:30:08.916971,Típica · Pescados y Mariscos,Arroces Mrg,37900,4300,42200
11506,11507,21-10-2020 15:30:09.103872,Desayunos,Fratelli - Desayunos,34500,4600,39100
11507,11508,21-10-2020 15:30:09.391051,Sushi,Umi,24300,5600,29900
11508,11509,21-10-2020 15:30:09.578058,Desayunos,Desayunos en Bogotá,24200,3400,27600
11509,11510,21-10-2020 15:30:09.915321,Sánduches · China,Peru Mix,18900,5900,24800
11510,11511,21-10-2020 15:30:10.253406,Típica,Campo Victoria,27800,3000,30800
11511,11512,21-10-2020 15:30:10.440562,Postres · Desayunos,Aury Postres - Comidas & Picadas,15000,4700,19700
11512,11513,21-10-2020 15:30:10.777722,Peruana,Uma Cantina Peruana,10700,3200,13900
11513,11514,21-10-2020 15:30:10.914411,Desayunos · Panadería,Decofruta,53900,4700,58600
11514,11515,21-10-2020 15:30:11.101238,Pollo,Chicken House,65000,4200,69200
11515,11516,21-10-2020 15:30:11.438446,Típica,Cazuelitas 93,23000,3900,26900
11516,11517,21-10-2020 15:30:11.775852,Típica,El Cucharón - Tipica,17800,4400,22200
11517,11518,21-10-2020 15:30:11.963099,Desayunos · Comida Rápida,Chocolatto,70000,3400,73400
11518,11519,21-10-2020 15:30:12.200874,Desayunos,Cafetería el Kippe,18900,3200,22100
11519,11520,21-10-2020 15:30:12.489057,Desayunos · Comida Rápida,La Veneca,12500,6300,18800
11520,11521,21-10-2020 15:30:12.675781,Postres · Desayunos,Restaurante Cornelia,24200,5500,29700
11521,11522,21-10-2020 15:30:13.063148,Postres · Desayunos,Buñuelos nacho,15000,6600,21600
11522,11523,21-10-2020 15:30:13.451033,Desayunos,Fratelli - Desayunos,24200,4600,28800
11523,11524,21-10-2020 15:30:13.838580,Pollo,Oliva Va,7500,5600,13100
11524,11525,21-10-2020 15:30:14.126210,Postres · Desayunos,Restaurante Cornelia,11870,5500,17370
11525,11526,21-10-2020 15:30:14.413495,Desayunos · Panadería,Siena Café,53400,3700,57100
11526,11527,21-10-2020 15:30:14.600572,Desayunos,Jacinta Arepas de Huevo,27800,4000,31800
11527,11528,21-10-2020 15:30:14.987619,Sánduches,Submarin,8900,3800,12700
11528,11529,21-10-2020 15:30:15.374857,Postres · Desayunos,La Folie - Postres,65000,3300,68300
11529,11530,21-10-2020 15:30:15.511636,Típica,Carbón & Mondongos,18900,6400,25300
11530,11531,21-10-2020 15:30:15.698987,Saludable · Desayunos,Básico y elemental,13000,5000,18000
11531,11532,21-10-2020 15:30:16.087187,Desayunos,Archies Desayunos,23000,3100,26100
11532,11533,21-10-2020 15:30:16.325235,Sánduches · Pescados y Mariscos,Pacific Comida de Mar,23000,4000,27000
11533,11534,21-10-2020 15:30:16.463090,Típica,La Herencia,35000,5900,40900
11534,11535,21-10-2020 15:30:16.800662,Pollo · Sánduches,Pollos Century,8900,3000,11900
11535,11536,21-10-2020 15:30:17.037867,Pollo,Heart & Cooking,65000,5000,70000
11536,11537,21-10-2020 15:30:17.225572,Desayunos · Panadería,Santa Juana Food Bar,24300,5900,30200
11537,11538,21-10-2020 15:30:17.614125,Peruana,Masivo,35000,5800,40800
11538,11539,21-10-2020 15:30:17.751260,Desayunos,Sunny Breakfast Brunch,45800,4300,50100
11539,11540,21-10-2020 15:30:18.088353,Saludable · Parrilla,The Angels Grill and Drinks,24200,6200,30400
11540,11541,21-10-2020 15:30:18.325663,Desayunos · Parrilla,Mi Patria,11870,4600,16470
11541,11542,21-10-2020 15:30:18.713444,Desayunos,Cafetería el Kippe,11870,3200,15070
11542,11543,21-10-2020 15:30:18.900717,Saludable · Desayunos,Libre de Culpa,29500,4000,33500
11543,11544,21-10-2020 15:30:19.187977,Desayunos · Típica,Peninsula Calentados y Parrilla,24300,3400,27700
11544,11545,21-10-2020 15:30:19.575835,Saludable · Desayunos,La Cesta,13600,4700,18300
11545,11546,21-10-2020 15:30:19.963626,Hamburguesas · Saludable,Restaurant Inn,18900,6100,25000
11546,11547,21-10-2020 15:30:20.350871,Jugos y Batidos,Pomponio,27800,3600,31400
11547,11548,21-10-2020 15:30:20.587908,Hamburguesas,Monchis - Hamburguesa,37900,4300,42200
11548,11549,21-10-2020 15:30:20.725097,Postres · Desayunos,Restaurante Cornelia,10700,5500,16200
11549,11550,21-10-2020 15:30:21.062413,Postres · Desayunos,Cosmo Cookies,53900,5900,59800
11550,11551,21-10-2020 15:30:21.349755,Típica · Parrilla,Mi Ranchito Parrilla,8900,4400,13300
11551,11552,21-10-2020 15:30:21.687430,Saludable · Desayunos,Bawana - Sandwich,23000,3400,26400
11552,11553,21-10-2020 15:30:22.074978,Desayunos · Típica,Casa Vieja,17800,6000,23800
11553,11554,21-10-2020 15:30:22.462332,China,China Food Col,13600,3600,17200
11554,11555,21-10-2020 15:30:22.800766,Desayunos · Empanadas,Empanadas Doraditas.com,23000,3000,26000
11555,11556,21-10-2020 15:30:23.037801,Típica,La Cocina,9000,4600,13600
11556,11557,21-10-2020 15:30:23.174751,Sánduches · Pescados y Mariscos,Pacific Comida de Mar,12500,4000,16500
11557,11558,21-10-2020 15:30:23.361682,Desayunos,Cafetería el Kippe,45800,3200,49000
11558,11559,21-10-2020 15:30:23.699382,Típica · Pescados y Mariscos,La Vitualla,17800,6300,24100
11559,11560,21-10-2020 15:30:24.037041,Italiana,Bocatto Di Passo,65000,5000,70000
11560,11561,21-10-2020 15:30:24.274688,Postres · Desayunos,Maltihelados,11870,6200,18070
11561,11562,21-10-2020 15:30:24.461976,Postres · Desayunos,Maria Luisa - Postres,10700,4300,15000
11562,11563,21-10-2020 15:30:24.799242,Postres,Toledo Pastelería,39700,6800,46500
11563,11564,21-10-2020 15:30:25.086586,Parrilla,Restaurante Bar Mi Ranchito,39700,5200,44900
11564,11565,21-10-2020 15:30:25.273971,Desayunos · Típica,La Frijolada,15000,4500,19500
11565,11566,21-10-2020 15:30:25.511145,Peruana · Internacional,La Chifería,17800,6600,24400
11566,11567,21-10-2020 15:30:25.698392,Hamburguesas · Alitas,Beer,24200,6600,30800
11567,11568,21-10-2020 15:30:25.885710,Pizza,Pizza Andante,24200,6300,30500
11568,11569,21-10-2020 15:30:26.122945,Desayunos · Café,vereda central calle 99,18900,5700,24600
11569,11570,21-10-2020 15:30:26.460360,Pollo,Chicken House,53900,4200,58100
11570,11571,21-10-2020 15:30:26.647563,Desayunos · Sánduches,Garnish,70000,5200,75200
11571,11572,21-10-2020 15:30:26.984683,Pollo,Señor Fantástico,45800,4700,50500
11572,11573,21-10-2020 15:30:27.171615,Postres · Saludable,Ana Rebana,48750,6300,55050
11573,11574,21-10-2020 15:30:27.458869,Postres · Desayunos,KOKOA & co.,35000,4700,39700
11574,11575,21-10-2020 15:30:27.595999,Postres · Desayunos,Protein Bakes,10700,5900,16600
11575,11576,21-10-2020 15:30:27.733439,Desayunos · Parrilla,Mi Patria,18900,4600,23500
11576,11577,21-10-2020 15:30:27.871124,Hamburguesas · Desayunos,El Inglés Gastro Pub,10700,6600,17300
11577,11578,21-10-2020 15:30:28.058341,Italiana,F*cking Good Pizza,35000,4200,39200
11578,11579,21-10-2020 15:30:28.445816,Café · Helados,Sofia heladería y café,15000,5800,20800
11579,11580,21-10-2020 15:30:28.833294,Típica · Pescados y Mariscos,Arroces Mrg,12500,4300,16800
11580,11581,21-10-2020 15:30:29.170533,Postres · Desayunos,La Folie - Postres,27800,3300,31100
11581,11582,21-10-2020 15:30:29.557902,Desayunos,Bagel Shop,35000,3200,38200
11582,11583,21-10-2020 15:30:29.895602,Saludable · Desayunos,Fresh Co,23000,5600,28600
11583,11584,21-10-2020 15:30:30.082693,Típica · Parrilla,La Parilla de David,18900,3100,22000
11584,11585,21-10-2020 15:30:30.420709,Pescados y Mariscos,La Gran Cazuela,12500,3200,15700
11585,11586,21-10-2020 15:30:30.658052,Parrilla · Café,Gaira Café,35000,4400,39400
11586,11587,21-10-2020 15:30:30.845464,Desayunos · Mexicana,La Mera Mera - Mexicana,23000,3100,26100
11587,11588,21-10-2020 15:30:31.182732,Parrilla · Café,Gaira Café,15600,4400,20000
11588,11589,21-10-2020 15:30:31.319991,Saludable,Hanai - Bowls Saludables,8900,5900,14800
11589,11590,21-10-2020 15:30:31.707671,Desayunos · Panadería,Siena Café,48750,3700,52450
11590,11591,21-10-2020 15:30:32.045488,Comida Rápida,Fiesta Digital Andrés,24300,3100,27400
11591,11592,21-10-2020 15:30:32.432824,Saludable · Desayunos,Malú,70000,3700,73700
11592,11593,21-10-2020 15:30:32.720356,Comida Rápida,Fiesta Digital Andrés,34500,3100,37600
11593,11594,21-10-2020 15:30:32.857576,Típica · Parrilla,Mi Ranchito Parrilla,65000,4400,69400
11594,11595,21-10-2020 15:30:32.996128,Saludable · Desayunos,Libre de Culpa,37900,4000,41900
11595,11596,21-10-2020 15:30:33.383638,Típica · Parrilla,Parrilla Farandula Gourmet,17800,5100,22900
11596,11597,21-10-2020 15:30:33.521057,Desayunos,Desayunos en Bogotá,35000,3400,38400
11597,11598,21-10-2020 15:30:33.858821,Desayunos · Café,Aromacafé el Placer de Compartir,23000,5000,28000
11598,11599,21-10-2020 15:30:34.096340,Desayunos · Empanadas,Mis Delicias,53900,3200,57100
11599,11600,21-10-2020 15:30:34.384072,Mexicana,La leyenda mexican kitchen,35000,3200,38200
11600,11601,21-10-2020 15:30:34.521765,Postres · Panadería,RIGHT AWAY FOODS,13600,6600,20200
11601,11602,21-10-2020 15:30:34.759572,Parrilla,Coquitas,10700,5600,16300
11602,11603,21-10-2020 15:30:35.147791,Desayunos · Pescados y Mariscos,Luzí­a - Mediterranea,35000,5700,40700
11603,11604,21-10-2020 15:30:35.384880,Típica · Parrilla,El Portal de la Antigua,29500,5600,35100
11604,11605,21-10-2020 15:30:35.722406,Típica,Sabores De Mi Tierra,23000,5400,28400
11605,11606,21-10-2020 15:30:35.909631,Peruana,Masivo,17800,5800,23600
11606,11607,21-10-2020 15:30:36.247488,Pollo · China,China Tao,10700,3500,14200
11607,11608,21-10-2020 15:30:36.585159,Sánduches,Submarin,9000,3800,12800
11608,11609,21-10-2020 15:30:36.822590,Desayunos,Don Leo,24300,6000,30300
11609,11610,21-10-2020 15:30:37.110868,Pollo · Desayunos,Workzone,23000,3100,26100
11610,11611,21-10-2020 15:30:37.449511,Parrilla · Café,Gaira Café,65000,4400,69400
11611,11612,21-10-2020 15:30:37.637743,Típica,Carbón & Mondongos,10700,6400,17100
11612,11613,21-10-2020 15:30:37.775857,Desayunos · Café,Matchacha,39700,5900,45600
11613,11614,21-10-2020 15:30:38.065041,Saludable · Desayunos,Raices Bienestar Gourmet,70000,6600,76600
11614,11615,21-10-2020 15:30:38.353009,Desayunos,El Corral - Desayunos,23000,5000,28000
11615,11616,21-10-2020 15:30:38.490878,Parrilla,Coquitas,10700,5600,16300
11616,11617,21-10-2020 15:30:38.879001,Desayunos · Panadería,Le Pain Quotidien,24200,3900,28100
11617,11618,21-10-2020 15:30:39.066601,Típica,Sopitas y Más,29500,4200,33700
11618,11619,21-10-2020 15:30:39.404469,Saludable · Desayunos,La Cesta,53900,4700,58600
11619,11620,21-10-2020 15:30:39.792296,Típica,El Cucharón - Tipica,48750,4400,53150
11620,11621,21-10-2020 15:30:39.929879,Postres · Desayunos,Sharmus,15000,6100,21100
11621,11622,21-10-2020 15:30:40.267076,Parrilla,Parrilla Pimentón,7500,3400,10900
11622,11623,21-10-2020 15:30:40.604817,Desayunos · Típica,Desayunadero de la 42,23000,5900,28900
11623,11624,21-10-2020 15:30:40.741926,Desayunos · Café,El Gualilo,29500,6200,35700
11624,11625,21-10-2020 15:30:40.979330,Hamburguesas · Panadería,NYC Burgers,11870,6200,18070
11625,11626,21-10-2020 15:30:41.267124,Desayunos · Mexicana,La Mera Mera - Mexicana,39700,3100,42800
11626,11627,21-10-2020 15:30:41.455225,Pollo · Saludable,Gratina,8900,4200,13100
11627,11628,21-10-2020 15:30:41.593256,Hamburguesas · Pescados y Mariscos,El Velero,37900,6500,44400
11628,11629,21-10-2020 15:30:41.731095,Parrilla · Café,Gaira Café,12500,4400,16900
11629,11630,21-10-2020 15:30:42.118580,Pollo · Típica,Auyama,39700,3900,43600
11630,11631,21-10-2020 15:30:42.305985,Desayunos,El Fogón Castellano,65000,3200,68200
11631,11632,21-10-2020 15:30:42.643432,Desayunos · Café,Frambas,35000,3400,38400
11632,11633,21-10-2020 15:30:42.980907,Hamburguesas · Alitas,Beer,13000,6600,19600
11633,11634,21-10-2020 15:30:43.269606,Panadería,Boul,17800,3100,20900
11634,11635,21-10-2020 15:30:43.557199,Desayunos · Panadería,Premium Break Bakery,70000,3700,73700
11635,11636,21-10-2020 15:30:43.694380,Saludable · Desayunos,Distrito Gourmet,13600,3700,17300
11636,11637,21-10-2020 15:30:43.881554,Postres · Saludable,Ana Rebana,48750,6300,55050
11637,11638,21-10-2020 15:30:44.269035,Pollo,Heart & Cooking,34500,5000,39500
11638,11639,21-10-2020 15:30:44.656443,Típica · Parrilla,El Portal de la Antigua,18900,5600,24500
11639,11640,21-10-2020 15:30:44.943798,Pollo · Desayunos,Workzone,37900,3100,41000
11640,11641,21-10-2020 15:30:45.181448,Típica,La Cocina,10700,4600,15300
11641,11642,21-10-2020 15:30:45.568983,Parrilla,Restaurante Bar Mi Ranchito,15600,5200,20800
11642,11643,21-10-2020 15:30:45.856324,Postres · Desayunos,Restaurante Cornelia,24300,5500,29800
11643,11644,21-10-2020 15:30:46.193677,Saludable · Jugos y Batidos,Berdes Drinks & Salads,31800,3500,35300
11644,11645,21-10-2020 15:30:46.380888,Pollo · Desayunos,Caserito Gourmet,10700,6700,17400
11645,11646,21-10-2020 15:30:46.618223,Postres · Desayunos,Maria Luisa - Postres,18900,4300,23200
11646,11647,21-10-2020 15:30:46.905582,Típica · Parrilla,Mi Ranchito Parrilla,23000,4400,27400
11647,11648,21-10-2020 15:30:47.092668,Alta Cocina · Parrilla,Criterión,53900,6000,59900
11648,11649,21-10-2020 15:30:47.280373,Pizza,Pastas Laurentina,7500,4800,12300
11649,11650,21-10-2020 15:30:47.517691,Típica,Sabores De Mi Tierra,65000,5400,70400
11650,11651,21-10-2020 15:30:47.705068,Saludable · Típica,Saludable Mrg,23000,5800,28800
11651,11652,21-10-2020 15:30:47.892170,Parrilla,El Tambor,70000,6800,76800
11652,11653,21-10-2020 15:30:48.029562,Típica,Salsig,31800,5600,37400
11653,11654,21-10-2020 15:30:48.167050,Poke,Poke Go,35000,4600,39600
11654,11655,21-10-2020 15:30:48.405643,Desayunos,El Corral - Desayunos,15600,5000,20600
11655,11656,21-10-2020 15:30:48.592863,Postres · Desayunos,Sweet Tale,24200,5800,30000
11656,11657,21-10-2020 15:30:48.780106,Postres,Levelma,48750,6200,54950
11657,11658,21-10-2020 15:30:48.967270,Parrilla · Internacional,Taperia de la Plaza,12500,5700,18200
11658,11659,21-10-2020 15:30:49.354942,Sánduches,Submarin,27800,3800,31600
11659,11660,21-10-2020 15:30:49.742428,Saludable · Desayunos,La Cesta,24300,4700,29000
11660,11661,21-10-2020 15:30:50.130084,Sushi,Canoa To Go,15000,5900,20900
11661,11662,21-10-2020 15:30:50.467961,Desayunos,Don Leo,10700,6000,16700
11662,11663,21-10-2020 15:30:50.855721,Pizza,Pastas Laurentina,17800,4800,22600
11663,11664,21-10-2020 15:30:51.193019,Desayunos · Panadería,El Pan de Phillippe,13600,4600,18200
11664,11665,21-10-2020 15:30:51.480664,Pizza · Italiana,Piatto - Pizza,48750,6600,55350
11665,11666,21-10-2020 15:30:51.618193,Típica · Parrilla,La Parilla de David,12500,3100,15600
11666,11667,21-10-2020 15:30:51.755374,Saludable · Desayunos,Bawana - Sandwich,8900,3400,12300
11667,11668,21-10-2020 15:30:51.942450,Pizza,18 Scalini,37900,4300,42200
11668,11669,21-10-2020 15:30:52.179623,Saludable · Desayunos,La Cesta,11870,4700,16570
11669,11670,21-10-2020 15:30:52.566967,Desayunos · Café,Frambas,13000,3400,16400
11670,11671,21-10-2020 15:30:52.704362,Parrilla,Rústico Picadería,53900,3800,57700
11671,11672,21-10-2020 15:30:52.991905,Pollo · Desayunos,Piaf,13600,6500,20100
11672,11673,21-10-2020 15:30:53.329429,Alta Cocina · Postres,La Pinta,7500,4500,12000
11673,11674,21-10-2020 15:30:53.618181,Saludable · Desayunos,Raices Bienestar Gourmet,15600,6600,22200
11674,11675,21-10-2020 15:30:54.005868,Hamburguesas,Bendito Cordero,11870,5800,17670
11675,11676,21-10-2020 15:30:54.393793,Desayunos · Típica,D´Porco,70000,3900,73900
11676,11677,21-10-2020 15:30:54.731288,Desayunos,Desayunos en Bogotá,39700,3400,43100
11677,11678,21-10-2020 15:30:55.018659,Saludable · Desayunos,Copacabana Açai Bowls,8900,3000,11900
11678,11679,21-10-2020 15:30:55.156276,Pollo · Desayunos,Candelina,15000,5300,20300
11679,11680,21-10-2020 15:30:55.452739,Pizza · Parrilla,Urban Lunch,12500,4000,16500
11680,11681,21-10-2020 15:30:55.590008,Italiana,Bocatto Di Passo,18900,5000,23900
11681,11682,21-10-2020 15:30:55.727654,Pescados y Mariscos,La Gran Cazuela,70000,3200,73200
11682,11683,21-10-2020 15:30:55.965546,Desayunos · Típica,Alce,31800,4900,36700
11683,11684,21-10-2020 15:30:56.353050,Desayunos · Panadería,Juliana Restaurante,24300,6100,30400
11684,11685,21-10-2020 15:30:56.740390,Saludable · Desayunos,Agua Dulce,53900,3700,57600
11685,11686,21-10-2020 15:30:57.128357,Alta Cocina · Italiana,Trattoria de la Plaza,12500,6000,18500
11686,11687,21-10-2020 15:30:57.316045,Desayunos · Pescados y Mariscos,Luzí­a - Mediterranea,31800,5700,37500
11687,11688,21-10-2020 15:30:57.653998,Postres · Desayunos,Vivalight Market.,29500,6500,36000
11688,11689,21-10-2020 15:30:57.891429,Internacional,Rio Sabores y Experiencias,53400,4100,57500
11689,11690,21-10-2020 15:30:58.079279,Típica,Bendita S,24300,4600,28900
11690,11691,21-10-2020 15:30:58.316550,Desayunos,Sr Buñuelo,15600,6400,22000
11691,11692,21-10-2020 15:30:58.705601,Desayunos · Mexicana,La Mera Mera - Mexicana,15600,3100,18700
11692,11693,21-10-2020 15:30:58.842948,Desayunos · Típica,D'Porco - Lechona,45800,6300,52100
11693,11694,21-10-2020 15:30:59.180294,Pizza,pizza andante,15600,4200,19800
11694,11695,21-10-2020 15:30:59.467879,Sushi,Canoa To Go,65000,5900,70900
11695,11696,21-10-2020 15:30:59.605428,Hamburguesas · Pescados y Mariscos,El Velero,7500,6500,14000
11696,11697,21-10-2020 15:30:59.942892,Postres · Saludable,Ana Rebana,13600,6300,19900
11697,11698,21-10-2020 15:31:00.080338,Postres,Beiked,10700,4000,14700
11698,11699,21-10-2020 15:31:00.418318,Desayunos · Típica,Criollomania,24300,5200,29500
11699,11700,21-10-2020 15:31:00.756076,Desayunos,Jacinta Arepas de Huevo,39700,4000,43700
11700,11701,21-10-2020 15:31:00.993743,Saludable · Jugos y Batidos,Berdes Drinks & Salads,31800,3500,35300
11701,11702,21-10-2020 15:31:01.331501,Sánduches,Submarin,29500,3800,33300
11702,11703,21-10-2020 15:31:01.568900,Pollo · Desayunos,Abasto,24200,3600,27800
11703,11704,21-10-2020 15:31:01.806366,Saludable · Desayunos,Fresh Co,18900,5600,24500
11704,11705,21-10-2020 15:31:02.094145,Desayunos · Panadería,El Pan de Phillippe,15000,4600,19600
11705,11706,21-10-2020 15:31:02.381895,Postres · Desayunos,Protein Bakes,48750,5900,54650
11706,11707,21-10-2020 15:31:02.669443,Saludable · Desayunos,Básico y elemental,53400,5000,58400
11707,11708,21-10-2020 15:31:03.057027,Desayunos,Desayunos en Bogotá,10700,3400,14100
11708,11709,21-10-2020 15:31:03.395268,Postres,Beiked,12500,4000,16500
11709,11710,21-10-2020 15:31:03.783982,Típica · Parrilla,La Parilla de David,7500,3100,10600
11710,11711,21-10-2020 15:31:04.171571,Postres · Desayunos,Gelateria Da Favola,39700,6500,46200
11711,11712,21-10-2020 15:31:04.558954,Internacional,Rio Sabores y Experiencias,17800,4100,21900
11712,11713,21-10-2020 15:31:04.846341,Sushi,Umi,7500,5600,13100
11713,11714,21-10-2020 15:31:05.234009,Desayunos · Típica,La Frijolada,15000,4500,19500
11714,11715,21-10-2020 15:31:05.521271,Poke,Poke Go,13000,4600,17600
11715,11716,21-10-2020 15:31:05.758688,Típica,Bandejas Mrg,12500,3800,16300
11716,11717,21-10-2020 15:31:06.046114,Parrilla · Café,Gaira Café,9000,4400,13400
11717,11718,21-10-2020 15:31:06.334017,Crepes,La Chabatta,15000,5900,20900
11718,11719,21-10-2020 15:31:06.471737,Típica,Baondish,13000,5800,18800
11719,11720,21-10-2020 15:31:06.759299,Saludable,MIMA,7500,3700,11200
11720,11721,21-10-2020 15:31:07.147101,Hamburguesas,Monchis - Hamburguesa,27800,4300,32100
11721,11722,21-10-2020 15:31:07.284656,Pollo,Oliva Va,13000,5600,18600
11722,11723,21-10-2020 15:31:07.572289,Saludable · Desayunos,La Cesta,34500,4700,39200
11723,11724,21-10-2020 15:31:07.859899,Parrilla · Café,Figaro Café/ Restaurante Argentino,17800,5800,23600
11724,11725,21-10-2020 15:31:08.198076,Típica,Bandejas Mrg,37900,3800,41700
11725,11726,21-10-2020 15:31:08.536419,Saludable · Desayunos,Básico y Elemental,15000,5900,20900
11726,11727,21-10-2020 15:31:08.875616,Típica · Parrilla,El Portal de la Antigua,18900,5600,24500
11727,11728,21-10-2020 15:31:09.263362,Desayunos,Don Leo,29500,6000,35500
11728,11729,21-10-2020 15:31:09.601433,Hamburguesas · Saludable,Restaurant Inn,24300,6100,30400
11729,11730,21-10-2020 15:31:09.789118,Postres · Desayunos,Maltihelados,23000,6200,29200
11730,11731,21-10-2020 15:31:09.976640,Desayunos · Típica,Rojo Gourmet,23000,4700,27700
11731,11732,21-10-2020 15:31:10.314278,Hamburguesas,Burger Society,37900,4100,42000
11732,11733,21-10-2020 15:31:10.601929,Desayunos · Comida Rápida,La Veneca,13000,6300,19300
11733,11734,21-10-2020 15:31:10.989938,Desayunos,El Corral - Desayunos,9000,5000,14000
11734,11735,21-10-2020 15:31:11.227747,Postres · Desayunos,La Folie - Postres,8900,3300,12200
11735,11736,21-10-2020 15:31:11.565496,Saludable · Desayunos,Básico y elemental,35000,5000,40000
11736,11737,21-10-2020 15:31:11.853445,Parrilla,Carnes la Zarza,35000,4900,39900
11737,11738,21-10-2020 15:31:11.990716,Desayunos · Típica,D'Porco - Lechona,23000,6300,29300
11738,11739,21-10-2020 15:31:12.178212,Desayunos · Parrilla,Mi Patria,37900,4600,42500
11739,11740,21-10-2020 15:31:12.416138,Saludable · Desayunos,Básico y elemental,70000,5000,75000
11740,11741,21-10-2020 15:31:12.653865,Postres · Desayunos,Aury Postres - Comidas & Picadas,53900,4700,58600
11741,11742,21-10-2020 15:31:12.791369,Asiática,TeT,53900,5900,59800
11742,11743,21-10-2020 15:31:12.979002,Desayunos · Panadería,Limarys,39700,6500,46200
11743,11744,21-10-2020 15:31:13.316656,Desayunos · Típica,D'Porco - Lechona,15000,6300,21300
11744,11745,21-10-2020 15:31:13.654396,Desayunos · Mexicana,La Mera Mera - Mexicana,39700,3100,42800
11745,11746,21-10-2020 15:31:13.791859,Desayunos · Pescados y Mariscos,Gypsy Bistro,9000,4500,13500
11746,11747,21-10-2020 15:31:14.080414,Alta Cocina · Italiana,Trattoria de la Plaza,23000,6000,29000
11747,11748,21-10-2020 15:31:14.318677,Desayunos · Parrilla,Mi Patria,39700,4600,44300
11748,11749,21-10-2020 15:31:14.556337,Italiana,Bocatto Di Passo,17800,5000,22800
11749,11750,21-10-2020 15:31:14.794316,Sánduches · China,Peru Mix,27800,5900,33700
11750,11751,21-10-2020 15:31:14.932525,Pollo,Heart & Cooking,70000,5000,75000
11751,11752,21-10-2020 15:31:15.271063,Sushi,Umi,7500,5600,13100
11752,11753,21-10-2020 15:31:15.409677,Italiana,Bocatto Di Passo,65000,5000,70000
11753,11754,21-10-2020 15:31:15.647225,Desayunos,La Frijolada Desayunos,15000,4400,19400
11754,11755,21-10-2020 15:31:15.934759,Desayunos · Café,Norma's Ice Cream Café,34500,6300,40800
11755,11756,21-10-2020 15:31:16.072290,Desayunos · Café,Moramia,35000,4700,39700
11756,11757,21-10-2020 15:31:16.410017,Hamburguesas · Saludable,Restaurant Inn,8900,6100,15000
11757,11758,21-10-2020 15:31:16.697741,Desayunos · Café,Aromacafé el Placer de Compartir,39700,5000,44700
11758,11759,21-10-2020 15:31:16.985450,Saludable · Desayunos,Malú,53400,3700,57100
11759,11760,21-10-2020 15:31:17.173271,Típica,Carbón & Mondongos,39700,6400,46100
11760,11761,21-10-2020 15:31:17.411702,Pollo,Oliva Va,13600,5600,19200
11761,11762,21-10-2020 15:31:17.750030,Pizza,Pizza Andante,24200,6300,30500
11762,11763,21-10-2020 15:31:18.037710,Desayunos · Panadería,Decofruta,23000,4700,27700
11763,11764,21-10-2020 15:31:18.275649,Pollo · Desayunos,Candelina,24300,5300,29600
11764,11765,21-10-2020 15:31:18.413433,Pollo,Heart & Cooking,70000,5000,75000
11765,11766,21-10-2020 15:31:18.550828,Pizza,Pizza Andante,23000,6300,29300
11766,11767,21-10-2020 15:31:18.688333,Postres · Desayunos,Gelateria Da Favola,34500,6500,41000
11767,11768,21-10-2020 15:31:19.076134,Mexicana,La leyenda mexican kitchen,34500,3200,37700
11768,11769,21-10-2020 15:31:19.415258,Desayunos · Café,Aromacafé el Placer de Compartir,35000,5000,40000
11769,11770,21-10-2020 15:31:19.703336,Desayunos · Típica,La Parrilla Dorada Polo,15600,6600,22200
11770,11771,21-10-2020 15:31:19.991248,Desayunos,Cafetería el Kippe,48750,3200,51950
11771,11772,21-10-2020 15:31:20.229451,Típica,Campo Victoria,15000,3000,18000
11772,11773,21-10-2020 15:31:20.467115,Parrilla · Internacional,Taperia de la Plaza,45800,5700,51500
11773,11774,21-10-2020 15:31:20.855150,Típica,Salsig,24200,5600,29800
11774,11775,21-10-2020 15:31:21.143055,Desayunos · Internacional,Camilia,15600,3900,19500
11775,11776,21-10-2020 15:31:21.481174,Desayunos · Café,El Gualilo,39700,6200,45900
11776,11777,21-10-2020 15:31:21.818914,Postres · Desayunos,KOKOA & co.,13600,4700,18300
11777,11778,21-10-2020 15:31:22.006628,Típica,Cazuelitas 93,15600,3900,19500
11778,11779,21-10-2020 15:31:22.194535,Peruana · Internacional,La Chifería,39700,6600,46300
11779,11780,21-10-2020 15:31:22.582838,Pollo · China,China Tao,10700,3500,14200
11780,11781,21-10-2020 15:31:22.870406,Parrilla · Café,Gaira Café,11870,4400,16270
11781,11782,21-10-2020 15:31:23.108157,Alta Cocina · Postres,La Pinta,70000,4500,74500
11782,11783,21-10-2020 15:31:23.346314,Desayunos · Típica,La Frijolada,45800,4500,50300
11783,11784,21-10-2020 15:31:23.534555,Parrilla,Antojo a Domicilio,53900,5000,58900
11784,11785,21-10-2020 15:31:23.772599,Desayunos,Archies Desayunos,12500,3100,15600
11785,11786,21-10-2020 15:31:24.060303,Saludable,The Good Rice Bowls,7500,3500,11000
11786,11787,21-10-2020 15:31:24.198054,Desayunos · Café,vereda central calle 99,35000,5700,40700
11787,11788,21-10-2020 15:31:24.385639,Desayunos,El Corral - Desayunos,39700,5000,44700
11788,11789,21-10-2020 15:31:24.724759,Pollo · Desayunos,Piaf,17800,6500,24300
11789,11790,21-10-2020 15:31:24.862173,Pollo · Desayunos,Abasto,48750,3600,52350
11790,11791,21-10-2020 15:31:25.049504,Desayunos · Italiana,Rceta By Rausch,12500,3600,16100
11791,11792,21-10-2020 15:31:25.387126,Típica,Campo Victoria,15000,3000,18000
11792,11793,21-10-2020 15:31:25.725434,Postres · Café,Loló Coffee & Snacks,12500,4600,17100
11793,11794,21-10-2020 15:31:25.913029,Saludable · Desayunos,Libre de Culpa,35000,4000,39000
11794,11795,21-10-2020 15:31:26.251089,Saludable · Desayunos,Guadalupe - Fruteria,13600,5900,19500
11795,11796,21-10-2020 15:31:26.589201,Saludable · Jugos y Batidos,Berdes Drinks & Salads,35000,3500,38500
11796,11797,21-10-2020 15:31:26.877112,Desayunos · Café,vereda central calle 99,53900,5700,59600
11797,11798,21-10-2020 15:31:27.014607,Pizza,18 Scalini,23000,4300,27300
11798,11799,21-10-2020 15:31:27.302683,Desayunos · Panadería,Limarys,35000,6500,41500
11799,11800,21-10-2020 15:31:27.540545,Pollo · Saludable,Yerbabuena,12500,3900,16400
11800,11801,21-10-2020 15:31:27.828428,Típica,La Herencia,8900,5900,14800
11801,11802,21-10-2020 15:31:28.116962,Desayunos · Típica,Calentao Express,17800,6000,23800
11802,11803,21-10-2020 15:31:28.505319,Pizza · Italiana,Pisapore - Pizza,17800,6600,24400
11803,11804,21-10-2020 15:31:28.692804,Desayunos · Típica,La Parrilla Dorada Polo,29500,6600,36100
11804,11805,21-10-2020 15:31:29.081268,Desayunos · Panadería,Pasteleite,48750,5900,54650
11805,11806,21-10-2020 15:31:29.269392,Pizza · Italiana,Pisapore - Pizza,23000,6600,29600
11806,11807,21-10-2020 15:31:29.507335,Típica · Parrilla,La Ternera Parrilla,23000,5200,28200
11807,11808,21-10-2020 15:31:29.745993,Desayunos · Café,vereda central calle 99,27800,5700,33500
11808,11809,21-10-2020 15:31:29.883654,Crepes,La Chabatta,39700,5900,45600
11809,11810,21-10-2020 15:31:30.121707,Típica,Baondish,48750,5800,54550
11810,11811,21-10-2020 15:31:30.359720,Desayunos · Típica,Desayunadero de la 42,10700,5900,16600
11811,11812,21-10-2020 15:31:30.699139,Italiana,Bocatto Di Passo,9000,5000,14000
11812,11813,21-10-2020 15:31:30.937373,Desayunos,La Frijolada Desayunos,48750,4400,53150
11813,11814,21-10-2020 15:31:31.275486,Desayunos · Panadería,Premium Break Bakery,15600,3700,19300
11814,11815,21-10-2020 15:31:31.463822,Pollo · Saludable,Gratina,23000,4200,27200
11815,11816,21-10-2020 15:31:31.851840,Desayunos,Sunny Breakfast Brunch,9000,4300,13300
11816,11817,21-10-2020 15:31:32.089745,Peruana,Uma Cantina Peruana,29500,3200,32700
11817,11818,21-10-2020 15:31:32.427647,Postres · Saludable,Ana Rebana,48750,6300,55050
11818,11819,21-10-2020 15:31:32.765611,Peruana,Masivo,8900,5800,14700
11819,11820,21-10-2020 15:31:33.053547,Desayunos · Panadería,Limarys,15600,6500,22100
11820,11821,21-10-2020 15:31:33.441916,Desayunos,Señor Desayuno,35000,6800,41800
11821,11822,21-10-2020 15:31:33.830084,Postres · Desayunos,La Folie - Postres,29500,3300,32800
11822,11823,21-10-2020 15:31:34.168042,Postres · Desayunos,Maltihelado,35000,4500,39500
11823,11824,21-10-2020 15:31:34.555969,Desayunos · Café,vereda central calle 99,15600,5700,21300
11824,11825,21-10-2020 15:31:34.844932,Saludable · Parrilla,The Angels Grill and Drinks,12500,6200,18700
11825,11826,21-10-2020 15:31:35.132769,Desayunos · Panadería,Santa Juana Food Bar,29500,5900,35400
11826,11827,21-10-2020 15:31:35.270402,Desayunos · Panadería,Decofruta,27800,4700,32500
11827,11828,21-10-2020 15:31:35.608614,Desayunos · Típica,Fogón Sangileño,23000,5000,28000
11828,11829,21-10-2020 15:31:35.846422,Típica,La Olla de Barro,34500,5300,39800
11829,11830,21-10-2020 15:31:36.134494,Pollo · Desayunos,Candelina,70000,5300,75300
11830,11831,21-10-2020 15:31:36.273078,Típica · Pescados y Mariscos,La Vitualla,24300,6300,30600
11831,11832,21-10-2020 15:31:36.611219,Desayunos,Sr Buñuelo,23000,6400,29400
11832,11833,21-10-2020 15:31:36.849272,Típica,Bendita S,24300,4600,28900
11833,11834,21-10-2020 15:31:37.187750,Parrilla,Parrilla Pimentón,23000,3400,26400
11834,11835,21-10-2020 15:31:37.475994,Desayunos · Internacional,Camilia,39700,3900,43600
11835,11836,21-10-2020 15:31:37.614189,Postres,Toledo Pastelería,15600,6800,22400
11836,11837,21-10-2020 15:31:37.751773,Parrilla,Carnes la Zarza,17800,4900,22700
11837,11838,21-10-2020 15:31:37.989465,Postres · Desayunos,Maltihelados,34500,6200,40700
11838,11839,21-10-2020 15:31:38.277403,Asiática,TeT,24300,5900,30200
11839,11840,21-10-2020 15:31:38.415746,Desayunos,Cafetería el Kippe,39700,3200,42900
11840,11841,21-10-2020 15:31:38.654073,Postres,Toledo Pastelería,27800,6800,34600
11841,11842,21-10-2020 15:31:38.841940,Desayunos · Panadería,Limarys,65000,6500,71500
11842,11843,21-10-2020 15:31:39.179844,Desayunos,Butter,15600,6700,22300
11843,11844,21-10-2020 15:31:39.517990,Desayunos · Parrilla,Mi Patria,31800,4600,36400
11844,11845,21-10-2020 15:31:39.756096,Sánduches · Pescados y Mariscos,Pacific Comida de Mar,15600,4000,19600
11845,11846,21-10-2020 15:31:40.144175,Saludable · Desayunos,Básico y elemental,23000,5000,28000
11846,11847,21-10-2020 15:31:40.332228,Hamburguesas,Monchis - Hamburguesa,17800,4300,22100
11847,11848,21-10-2020 15:31:40.569671,Desayunos · Típica,Desayunadero de la 42,27800,5900,33700
11848,11849,21-10-2020 15:31:40.757669,Desayunos,Cafetería el Kippe,13000,3200,16200
11849,11850,21-10-2020 15:31:40.895258,Saludable · Desayunos,Guadalupe - Fruteria,12500,5900,18400
11850,11851,21-10-2020 15:31:41.233567,Típica,Cazuelitas 93,7500,3900,11400
11851,11852,21-10-2020 15:31:41.422495,Típica,Carbón & Mondongos,35000,6400,41400
11852,11853,21-10-2020 15:31:41.610797,Desayunos,Desayunos en Bogotá,11870,3400,15270
11853,11854,21-10-2020 15:31:41.798622,Saludable,MIMA,17800,3700,21500
11854,11855,21-10-2020 15:31:41.986348,Hamburguesas · Alitas,Beer,18900,6600,25500
11855,11856,21-10-2020 15:31:42.374308,Postres,Toledo Pastelería,17800,6800,24600
11856,11857,21-10-2020 15:31:42.712441,Postres · Desayunos,Buñuelos nacho,23000,6600,29600
11857,11858,21-10-2020 15:31:43.050383,Pizza · Italiana,Pisapore - Pizza,39700,6600,46300
11858,11859,21-10-2020 15:31:43.238316,Típica,Lo Nuestro,35000,3100,38100
11859,11860,21-10-2020 15:31:43.376085,Pollo,Señor Fantástico,9000,4700,13700
11860,11861,21-10-2020 15:31:43.714495,Mexicana,Mexicanachos,45800,3900,49700
11861,11862,21-10-2020 15:31:43.902354,Desayunos · Típica,La Frijolada,10700,4500,15200
11862,11863,21-10-2020 15:31:44.090336,Desayunos · Parrilla,Mi Patria,53400,4600,58000
11863,11864,21-10-2020 15:31:44.328507,Típica,Juan Chorizo,17800,3900,21700
11864,11865,21-10-2020 15:31:44.616950,Sushi · Desayunos,Maki Roll,8900,4300,13200
11865,11866,21-10-2020 15:31:45.005118,Desayunos · Café,Frambas,13600,3400,17000
11866,11867,21-10-2020 15:31:45.294326,Postres,Toledo Pastelería,10700,6800,17500
11867,11868,21-10-2020 15:31:45.632731,Postres · Panadería,RIGHT AWAY FOODS,15000,6600,21600
11868,11869,21-10-2020 15:31:46.021090,Pizza,pizza andante,48750,4200,52950
11869,11870,21-10-2020 15:31:46.159052,Típica · Parrilla,Mi Ranchito Parrilla,7500,4400,11900
11870,11871,21-10-2020 15:31:46.397278,Típica,La Olla de Barro,11870,5300,17170
11871,11872,21-10-2020 15:31:46.635304,Desayunos,Fratelli - Desayunos,35000,4600,39600
11872,11873,21-10-2020 15:31:46.773351,Desayunos · Panadería,Premium Break Bakery,27800,3700,31500
11873,11874,21-10-2020 15:31:47.061309,Pizza,Pizza Andante,13000,6300,19300
11874,11875,21-10-2020 15:31:47.249267,Sushi,Canoa To Go,23000,5900,28900
11875,11876,21-10-2020 15:31:47.487364,Desayunos · Jugos y Batidos,Dont Be Hungry,24300,5600,29900
11876,11877,21-10-2020 15:31:47.775648,Sushi,Umi,37900,5600,43500
11877,11878,21-10-2020 15:31:47.963561,Hamburguesas · Saludable,Restaurant Inn,18900,6100,25000
11878,11879,21-10-2020 15:31:48.302216,Desayunos,Jacinta Arepas de Huevo,27800,4000,31800
11879,11880,21-10-2020 15:31:48.440325,Hamburguesas · Pescados y Mariscos,El Velero,23000,6500,29500
11880,11881,21-10-2020 15:31:48.778681,Típica · Pescados y Mariscos,Arroces Mrg,48750,4300,53050
11881,11882,21-10-2020 15:31:49.066690,Pizza,Pastas Laurentina,37900,4800,42700
11882,11883,21-10-2020 15:31:49.405163,Postres,Levelma,9000,6200,15200
11883,11884,21-10-2020 15:31:49.793748,Alta Cocina · Parrilla,Criterión,9000,6000,15000
11884,11885,21-10-2020 15:31:50.031890,Parrilla,Rústico Picadería,15000,3800,18800
11885,11886,21-10-2020 15:31:50.422197,Pollo,Oliva Va,65000,5600,70600
11886,11887,21-10-2020 15:31:50.610642,Típica,La Cocina,24200,4600,28800
11887,11888,21-10-2020 15:31:50.848956,Pescados y Mariscos,Fish Place - Del Mar,29500,5400,34900
11888,11889,21-10-2020 15:31:51.237753,Hamburguesas · Pescados y Mariscos,El Velero,12500,6500,19000
11889,11890,21-10-2020 15:31:51.375960,Sushi,Kim Pop,29500,5400,34900
11890,11891,21-10-2020 15:31:51.564257,Postres,La Tertulia,15600,3400,19000
11891,11892,21-10-2020 15:31:51.702481,Desayunos · Panadería,Premium Break Bakery,23000,3700,26700
11892,11893,21-10-2020 15:31:51.940627,Típica · Parrilla,Typykos,8900,6000,14900
11893,11894,21-10-2020 15:31:52.229261,Asiática,TeT,39700,5900,45600
11894,11895,21-10-2020 15:31:52.517473,Pescados y Mariscos,La Gran Cazuela,7500,3200,10700
11895,11896,21-10-2020 15:31:52.855647,Típica,La Cocina,27800,4600,32400
11896,11897,21-10-2020 15:31:52.993957,Sánduches,Submarin,35000,3800,38800
11897,11898,21-10-2020 15:31:53.382399,Saludable · Desayunos,Básico y Elemental,34500,5900,40400
11898,11899,21-10-2020 15:31:53.720712,Desayunos · Café,vereda central calle 99,27800,5700,33500
11899,11900,21-10-2020 15:31:53.908876,Desayunos · Empanadas,Empanadas Doraditas.com,27800,3000,30800
11900,11901,21-10-2020 15:31:54.147829,Parrilla,Campocina,31800,4600,36400
11901,11902,21-10-2020 15:31:54.286745,Asiática,TeT,13000,5900,18900
11902,11903,21-10-2020 15:31:54.525907,Típica,Sopitas y Más,70000,4200,74200
11903,11904,21-10-2020 15:31:54.864789,Desayunos · Típica,Parrilla Farandula Típico,53900,5900,59800
11904,11905,21-10-2020 15:31:55.153045,Parrilla,Campocina,53400,4600,58000
11905,11906,21-10-2020 15:31:55.291257,Desayunos · Italiana,Rceta By Rausch,15600,3600,19200
11906,11907,21-10-2020 15:31:55.630844,Desayunos · Típica,D'Porco - Lechona,23000,6300,29300
11907,11908,21-10-2020 15:31:55.869024,Desayunos · Típica,Rojo Gourmet,13000,4700,17700
11908,11909,21-10-2020 15:31:56.006996,Desayunos · Árabe,Boniato Sabores Vivos,35000,5300,40300
11909,11910,21-10-2020 15:31:56.245281,Saludable · Parrilla,Box,23000,3700,26700
11910,11911,21-10-2020 15:31:56.583430,Postres · Desayunos,Café Quindio,10700,5700,16400
11911,11912,21-10-2020 15:31:56.871683,Desayunos · Panadería,Ficchi Panadería,35000,3100,38100
11912,11913,21-10-2020 15:31:57.060207,Desayunos · Sánduches,Danilo Colombia,23000,3300,26300
11913,11914,21-10-2020 15:31:57.198049,Desayunos · Típica,Calentao Express,18900,6000,24900
11914,11915,21-10-2020 15:31:57.386276,Saludable · Desayunos,Agua Dulce,13600,3700,17300
11915,11916,21-10-2020 15:31:57.774304,Internacional,Rio Sabores y Experiencias,15600,4100,19700
11916,11917,21-10-2020 15:31:58.112646,Postres · Panadería,RIGHT AWAY FOODS,12500,6600,19100
11917,11918,21-10-2020 15:31:58.350599,Panadería,Boul,13600,3100,16700
11918,11919,21-10-2020 15:31:58.538549,Saludable,Ventura Soup y Salad,12500,3800,16300
11919,11920,21-10-2020 15:31:58.726539,Saludable · Jugos y Batidos,Berdes Drinks & Salads,23000,3500,26500
11920,11921,21-10-2020 15:31:58.964932,Desayunos · Sánduches,Danilo Colombia,23000,3300,26300
11921,11922,21-10-2020 15:31:59.103012,Sushi,Canoa To Go,7500,5900,13400
11922,11923,21-10-2020 15:31:59.291144,Postres · Desayunos,Maltihelados,53900,6200,60100
11923,11924,21-10-2020 15:31:59.679384,Desayunos · Café,Libertario Coffee Roasters,10700,4600,15300
11924,11925,21-10-2020 15:31:59.917438,Desayunos · Típica,Criollomania,31800,5200,37000
11925,11926,21-10-2020 15:32:00.305601,Italiana,Bocatto Di Passo,17800,5000,22800
11926,11927,21-10-2020 15:32:00.695076,Desayunos · Típica,90 Calentados,11870,3700,15570
11927,11928,21-10-2020 15:32:00.933166,Desayunos · Café,El Gualilo,23000,6200,29200
11928,11929,21-10-2020 15:32:01.121652,Típica,El Cucharón - Tipica,70000,4400,74400
11929,11930,21-10-2020 15:32:01.409855,Desayunos · Café,El Gualilo,15000,6200,21200
11930,11931,21-10-2020 15:32:01.748090,Hamburguesas · Pescados y Mariscos,El Velero,48750,6500,55250
11931,11932,21-10-2020 15:32:01.936235,Sushi · Desayunos,Maki Roll,45800,4300,50100
11932,11933,21-10-2020 15:32:02.124426,Italiana,F*cking Good Pizza,10700,4200,14900
11933,11934,21-10-2020 15:32:02.512595,Típica,Sopitas y Más,13000,4200,17200
11934,11935,21-10-2020 15:32:02.850862,Desayunos,Sr Buñuelo,70000,6400,76400
11935,11936,21-10-2020 15:32:03.239821,Jugos y Batidos,Pomponio,24300,3600,27900
11936,11937,21-10-2020 15:32:03.478165,Hamburguesas · Desayunos,El Inglés Gastro Pub,13600,6600,20200
11937,11938,21-10-2020 15:32:03.716659,Postres,La Galeta,24300,3000,27300
11938,11939,21-10-2020 15:32:03.854647,Parrilla,Coquitas,24200,5600,29800
11939,11940,21-10-2020 15:32:04.142694,Desayunos · Helados,San Giorgio Gelateria,9000,3100,12100
11940,11941,21-10-2020 15:32:04.431383,Postres · Desayunos,Restaurante Cornelia,31800,5500,37300
11941,11942,21-10-2020 15:32:04.620032,Postres · Café,Celestino Café,70000,5900,75900
11942,11943,21-10-2020 15:32:04.958650,Desayunos · Típica,La Frijolada,29500,4500,34000
11943,11944,21-10-2020 15:32:05.146768,Saludable · Desayunos,Básico y Elemental,15600,5900,21500
11944,11945,21-10-2020 15:32:05.535364,Saludable · Típica,Saludable Mrg,53900,5800,59700
11945,11946,21-10-2020 15:32:05.925003,Alta Cocina · Parrilla,Criterión,23000,6000,29000
11946,11947,21-10-2020 15:32:06.063048,Postres · Panadería,RIGHT AWAY FOODS,18900,6600,25500
11947,11948,21-10-2020 15:32:06.201014,Postres · Desayunos,Restaurante Cornelia,23000,5500,28500
11948,11949,21-10-2020 15:32:06.439987,Desayunos · Típica,Papadió - Colombianas,7500,5700,13200
11949,11950,21-10-2020 15:32:06.628424,Pollo · Desayunos,Workzone,15000,3100,18100
11950,11951,21-10-2020 15:32:06.866715,Típica · Parrilla,Mi Ranchito Parrilla,23000,4400,27400
11951,11952,21-10-2020 15:32:07.155239,Típica · Parrilla,Toya,7500,4200,11700
11952,11953,21-10-2020 15:32:07.393824,Típica · Parrilla,El Portal de la Antigua,37900,5600,43500
11953,11954,21-10-2020 15:32:07.732278,Saludable · Desayunos,Malú,15600,3700,19300
11954,11955,21-10-2020 15:32:08.071538,Comida Rápida · Perros Calientes,Similoa - Comida Rapida,35000,3700,38700
11955,11956,21-10-2020 15:32:08.209966,Postres,Levelma,24200,6200,30400
11956,11957,21-10-2020 15:32:08.448842,Típica,La Herencia,10700,5900,16600
11957,11958,21-10-2020 15:32:08.587149,Parrilla,OAK Ahumado y Brebajes,10700,6000,16700
11958,11959,21-10-2020 15:32:08.725651,Parrilla,Carnes la Zarza,34500,4900,39400
11959,11960,21-10-2020 15:32:08.863652,Saludable · Desayunos,Distrito Gourmet,35000,3700,38700
11960,11961,21-10-2020 15:32:09.252042,Sushi,Sushi Reel,24200,4700,28900
11961,11962,21-10-2020 15:32:09.640976,Desayunos · Panadería,Artesanos,23000,4300,27300
11962,11963,21-10-2020 15:32:09.879324,Pizza,Pastas Laurentina,35000,4800,39800
11963,11964,21-10-2020 15:32:10.218249,Saludable · Desayunos,Fresh Co,65000,5600,70600
11964,11965,21-10-2020 15:32:10.607244,Típica,Sabrosito,12500,4000,16500
11965,11966,21-10-2020 15:32:10.946852,Desayunos · Comida Rápida,La Veneca,15000,6300,21300
11966,11967,21-10-2020 15:32:11.135571,Desayunos · Panadería,Artesanos,35000,4300,39300
11967,11968,21-10-2020 15:32:11.324175,Saludable · Parrilla,Box,13000,3700,16700
11968,11969,21-10-2020 15:32:11.662796,Asiática,TeT,23000,5900,28900
11969,11970,21-10-2020 15:32:11.850821,Saludable,Ventura Soup y Salad,37900,3800,41700
11970,11971,21-10-2020 15:32:12.089033,Peruana,Uma Cantina Peruana,24200,3200,27400
11971,11972,21-10-2020 15:32:12.377313,Pollo · Saludable,Tremenda Sal y Dulce,34500,6500,41000
11972,11973,21-10-2020 15:32:12.716201,Pollo · Desayunos,Caserito Gourmet,17800,6700,24500
11973,11974,21-10-2020 15:32:12.954585,Pizza · Parrilla,Urban Lunch,13600,4000,17600
11974,11975,21-10-2020 15:32:13.092666,Pizza,Pastas Laurentina,35000,4800,39800
11975,11976,21-10-2020 15:32:13.432010,Desayunos · Panadería,Ficchi Panadería,70000,3100,73100
11976,11977,21-10-2020 15:32:13.670436,Típica,Bendita S,53900,4600,58500
11977,11978,21-10-2020 15:32:13.808645,Parrilla,Antojo a Domicilio,13600,5000,18600
11978,11979,21-10-2020 15:32:14.046831,Postres · Saludable,Ana Rebana,10700,6300,17000
11979,11980,21-10-2020 15:32:14.385459,Pollo,Oliva Va,13600,5600,19200
11980,11981,21-10-2020 15:32:14.624289,Desayunos · Café,Frambas,35000,3400,38400
11981,11982,21-10-2020 15:32:14.862433,Típica,Bendita S,15600,4600,20200
11982,11983,21-10-2020 15:32:15.251414,Desayunos · Típica,Criollomania,23000,5200,28200
11983,11984,21-10-2020 15:32:15.590436,Típica,Bendita S,23000,4600,27600
11984,11985,21-10-2020 15:32:15.980133,Mexicana,Hidalgo Taquería,24200,4900,29100
11985,11986,21-10-2020 15:32:16.168796,Saludable · Parrilla,The Angels Grill and Drinks,15600,6200,21800
11986,11987,21-10-2020 15:32:16.507386,Postres · Desayunos,Gelateria Da Favola,39700,6500,46200
11987,11988,21-10-2020 15:32:16.846194,Desayunos · Típica,Peninsula Calentados y Parrilla,15600,3400,19000
11988,11989,21-10-2020 15:32:16.984954,Helados,Orso To Go,15600,6800,22400
11989,11990,21-10-2020 15:32:17.224612,Pollo · Típica,Auyama,18900,3900,22800
11990,11991,21-10-2020 15:32:17.463672,Desayunos · Café,Moramia,9000,4700,13700
11991,11992,21-10-2020 15:32:17.602392,Sushi · Asiática,Arigato,10700,5300,16000
11992,11993,21-10-2020 15:32:17.741535,Sushi · Asiática,Tu Sushi,13000,6400,19400
11993,11994,21-10-2020 15:32:17.929952,Desayunos · Panadería,Premium Break Bakery,45800,3700,49500
11994,11995,21-10-2020 15:32:18.268660,Mexicana,Cantina La 15,31800,4300,36100
11995,11996,21-10-2020 15:32:18.457345,Típica,Baondish,8900,5800,14700
11996,11997,21-10-2020 15:32:18.746185,Desayunos · Parrilla,Mi Patria,13600,4600,18200
11997,11998,21-10-2020 15:32:18.884717,Pollo,Heart & Cooking,17800,5000,22800
11998,11999,21-10-2020 15:32:19.274217,Desayunos,Archies Desayunos,24200,3100,27300
11999,12000,21-10-2020 15:32:19.613548,Saludable,Puro Verde,45800,5700,51500
12000,12001,21-10-2020 15:32:19.852378,Desayunos,Fratelli - Desayunos,45800,4600,50400
12001,12002,21-10-2020 15:32:20.241760,Parrilla,Arroces Maria Paula,34500,6800,41300
12002,12003,21-10-2020 15:32:20.631048,Comida Rápida · Perros Calientes,Similoa - Comida Rapida,24200,3700,27900
12003,12004,21-10-2020 15:32:20.769669,Saludable · Desayunos,Maracuyá,39700,6700,46400
12004,12005,21-10-2020 15:32:20.908512,Crepes,La Chabatta,34500,5900,40400
12005,12006,21-10-2020 15:32:21.148530,Hamburguesas,Bendito Cordero,18900,5800,24700
12006,12007,21-10-2020 15:32:21.537593,Desayunos · Café,El Gualilo,48750,6200,54950
12007,12008,21-10-2020 15:32:21.676178,Desayunos,El Fogón Castellano,23000,3200,26200
12008,12009,21-10-2020 15:32:21.965154,Asiática,Thai Station,31800,6000,37800
12009,12010,21-10-2020 15:32:22.354198,Postres · Desayunos,Restaurante Cornelia,17800,5500,23300
12010,12011,21-10-2020 15:32:22.642978,Postres · Desayunos,Protein Bakes,53900,5900,59800
12011,12012,21-10-2020 15:32:22.981566,Pollo,Heart & Cooking,70000,5000,75000
12012,12013,21-10-2020 15:32:23.370243,Hamburguesas,Gofi Burger,31800,5100,36900
12013,12014,21-10-2020 15:32:23.709325,Típica,La Olla de Barro,45800,5300,51100
12014,12015,21-10-2020 15:32:23.998021,Pollo,Oliva Va,23000,5600,28600
12015,12016,21-10-2020 15:32:24.186337,Postres,Beiked,10700,4000,14700
12016,12017,21-10-2020 15:32:24.474770,Típica,El Cucharón - Tipica,15600,4400,20000
12017,12018,21-10-2020 15:32:24.713476,Desayunos · Sánduches,Frutos del Bosque,12500,3500,16000
12018,12019,21-10-2020 15:32:25.001981,Saludable,Hanai - Bowls Saludables,7500,5900,13400
12019,12020,21-10-2020 15:32:25.340509,Saludable · Desayunos,Bon Eat - Saludable,29500,4800,34300
12020,12021,21-10-2020 15:32:25.729208,Desayunos · Típica,D´Porco,65000,3900,68900
12021,12022,21-10-2020 15:32:26.017847,Parrilla · Café,Figaro Café/ Restaurante Argentino,24200,5800,30000
12022,12023,21-10-2020 15:32:26.258366,Desayunos · Típica,Desayunadero de la 42,8900,5900,14800
12023,12024,21-10-2020 15:32:26.547673,Parrilla · Café,Gaira Café,15000,4400,19400
12024,12025,21-10-2020 15:32:26.786706,Desayunos · Café,Moramia,8900,4700,13600
12025,12026,21-10-2020 15:32:26.925029,Sushi · Asiática,Arigato,8900,5300,14200
12026,12027,21-10-2020 15:32:27.263821,Parrilla,Carnes la Zarza,12500,4900,17400
12027,12028,21-10-2020 15:32:27.652701,Desayunos · Típica,Rojo Gourmet,18900,4700,23600
12028,12029,21-10-2020 15:32:27.791018,Internacional,Rio Sabores y Experiencias,24200,4100,28300
12029,12030,21-10-2020 15:32:28.179637,Hamburguesas · Desayunos,El Inglés Gastro Pub,53900,6600,60500
12030,12031,21-10-2020 15:32:28.318394,Postres · Desayunos,KOKOA & co.,23000,4700,27700
12031,12032,21-10-2020 15:32:28.556784,Típica · Parrilla,Mi Ranchito Parrilla,15000,4400,19400
12032,12033,21-10-2020 15:32:28.745385,Pollo · Típica,Auyama,37900,3900,41800
12033,12034,21-10-2020 15:32:28.933818,Jugos y Batidos,Pomponio,53900,3600,57500
12034,12035,21-10-2020 15:32:29.272627,Pizza · Parrilla,Urban Lunch,45800,4000,49800
12035,12036,21-10-2020 15:32:29.661506,Saludable · Parrilla,Box,9000,3700,12700
12036,12037,21-10-2020 15:32:29.799837,Desayunos · Típica,Papadió - Colombianas,35000,5700,40700
12037,12038,21-10-2020 15:32:29.938103,Desayunos · Jugos y Batidos,Dont Be Hungry,7500,5600,13100
12038,12039,21-10-2020 15:32:30.327115,Desayunos · Sánduches,Frutos del Bosque,70000,3500,73500
12039,12040,21-10-2020 15:32:30.616302,Sánduches · China,Peru Mix,53400,5900,59300
12040,12041,21-10-2020 15:32:31.005213,Típica,La Herencia,65000,5900,70900
12041,12042,21-10-2020 15:32:31.144060,Desayunos · Típica,Criollomania,12500,5200,17700
12042,12043,21-10-2020 15:32:31.534223,Típica,Bendita S,18900,4600,23500
12043,12044,21-10-2020 15:32:31.922915,Saludable · Desayunos,Raices Bienestar Gourmet,29500,6600,36100
12044,12045,21-10-2020 15:32:32.161515,Saludable · Desayunos,Agua Dulce,9000,3700,12700
12045,12046,21-10-2020 15:32:32.500399,Helados,Buon Gelato,65000,4400,69400
12046,12047,21-10-2020 15:32:32.689477,Saludable · Desayunos,Bawana - Sandwich,8900,3400,12300
12047,12048,21-10-2020 15:32:32.927716,Desayunos · Café,Frambas,53400,3400,56800
12048,12049,21-10-2020 15:32:33.266421,Parrilla,Antojo a Domicilio,23000,5000,28000
12049,12050,21-10-2020 15:32:33.455434,Sushi,Canoa To Go,9000,5900,14900
12050,12051,21-10-2020 15:32:33.794126,Sushi · Asiática,Arigato,15000,5300,20300
12051,12052,21-10-2020 15:32:34.132981,Desayunos · Panadería,Limarys,9000,6500,15500
12052,12053,21-10-2020 15:32:34.471938,Desayunos,Butter,48750,6700,55450
12053,12054,21-10-2020 15:32:34.860413,Poke,Poke Go,27800,4600,32400
12054,12055,21-10-2020 15:32:35.199169,Saludable · Desayunos,Raices Bienestar Gourmet,15600,6600,22200
12055,12056,21-10-2020 15:32:35.388021,Poke,Poke Go,12500,4600,17100
12056,12057,21-10-2020 15:32:35.677308,Postres,La Tertulia,70000,3400,73400
12057,12058,21-10-2020 15:32:36.015799,Mexicana,La leyenda mexican kitchen,8900,3200,12100
12058,12059,21-10-2020 15:32:36.154480,Saludable · Desayunos,Raices Bienestar Gourmet,35000,6600,41600
12059,12060,21-10-2020 15:32:36.342877,Típica,Salsig,12500,5600,18100
12060,12061,21-10-2020 15:32:36.632510,Pescados y Mariscos,Pescadero Héroes del Mar,35000,6600,41600
12061,12062,21-10-2020 15:32:37.021435,Típica · Parrilla,Parrilla Farandula Gourmet,29500,5100,34600
12062,12063,21-10-2020 15:32:37.310301,Desayunos · Italiana,Rceta By Rausch,53400,3600,57000
12063,12064,21-10-2020 15:32:37.549327,Hamburguesas,Gofi Burger,13600,5100,18700
12064,12065,21-10-2020 15:32:37.887754,Pizza · Parrilla,Urban Lunch,70000,4000,74000
12065,12066,21-10-2020 15:32:38.026758,Postres,Toledo Pastelería,31800,6800,38600
12066,12067,21-10-2020 15:32:38.366530,Pollo · Pescados y Mariscos,Bang Bang Rice,9000,3400,12400
12067,12068,21-10-2020 15:32:38.656175,Saludable · Desayunos,Agua Dulce,45800,3700,49500
12068,12069,21-10-2020 15:32:38.845422,Saludable,MIMA,17800,3700,21500
12069,12070,21-10-2020 15:32:39.034524,Pollo · Saludable,Tremenda Sal y Dulce,10700,6500,17200
12070,12071,21-10-2020 15:32:39.173843,Italiana,Bocatto Di Passo,10700,5000,15700
12071,12072,21-10-2020 15:32:39.563173,Saludable,A2manos,13000,4200,17200
12072,12073,21-10-2020 15:32:39.902344,Postres · Desayunos,Jacques Pastelería,70000,5900,75900
12073,12074,21-10-2020 15:32:40.041465,Desayunos · Típica,D'Porco - Lechona,37900,6300,44200
12074,12075,21-10-2020 15:32:40.180377,Desayunos · Típica,La Frijolada,18900,4500,23400
12075,12076,21-10-2020 15:32:40.519742,Pollo,Señor Fantástico,10700,4700,15400
12076,12077,21-10-2020 15:32:40.808482,Internacional,La Esquina con Sabor Parrilla,34500,3000,37500
12077,12078,21-10-2020 15:32:41.046819,Típica · Parrilla,Parrilla Farandula Gourmet,45800,5100,50900
12078,12079,21-10-2020 15:32:41.285460,Saludable,A2manos,53400,4200,57600
12079,12080,21-10-2020 15:32:41.573846,Pollo · Saludable,Gratina,11870,4200,16070
12080,12081,21-10-2020 15:32:41.763396,Parrilla,Antojo a Domicilio,11870,5000,16870
12081,12082,21-10-2020 15:32:41.902170,Mexicana,La leyenda mexican kitchen,18900,3200,22100
12082,12083,21-10-2020 15:32:42.141310,Sushi · Desayunos,Maki Roll,53900,4300,58200
12083,12084,21-10-2020 15:32:42.430429,Pollo · Típica,Auyama,15600,3900,19500
12084,12085,21-10-2020 15:32:42.568884,Alta Cocina · Postres,La Pinta,11870,4500,16370
12085,12086,21-10-2020 15:32:42.907457,Pollo · Desayunos,Abasto,24300,3600,27900
12086,12087,21-10-2020 15:32:43.045930,Parrilla,Arepaisa de Medellín,70000,5600,75600
12087,12088,21-10-2020 15:32:43.434689,Desayunos · Sánduches,Garnish,35000,5200,40200
12088,12089,21-10-2020 15:32:43.823626,Parrilla,OAK Ahumado y Brebajes,17800,6000,23800
12089,12090,21-10-2020 15:32:44.112274,Postres · Desayunos,Buñuelos nacho,8900,6600,15500
12090,12091,21-10-2020 15:32:44.351190,Desayunos · Panadería,Artesanos,53900,4300,58200
12091,12092,21-10-2020 15:32:44.740225,Desayunos,Don Leo,24300,6000,30300
12092,12093,21-10-2020 15:32:44.929061,Desayunos · Café,El Gualilo,8900,6200,15100
12093,12094,21-10-2020 15:32:45.067383,Desayunos · Panadería,Santa Juana Food Bar,15600,5900,21500
12094,12095,21-10-2020 15:32:45.406809,Pollo,Chicken House,45800,4200,50000
12095,12096,21-10-2020 15:32:45.795964,Saludable · Desayunos,Agua Dulce,8900,3700,12600
12096,12097,21-10-2020 15:32:46.034837,Parrilla,Rústico Picadería,8900,3800,12700
12097,12098,21-10-2020 15:32:46.373919,Desayunos · Árabe,Boniato Sabores Vivos,65000,5300,70300
12098,12099,21-10-2020 15:32:46.763599,Saludable · Desayunos,Re.al Alimentos Reales,34500,4000,38500
12099,12100,21-10-2020 15:32:47.002309,Pizza · Italiana,Piatto - Pizza,23000,6600,29600
12100,12101,21-10-2020 15:32:47.190870,Parrilla · Café,Gaira Café,15600,4400,20000
12101,12102,21-10-2020 15:32:47.579749,Saludable,Puro Verde,65000,5700,70700
12102,12103,21-10-2020 15:32:47.768417,Desayunos · Típica,D´Porco,23000,3900,26900
12103,12104,21-10-2020 15:32:48.107596,Saludable · Jugos y Batidos,Berdes Drinks & Salads,11870,3500,15370
12104,12105,21-10-2020 15:32:48.496586,Parrilla · Café,Figaro Café/ Restaurante Argentino,39700,5800,45500
12105,12106,21-10-2020 15:32:48.785307,Saludable,The Good Rice Bowls,48750,3500,52250
12106,12107,21-10-2020 15:32:49.124154,Parrilla · Café,Figaro Café/ Restaurante Argentino,10700,5800,16500
12107,12108,21-10-2020 15:32:49.463112,Perros Calientes,Dog Shop - Rapida,15000,4900,19900
12108,12109,21-10-2020 15:32:49.801914,Saludable · Desayunos,Guadalupe - Fruteria,27800,5900,33700
12109,12110,21-10-2020 15:32:49.940518,Pollo · Pescados y Mariscos,Bang Bang Rice,7500,3400,10900
12110,12111,21-10-2020 15:32:50.229313,Pizza · Italiana,Pisapore - Pizza,65000,6600,71600
12111,12112,21-10-2020 15:32:50.418102,Desayunos · Sánduches,Danilo Colombia,24200,3300,27500
12112,12113,21-10-2020 15:32:50.806957,Desayunos · Internacional,Camilia,35000,3900,38900
12113,12114,21-10-2020 15:32:51.095277,Típica · Parrilla,Toya,15600,4200,19800
12114,12115,21-10-2020 15:32:51.434438,Desayunos · Café,vereda central calle 99,23000,5700,28700
12115,12116,21-10-2020 15:32:51.774169,Desayunos,El Fogón Castellano,37900,3200,41100
12116,12117,21-10-2020 15:32:52.113302,Pizza · Italiana,Pisapore - Pizza,11870,6600,18470
12117,12118,21-10-2020 15:32:52.402257,Desayunos,Butter,23000,6700,29700
12118,12119,21-10-2020 15:32:52.691445,Saludable · Desayunos,La Estampilla,31800,6000,37800
12119,12120,21-10-2020 15:32:53.080248,Típica · Parrilla,La Ternera Parrilla,27800,5200,33000
12120,12121,21-10-2020 15:32:53.269190,Parrilla,Campocina,17800,4600,22400
12121,12122,21-10-2020 15:32:53.458302,Desayunos,Bagel Shop,13000,3200,16200
12122,12123,21-10-2020 15:32:53.847012,Desayunos · Jugos y Batidos,Frutiwow,18900,4100,23000
12123,12124,21-10-2020 15:32:54.135783,Desayunos,Sunny Breakfast Brunch,7500,4300,11800
12124,12125,21-10-2020 15:32:54.275276,Internacional,Rio Sabores y Experiencias,23000,4100,27100
12125,12126,21-10-2020 15:32:54.513833,Saludable · Desayunos,Agua Dulce,17800,3700,21500
12126,12127,21-10-2020 15:32:54.752381,Típica,La Herencia,24200,5900,30100
12127,12128,21-10-2020 15:32:54.891061,Postres · Saludable,Ana Rebana,53400,6300,59700
12128,12129,21-10-2020 15:32:55.029618,Saludable,Ventura Soup y Salad,8900,3800,12700
12129,12130,21-10-2020 15:32:55.418695,Desayunos · Café,Aromacafé el Placer de Compartir,23000,5000,28000
12130,12131,21-10-2020 15:32:55.707516,Desayunos,Don Leo,70000,6000,76000
12131,12132,21-10-2020 15:32:55.895978,Sánduches · Pescados y Mariscos,Pacific Comida de Mar,10700,4000,14700
12132,12133,21-10-2020 15:32:56.134530,Postres,La Tertulia,23000,3400,26400
12133,12134,21-10-2020 15:32:56.424431,Desayunos · Panadería,Siena Café,17800,3700,21500
12134,12135,21-10-2020 15:32:56.562851,Desayunos · Típica,La Parrilla Dorada Polo,70000,6600,76600
12135,12136,21-10-2020 15:32:56.902326,Crepes,San Crepes,37900,4900,42800
12136,12137,21-10-2020 15:32:57.141271,Desayunos,Sr Buñuelo,24200,6400,30600
12137,12138,21-10-2020 15:32:57.329362,Sushi,Canoa To Go,31800,5900,37700
12138,12139,21-10-2020 15:32:57.618247,Mexicana,Hidalgo Taquería,35000,4900,39900
12139,12140,21-10-2020 15:32:57.856570,Desayunos · Típica,Criollomania,35000,5200,40200
12140,12141,21-10-2020 15:32:58.195536,Desayunos · Café,Aromacafé el Placer de Compartir,53900,5000,58900
12141,12142,21-10-2020 15:32:58.584721,Desayunos · Sánduches,Frutos del Bosque,37900,3500,41400
12142,12143,21-10-2020 15:32:58.823610,Pollo,Heart & Cooking,31800,5000,36800
12143,12144,21-10-2020 15:32:59.162730,Hamburguesas,Bendito Cordero,8900,5800,14700
12144,12145,21-10-2020 15:32:59.401633,Saludable · Desayunos,La Estampilla,34500,6000,40500
12145,12146,21-10-2020 15:32:59.640498,Desayunos,El Fogón Castellano,53400,3200,56600
12146,12147,21-10-2020 15:32:59.979307,Pollo · Típica,Auyama,8900,3900,12800
12147,12148,21-10-2020 15:33:00.118227,Saludable · Desayunos,Bon Eat - Saludable,37900,4800,42700
12148,12149,21-10-2020 15:33:00.506846,Parrilla · Café,Gaira Café,17800,4400,22200
12149,12150,21-10-2020 15:33:00.645433,Desayunos · Café,Matchacha,35000,5900,40900
12150,12151,21-10-2020 15:33:00.783875,Hamburguesas,Burger Society,24200,4100,28300
12151,12152,21-10-2020 15:33:01.173498,Típica,Bandejas Mrg,15000,3800,18800
12152,12153,21-10-2020 15:33:01.412799,Típica,Cazuelitas 93,13000,3900,16900
12153,12154,21-10-2020 15:33:01.801960,Típica · Parrilla,La Parilla de David,8900,3100,12000
12154,12155,21-10-2020 15:33:01.991661,Pollo · Saludable,Yerbabuena,31800,3900,35700
12155,12156,21-10-2020 15:33:02.230431,Desayunos,Butter,35000,6700,41700
12156,12157,21-10-2020 15:33:02.469509,Desayunos · Internacional,Camilia,8900,3900,12800
12157,12158,21-10-2020 15:33:02.808466,Saludable · Desayunos,Guadalupe - Fruteria,8900,5900,14800
12158,12159,21-10-2020 15:33:03.047250,Parrilla,Coquitas,48750,5600,54350
12159,12160,21-10-2020 15:33:03.185676,Típica · Parrilla,El Santandereano,11870,5200,17070
12160,12161,21-10-2020 15:33:03.324162,Postres · Desayunos,Protein Bakes,8900,5900,14800
12161,12162,21-10-2020 15:33:03.563292,Desayunos · Típica,Calentao Express,37900,6000,43900
12162,12163,21-10-2020 15:33:03.752213,Desayunos · Pescados y Mariscos,Gypsy Bistro,45800,4500,50300
12163,12164,21-10-2020 15:33:03.891093,Comida Rápida,Fiesta Digital Andrés,23000,3100,26100
12164,12165,21-10-2020 15:33:04.079811,Desayunos · Panadería,Choclofee,45800,4700,50500
12165,12166,21-10-2020 15:33:04.218658,Típica,Salsig,48750,5600,54350
12166,12167,21-10-2020 15:33:04.458170,Postres · Café,Celestino Café,24200,5900,30100
12167,12168,21-10-2020 15:33:04.746832,Pescados y Mariscos,La Gran Cazuela,45800,3200,49000
12168,12169,21-10-2020 15:33:05.136094,Parrilla,Restaurante Bar Mi Ranchito,48750,5200,53950
12169,12170,21-10-2020 15:33:05.324899,Hamburguesas,Monchis - Hamburguesa,35000,4300,39300
12170,12171,21-10-2020 15:33:05.563597,Postres · Desayunos,Restaurante Cornelia,11870,5500,17370
12171,12172,21-10-2020 15:33:05.952864,Típica,Lo Nuestro,70000,3100,73100
12172,12173,21-10-2020 15:33:06.341823,Saludable,Amor Propio saludable,24300,4000,28300
12173,12174,21-10-2020 15:33:06.530487,Saludable · Desayunos,Maracuyá,11870,6700,18570
12174,12175,21-10-2020 15:33:06.769310,Desayunos · Sánduches,Frutos del Bosque,18900,3500,22400
12175,12176,21-10-2020 15:33:06.958108,Parrilla,Arroces Maria Paula,15000,6800,21800
12176,12177,21-10-2020 15:33:07.297157,Parrilla,Arroces Maria Paula,10700,6800,17500
12177,12178,21-10-2020 15:33:07.635870,Desayunos · Comida Rápida,La Veneca,34500,6300,40800
12178,12179,21-10-2020 15:33:08.024993,Pescados y Mariscos,Fish Place - Del Mar,8900,5400,14300
12179,12180,21-10-2020 15:33:08.363929,Típica,Carbón & Mondongos,53400,6400,59800
12180,12181,21-10-2020 15:33:08.703164,Parrilla · Café,Figaro Café/ Restaurante Argentino,18900,5800,24700
12181,12182,21-10-2020 15:33:08.992199,Sánduches · China,Peru Mix,29500,5900,35400
12182,12183,21-10-2020 15:33:09.231340,Peruana,Uma Cantina Peruana,37900,3200,41100
12183,12184,21-10-2020 15:33:09.520299,Postres · Desayunos,Vivalight Market.,10700,6500,17200
12184,12185,21-10-2020 15:33:09.709346,Sánduches · China,Peru Mix,31800,5900,37700
12185,12186,21-10-2020 15:33:10.048038,Saludable,The Good Rice Bowls,12500,3500,16000
12186,12187,21-10-2020 15:33:10.236828,Típica,La Olla de Barro,17800,5300,23100
12187,12188,21-10-2020 15:33:10.375530,Saludable · Desayunos,Maracuyá,13000,6700,19700
12188,12189,21-10-2020 15:33:10.714815,Saludable · Desayunos,Básico y elemental,53400,5000,58400
12189,12190,21-10-2020 15:33:11.053442,Desayunos · Panadería,Choclofee,35000,4700,39700
12190,12191,21-10-2020 15:33:11.242326,Pollo,Oliva Va,9000,5600,14600
12191,12192,21-10-2020 15:33:11.581251,Saludable · Desayunos,Copacabana Açai Bowls,13000,3000,16000
12192,12193,21-10-2020 15:33:11.819918,Desayunos · Café,Matchacha,23000,5900,28900
12193,12194,21-10-2020 15:33:11.958482,Helados,Orso To Go,10700,6800,17500
12194,12195,21-10-2020 15:33:12.298372,Parrilla,OAK Ahumado y Brebajes,39700,6000,45700
12195,12196,21-10-2020 15:33:12.687327,Sushi,Umi,65000,5600,70600
12196,12197,21-10-2020 15:33:12.826003,Pescados y Mariscos,Fish Place - Del Mar,13000,5400,18400
12197,12198,21-10-2020 15:33:13.215022,Helados,Buon Gelato,48750,4400,53150
12198,12199,21-10-2020 15:33:13.604368,Hamburguesas · Desayunos,El Inglés Gastro Pub,31800,6600,38400
12199,12200,21-10-2020 15:33:13.943717,Desayunos · Café,vereda central calle 99,35000,5700,40700
12200,12201,21-10-2020 15:33:14.082643,Hamburguesas · Panadería,NYC Burgers,27800,6200,34000
12201,12202,21-10-2020 15:33:14.271726,Saludable,Puro Verde,13000,5700,18700
12202,12203,21-10-2020 15:33:14.560910,Postres · Desayunos,Sharmus,29500,6100,35600
12203,12204,21-10-2020 15:33:14.949905,Típica · Parrilla,La Ternera Parrilla,13600,5200,18800
12204,12205,21-10-2020 15:33:15.088516,Desayunos · Café,Moramia,65000,4700,69700
12205,12206,21-10-2020 15:33:15.427613,Desayunos · Italiana,Rceta By Rausch,53400,3600,57000
12206,12207,21-10-2020 15:33:15.566183,Típica · Parrilla,El Portal de la Antigua,48750,5600,54350
12207,12208,21-10-2020 15:33:15.754814,Desayunos · Empanadas,Mis Delicias,7500,3200,10700
12208,12209,21-10-2020 15:33:15.893456,Desayunos · Típica,D'Porco - Lechona,13600,6300,19900
12209,12210,21-10-2020 15:33:16.031941,Desayunos · Jugos y Batidos,Kuriwaji,45800,6300,52100
12210,12211,21-10-2020 15:33:16.320867,Saludable,MIMA,10700,3700,14400
12211,12212,21-10-2020 15:33:16.659933,Hamburguesas,Burger Society,23000,4100,27100
12212,12213,21-10-2020 15:33:17.048983,Pizza,pizza andante,23000,4200,27200
12213,12214,21-10-2020 15:33:17.438476,Típica · Parrilla,El Santandereano,9000,5200,14200
12214,12215,21-10-2020 15:33:17.627622,Típica,Cabrito Santandereano,29500,6600,36100
12215,12216,21-10-2020 15:33:18.016694,Desayunos · Típica,Cochon,7500,3300,10800
12216,12217,21-10-2020 15:33:18.356074,Sushi · Asiática,Tu Sushi,35000,6400,41400
12217,12218,21-10-2020 15:33:18.695397,Desayunos,Fratelli - Desayunos,13000,4600,17600
12218,12219,21-10-2020 15:33:19.035159,Pollo,Señor Fantástico,27800,4700,32500
12219,12220,21-10-2020 15:33:19.274356,Desayunos · Café,Aromacafé el Placer de Compartir,39700,5000,44700
12220,12221,21-10-2020 15:33:19.663816,Desayunos,Cafetería el Kippe,13000,3200,16200
12221,12222,21-10-2020 15:33:20.003109,Típica,Salsig,35000,5600,40600
12222,12223,21-10-2020 15:33:20.292368,Desayunos,Sr Buñuelo,35000,6400,41400
12223,12224,21-10-2020 15:33:20.481330,Hamburguesas · Panadería,NYC Burgers,10700,6200,16900
12224,12225,21-10-2020 15:33:20.670289,Postres · Desayunos,Jacques Pastelería,53400,5900,59300
12225,12226,21-10-2020 15:33:21.009344,Desayunos,Sr Buñuelo,10700,6400,17100
12226,12227,21-10-2020 15:33:21.248822,Italiana,Bocatto Di Passo,23000,5000,28000
12227,12228,21-10-2020 15:33:21.387463,Poke,Poke Go,10700,4600,15300
12228,12229,21-10-2020 15:33:21.576492,Desayunos · Panadería,Artesanos,7500,4300,11800
12229,12230,21-10-2020 15:33:21.765427,Típica · Pescados y Mariscos,La Vitualla,53400,6300,59700
12230,12231,21-10-2020 15:33:22.054804,Típica,La Cocina,29500,4600,34100
12231,12232,21-10-2020 15:33:22.445035,Desayunos · Jugos y Batidos,Kuriwaji,53400,6300,59700
12232,12233,21-10-2020 15:33:22.734013,Saludable · Desayunos,Raices Bienestar Gourmet,9000,6600,15600
12233,12234,21-10-2020 15:33:22.972845,Desayunos · Típica,Cochon,34500,3300,37800
12234,12235,21-10-2020 15:33:23.361934,Desayunos,Don Leo,13600,6000,19600
12235,12236,21-10-2020 15:33:23.651096,Típica · Parrilla,El Santandereano,35000,5200,40200
12236,12237,21-10-2020 15:33:23.790480,Parrilla · Café,Gaira Café,23000,4400,27400
12237,12238,21-10-2020 15:33:24.030290,Típica,Juan Chorizo,70000,3900,73900
12238,12239,21-10-2020 15:33:24.420164,Desayunos,Archies Desayunos,53400,3100,56500
12239,12240,21-10-2020 15:33:24.759895,Típica,Sopitas y Más,53400,4200,57600
12240,12241,21-10-2020 15:33:25.049450,Desayunos · Panadería,Choclofee,35000,4700,39700
12241,12242,21-10-2020 15:33:25.438890,Desayunos · Café,Moramia,37900,4700,42600
12242,12243,21-10-2020 15:33:25.778383,Pollo · Saludable,Gratina,27800,4200,32000
12243,12244,21-10-2020 15:33:25.967758,Desayunos · Panadería,Artesanos,10700,4300,15000
12244,12245,21-10-2020 15:33:26.307206,Saludable · Desayunos,Guadalupe - Fruteria,23000,5900,28900
12245,12246,21-10-2020 15:33:26.496412,Desayunos · Típica,Criollomania,65000,5200,70200
12246,12247,21-10-2020 15:33:26.786113,Pizza · Italiana,Piatto - Pizza,8900,6600,15500
12247,12248,21-10-2020 15:33:26.975207,Típica,La Cocina,11870,4600,16470
12248,12249,21-10-2020 15:33:27.114521,Internacional,La Esquina con Sabor Parrilla,24200,3000,27200
12249,12250,21-10-2020 15:33:27.353761,Desayunos · Jugos y Batidos,Frutiwow,15600,4100,19700
12250,12251,21-10-2020 15:33:27.594499,Alta Cocina · Postres,La Pinta,23000,4500,27500
12251,12252,21-10-2020 15:33:27.784195,Desayunos · Comida Rápida,La Veneca,31800,6300,38100
12252,12253,21-10-2020 15:33:28.023588,Sushi · Desayunos,Maki Roll,9000,4300,13300
12253,12254,21-10-2020 15:33:28.313158,Parrilla,Campocina,27800,4600,32400
12254,12255,21-10-2020 15:33:28.552530,Parrilla,Restaurante Bar Mi Ranchito,23000,5200,28200
12255,12256,21-10-2020 15:33:28.741857,Asiática,TeT,27800,5900,33700
12256,12257,21-10-2020 15:33:28.880935,Saludable,The Good Rice Bowls,35000,3500,38500
12257,12258,21-10-2020 15:33:29.120701,Desayunos · Panadería,Premium Break Bakery,23000,3700,26700
12258,12259,21-10-2020 15:33:29.260401,Desayunos · Típica,La Parrilla Dorada Polo,15000,6600,21600
12259,12260,21-10-2020 15:33:29.450464,Desayunos · Sánduches,Frutos del Bosque,15600,3500,19100
12260,12261,21-10-2020 15:33:29.789892,Asiática,Thai Station,35000,6000,41000
12261,12262,21-10-2020 15:33:30.179432,Saludable,The Good Rice Bowls,45800,3500,49300
12262,12263,21-10-2020 15:33:30.368700,Saludable · Desayunos,Agua Dulce,10700,3700,14400
12263,12264,21-10-2020 15:33:30.658065,Pollo,Chicken House,70000,4200,74200
12264,12265,21-10-2020 15:33:30.997954,Desayunos · Típica,Calentao Express,48750,6000,54750
12265,12266,21-10-2020 15:33:31.237414,Hamburguesas · Desayunos,El Inglés Gastro Pub,45800,6600,52400
12266,12267,21-10-2020 15:33:31.577059,Desayunos · Pescados y Mariscos,Luzí­a - Mediterranea,17800,5700,23500
12267,12268,21-10-2020 15:33:31.716406,Postres · Desayunos,Café Quindio,13000,5700,18700
12268,12269,21-10-2020 15:33:32.006003,Saludable · Desayunos,Malú,13600,3700,17300
12269,12270,21-10-2020 15:33:32.195286,Hamburguesas · Alitas,Beer,7500,6600,14100
12270,12271,21-10-2020 15:33:32.585534,Desayunos · Empanadas,Empanadas Doraditas.com,8900,3000,11900
12271,12272,21-10-2020 15:33:32.976616,Desayunos · Café,Libertario Coffee Roasters,29500,4600,34100
12272,12273,21-10-2020 15:33:33.316119,Saludable · Típica,Saludable Mrg,17800,5800,23600
12273,12274,21-10-2020 15:33:33.505520,Sushi · Desayunos,Maki Roll,7500,4300,11800
12274,12275,21-10-2020 15:33:33.645034,Típica · Parrilla,Mi Ranchito Parrilla,13000,4400,17400
12275,12276,21-10-2020 15:33:33.934648,Sánduches · China,Peru Mix,17800,5900,23700
12276,12277,21-10-2020 15:33:34.124422,Pollo · Sánduches,Pollos Century,23000,3000,26000
12277,12278,21-10-2020 15:33:34.363546,Desayunos,Sr Buñuelo,24200,6400,30600
12278,12279,21-10-2020 15:33:34.652634,Desayunos,Bagel Shop,23000,3200,26200
12279,12280,21-10-2020 15:33:34.991659,Postres · Desayunos,Vivalight Market.,7500,6500,14000
12280,12281,21-10-2020 15:33:35.330746,Pollo · Saludable,Gratina,13600,4200,17800
12281,12282,21-10-2020 15:33:35.519397,Parrilla · Café,Figaro Café/ Restaurante Argentino,37900,5800,43700
12282,12283,21-10-2020 15:33:35.858378,Saludable · Desayunos,La Estampilla,27800,6000,33800
12283,12284,21-10-2020 15:33:36.147489,Saludable,Amor Propio saludable,39700,4000,43700
12284,12285,21-10-2020 15:33:36.487824,Desayunos · Típica,Alce,24200,4900,29100
12285,12286,21-10-2020 15:33:36.827110,Sushi · Asiática,Tu Sushi,10700,6400,17100
12286,12287,21-10-2020 15:33:37.016294,Saludable · Desayunos,Re.al Alimentos Reales,11870,4000,15870
12287,12288,21-10-2020 15:33:37.206147,Saludable · Desayunos,Copacabana Açai Bowls,10700,3000,13700
12288,12289,21-10-2020 15:33:37.595420,Internacional,Rio Sabores y Experiencias,24300,4100,28400
12289,12290,21-10-2020 15:33:37.834330,Desayunos · Panadería,Juliana Restaurante,9000,6100,15100
12290,12291,21-10-2020 15:33:38.173444,Desayunos · Panadería,El Pan de Phillippe,53400,4600,58000
12291,12292,21-10-2020 15:33:38.462497,Sushi · Asiática,Arigato,65000,5300,70300
12292,12293,21-10-2020 15:33:38.651495,Saludable · Desayunos,Maracuyá,18900,6700,25600
12293,12294,21-10-2020 15:33:38.790999,Saludable · Jugos y Batidos,Berdes Drinks & Salads,27800,3500,31300
12294,12295,21-10-2020 15:33:39.180060,Pizza,Pizza Andante,8900,6300,15200
12295,12296,21-10-2020 15:33:39.569689,Pollo · China,China Tao,45800,3500,49300
12296,12297,21-10-2020 15:33:39.959384,Sushi,Umi,70000,5600,75600
12297,12298,21-10-2020 15:33:40.249212,Saludable · Típica,Sopas Mrg,48750,3100,51850
12298,12299,21-10-2020 15:33:40.488745,Típica,El Cucharón - Tipica,34500,4400,38900
12299,12300,21-10-2020 15:33:40.627979,Saludable,The Good Rice Bowls,48750,3500,52250
12300,12301,21-10-2020 15:33:40.967510,Desayunos · Típica,Cochon,35000,3300,38300
12301,12302,21-10-2020 15:33:41.207005,Desayunos,Butter,39700,6700,46400
12302,12303,21-10-2020 15:33:41.396854,Desayunos · Panadería,Siena Café,70000,3700,73700
12303,12304,21-10-2020 15:33:41.636436,Desayunos · Café,Norma's Ice Cream Café,45800,6300,52100
12304,12305,21-10-2020 15:33:41.925807,Típica,La Cocina,70000,4600,74600
12305,12306,21-10-2020 15:33:42.064782,Pollo · Desayunos,Piaf,23000,6500,29500
12306,12307,21-10-2020 15:33:42.253891,Desayunos · Típica,90 Calentados,65000,3700,68700
12307,12308,21-10-2020 15:33:42.442875,Pollo · Pescados y Mariscos,Bang Bang Rice,18900,3400,22300
12308,12309,21-10-2020 15:33:42.682274,Desayunos · Típica,Rojo Gourmet,34500,4700,39200
12309,12310,21-10-2020 15:33:42.821298,Desayunos · Café,Frambas,17800,3400,21200
12310,12311,21-10-2020 15:33:43.110470,Postres · Helados,Mahé,53900,6000,59900
12311,12312,21-10-2020 15:33:43.400833,Desayunos · Mexicana,La Mera Mera - Mexicana,37900,3100,41000
12312,12313,21-10-2020 15:33:43.539785,Pizza,Pizza Andante,35000,6300,41300
12313,12314,21-10-2020 15:33:43.829013,Desayunos · Típica,Peninsula Calentados y Parrilla,31800,3400,35200
12314,12315,21-10-2020 15:33:44.218416,Saludable · Desayunos,Guadalupe - Fruteria,35000,5900,40900
12315,12316,21-10-2020 15:33:44.457827,Parrilla,Restaurante Bar Mi Ranchito,15600,5200,20800
12316,12317,21-10-2020 15:33:44.747398,Saludable · Desayunos,La Estampilla,45800,6000,51800
12317,12318,21-10-2020 15:33:44.988038,Saludable · Desayunos,Distrito Gourmet,35000,3700,38700
12318,12319,21-10-2020 15:33:45.127411,Mexicana,La leyenda mexican kitchen,7500,3200,10700
12319,12320,21-10-2020 15:33:45.316462,Desayunos · Típica,Desayunadero de la 42,10700,5900,16600
12320,12321,21-10-2020 15:33:45.455927,Desayunos · Panadería,Artesanos,23000,4300,27300
12321,12322,21-10-2020 15:33:45.594995,Desayunos,Don Leo,53400,6000,59400
12322,12323,21-10-2020 15:33:45.734576,Desayunos · Panadería,Santa Juana Food Bar,13000,5900,18900
12323,12324,21-10-2020 15:33:46.073877,Desayunos,Señor Desayuno,24200,6800,31000
12324,12325,21-10-2020 15:33:46.463459,Saludable · Desayunos,Básico y elemental,53400,5000,58400
12325,12326,21-10-2020 15:33:46.852789,Postres · Café,Celestino Café,15000,5900,20900
12326,12327,21-10-2020 15:33:47.142171,Pizza,Pastas Laurentina,7500,4800,12300
12327,12328,21-10-2020 15:33:47.431942,Postres · Desayunos,Sharmus,12500,6100,18600
12328,12329,21-10-2020 15:33:47.621833,Hamburguesas · Alitas,Beer,31800,6600,38400
12329,12330,21-10-2020 15:33:47.760961,Postres,La Tertulia,18900,3400,22300
12330,12331,21-10-2020 15:33:48.000033,Desayunos · Café,Norma's Ice Cream Café,7500,6300,13800
12331,12332,21-10-2020 15:33:48.239528,Sushi,Umi,18900,5600,24500
12332,12333,21-10-2020 15:33:48.429858,Sushi,Sushi Reel,31800,4700,36500
12333,12334,21-10-2020 15:33:48.719254,Típica · Parrilla,El Portal de la Antigua,23000,5600,28600
12334,12335,21-10-2020 15:33:48.908473,Internacional,La Esquina con Sabor Parrilla,8900,3000,11900
12335,12336,21-10-2020 15:33:49.248024,Pollo,Heart & Cooking,31800,5000,36800
12336,12337,21-10-2020 15:33:49.487419,Desayunos · Café,Matchacha,11870,5900,17770
12337,12338,21-10-2020 15:33:49.676473,Sánduches · China,Peru Mix,13600,5900,19500
12338,12339,21-10-2020 15:33:49.815461,Saludable · Desayunos,La Estampilla,9000,6000,15000
12339,12340,21-10-2020 15:33:50.205054,Sushi,Kim Pop,37900,5400,43300
12340,12341,21-10-2020 15:33:50.394206,Postres,La Tertulia,65000,3400,68400
12341,12342,21-10-2020 15:33:50.583447,Desayunos · Café,Norma's Ice Cream Café,24200,6300,30500
12342,12343,21-10-2020 15:33:50.822807,Postres · Desayunos,Maltihelados,35000,6200,41200
12343,12344,21-10-2020 15:33:51.162269,Parrilla,Restaurante Bar Mi Ranchito,65000,5200,70200
12344,12345,21-10-2020 15:33:51.551775,Sushi · Asiática,Tu Sushi,35000,6400,41400
12345,12346,21-10-2020 15:33:51.741254,Saludable · Desayunos,Libre de Culpa,35000,4000,39000
12346,12347,21-10-2020 15:33:51.930699,Pescados y Mariscos,Fish Place - Del Mar,39700,5400,45100
12347,12348,21-10-2020 15:33:52.170153,Saludable · Desayunos,Guadalupe - Fruteria,31800,5900,37700
12348,12349,21-10-2020 15:33:52.559400,Saludable · Desayunos,Guadalupe - Fruteria,13600,5900,19500
12349,12350,21-10-2020 15:33:52.848813,Desayunos,Jacinta Arepas de Huevo,27800,4000,31800
12350,12351,21-10-2020 15:33:53.138181,Desayunos · Típica,90 Calentados,12500,3700,16200
12351,12352,21-10-2020 15:33:53.429104,Desayunos,Cafetería el Kippe,53400,3200,56600
12352,12353,21-10-2020 15:33:53.618785,Mexicana,Hidalgo Taquería,15000,4900,19900
12353,12354,21-10-2020 15:33:53.757752,Desayunos · Pescados y Mariscos,Luzí­a - Mediterranea,7500,5700,13200
12354,12355,21-10-2020 15:33:53.947227,Desayunos · Sánduches,Frutos del Bosque,7500,3500,11000
12355,12356,21-10-2020 15:33:54.136509,Desayunos · Panadería,Limarys,39700,6500,46200
12356,12357,21-10-2020 15:33:54.426095,Pollo · Típica,Auyama,18900,3900,22800
12357,12358,21-10-2020 15:33:54.615495,Desayunos · Café,Frambas,65000,3400,68400
12358,12359,21-10-2020 15:33:55.005514,Desayunos · Café,Matchacha,8900,5900,14800
12359,12360,21-10-2020 15:33:55.194679,Saludable · Desayunos,Fresh Co,24200,5600,29800
12360,12361,21-10-2020 15:33:55.383845,Típica,El Cucharón - Tipica,34500,4400,38900
12361,12362,21-10-2020 15:33:55.673086,Pizza · Italiana,Piatto - Pizza,23000,6600,29600
12362,12363,21-10-2020 15:33:55.962694,Desayunos · Café,Norma's Ice Cream Café,29500,6300,35800
12363,12364,21-10-2020 15:33:56.202125,Sushi,Umi,9000,5600,14600
12364,12365,21-10-2020 15:33:56.391658,Peruana,Masivo,13600,5800,19400
12365,12366,21-10-2020 15:33:56.532056,Desayunos · Panadería,Ficchi Panadería,35000,3100,38100
12366,12367,21-10-2020 15:33:56.871491,Desayunos,Jacinta Arepas de Huevo,15000,4000,19000
12367,12368,21-10-2020 15:33:57.160937,Desayunos · Panadería,Santa Juana Food Bar,15600,5900,21500
12368,12369,21-10-2020 15:33:57.500606,Desayunos · Empanadas,Mis Delicias,10700,3200,13900
12369,12370,21-10-2020 15:33:57.639821,Pollo · Sánduches,Pollos Century,24300,3000,27300
12370,12371,21-10-2020 15:33:57.879063,Desayunos,La Frijolada Desayunos,17800,4400,22200
12371,12372,21-10-2020 15:33:58.017940,Italiana,F*cking Good Pizza,29500,4200,33700
12372,12373,21-10-2020 15:33:58.157222,Postres · Café,Celestino Café,37900,5900,43800
12373,12374,21-10-2020 15:33:58.346106,Desayunos · Jugos y Batidos,Dont Be Hungry,53400,5600,59000
12374,12375,21-10-2020 15:33:58.486202,Típica,Sabrosito,23000,4000,27000
12375,12376,21-10-2020 15:33:58.775226,Peruana,Masivo,35000,5800,40800
12376,12377,21-10-2020 15:33:58.914459,Alta Cocina · Italiana,Trattoria de la Plaza,24300,6000,30300
12377,12378,21-10-2020 15:33:59.153979,Alta Cocina · Postres,La Pinta,17800,4500,22300
12378,12379,21-10-2020 15:33:59.343622,Desayunos · Típica,D'Porco - Lechona,29500,6300,35800
12379,12380,21-10-2020 15:33:59.533423,Desayunos · Típica,Rojo Gourmet,8900,4700,13600
12380,12381,21-10-2020 15:33:59.822996,Postres,Levelma,23000,6200,29200
12381,12382,21-10-2020 15:34:00.012095,Pollo · Típica,Auyama,35000,3900,38900
12382,12383,21-10-2020 15:34:00.201583,Postres · Desayunos,Jacques Pastelería,35000,5900,40900
12383,12384,21-10-2020 15:34:00.591130,Pizza · Italiana,Pisapore - Pizza,17800,6600,24400
12384,12385,21-10-2020 15:34:00.730537,Parrilla,Restaurante Bar Mi Ranchito,27800,5200,33000
12385,12386,21-10-2020 15:34:01.120075,Típica · Parrilla,Toya,18900,4200,23100
12386,12387,21-10-2020 15:34:01.409734,Desayunos · Empanadas,Mis Delicias,15000,3200,18200
12387,12388,21-10-2020 15:34:01.599266,Sushi · Asiática,Arigato,37900,5300,43200
12388,12389,21-10-2020 15:34:01.738555,Desayunos · Típica,Fogón Sangileño,48750,5000,53750
12389,12390,21-10-2020 15:34:02.028016,Desayunos · Típica,Desayunadero de la 42,24200,5900,30100
12390,12391,21-10-2020 15:34:02.217560,Saludable,A2manos,31800,4200,36000
12391,12392,21-10-2020 15:34:02.507557,Pollo · Desayunos,Workzone,7500,3100,10600
12392,12393,21-10-2020 15:34:02.847105,Típica,Sabrosito,27800,4000,31800
12393,12394,21-10-2020 15:34:03.136515,Postres · Desayunos,La Folie - Postres,8900,3300,12200
12394,12395,21-10-2020 15:34:03.325813,Típica,Lo Nuestro,53900,3100,57000
12395,12396,21-10-2020 15:34:03.465155,Desayunos,Don Leo,29500,6000,35500
12396,12397,21-10-2020 15:34:03.806080,Parrilla,Carnes la Zarza,45800,4900,50700
12397,12398,21-10-2020 15:34:04.195646,Pollo,Heart & Cooking,10700,5000,15700
12398,12399,21-10-2020 15:34:04.384992,Desayunos · Parrilla,Mi Patria,35000,4600,39600
12399,12400,21-10-2020 15:34:04.724795,Desayunos · Café,Frambas,65000,3400,68400
12400,12401,21-10-2020 15:34:04.864363,Desayunos · Panadería,Siena Café,31800,3700,35500
12401,12402,21-10-2020 15:34:05.254357,Desayunos,Don Leo,24200,6000,30200
12402,12403,21-10-2020 15:34:05.594326,Desayunos · Panadería,Siena Café,13600,3700,17300
12403,12404,21-10-2020 15:34:05.783759,Pizza · Italiana,Pisapore - Pizza,45800,6600,52400
12404,12405,21-10-2020 15:34:06.123424,Desayunos · Parrilla,Mi Patria,23000,4600,27600
12405,12406,21-10-2020 15:34:06.262491,Típica,Salsig,35000,5600,40600
12406,12407,21-10-2020 15:34:06.501805,Postres · Desayunos,Café Quindio,9000,5700,14700
12407,12408,21-10-2020 15:34:06.791300,Desayunos · Panadería,Limarys,53400,6500,59900
12408,12409,21-10-2020 15:34:06.930570,Típica,La Cocina,31800,4600,36400
12409,12410,21-10-2020 15:34:07.170332,Típica,La Olla de Barro,35000,5300,40300
12410,12411,21-10-2020 15:34:07.410285,Sánduches · Pescados y Mariscos,Pacific Comida de Mar,18900,4000,22900
12411,12412,21-10-2020 15:34:07.549546,Café · Helados,Sofia heladería y café,39700,5800,45500
12412,12413,21-10-2020 15:34:07.789293,Desayunos · Internacional,Camilia,8900,3900,12800
12413,12414,21-10-2020 15:34:08.078820,Parrilla,Arepaisa de Medellín,24300,5600,29900
12414,12415,21-10-2020 15:34:08.318686,Desayunos · Típica,Papadió - Colombianas,23000,5700,28700
12415,12416,21-10-2020 15:34:08.708684,Desayunos,El Corral - Desayunos,11870,5000,16870
12416,12417,21-10-2020 15:34:08.999075,Hamburguesas · Pescados y Mariscos,El Velero,8900,6500,15400
12417,12418,21-10-2020 15:34:09.388804,Desayunos · Café,El Gualilo,48750,6200,54950
12418,12419,21-10-2020 15:34:09.528492,Helados,Buon Gelato,15600,4400,20000
12419,12420,21-10-2020 15:34:09.718517,Perros Calientes,Dog Shop - Rapida,45800,4900,50700
12420,12421,21-10-2020 15:34:09.958303,Parrilla,Arepaisa de Medellín,65000,5600,70600
12421,12422,21-10-2020 15:34:10.097663,Postres · Desayunos,Cosmo Cookies,31800,5900,37700
12422,12423,21-10-2020 15:34:10.237209,Saludable · Desayunos,Re.al Alimentos Reales,23000,4000,27000
12423,12424,21-10-2020 15:34:10.476498,Saludable · Parrilla,Box,24300,3700,28000
12424,12425,21-10-2020 15:34:10.866201,Jugos y Batidos,Pomponio,7500,3600,11100
12425,12426,21-10-2020 15:34:11.005443,Saludable · Jugos y Batidos,Berdes Drinks & Salads,23000,3500,26500
12426,12427,21-10-2020 15:34:11.295183,Desayunos · Empanadas,Mis Delicias,13600,3200,16800
12427,12428,21-10-2020 15:34:11.684878,Desayunos · Panadería,Ficchi Panadería,53900,3100,57000
12428,12429,21-10-2020 15:34:11.924433,Pizza,Pizza Andante,13600,6300,19900
12429,12430,21-10-2020 15:34:12.263942,Saludable · Desayunos,La Estampilla,10700,6000,16700
12430,12431,21-10-2020 15:34:12.453486,Pollo,Señor Fantástico,15600,4700,20300
12431,12432,21-10-2020 15:34:12.643334,Desayunos · Típica,La Parrilla Dorada Polo,18900,6600,25500
12432,12433,21-10-2020 15:34:12.782813,Típica,Salsig,7500,5600,13100
12433,12434,21-10-2020 15:34:12.972365,Internacional,Rio Sabores y Experiencias,15600,4100,19700
12434,12435,21-10-2020 15:34:13.212715,Pollo · Desayunos,Candelina,29500,5300,34800
12435,12436,21-10-2020 15:34:13.452702,Desayunos · Jugos y Batidos,Frutiwow,65000,4100,69100
12436,12437,21-10-2020 15:34:13.642533,Saludable · Desayunos,Raices Bienestar Gourmet,13000,6600,19600
12437,12438,21-10-2020 15:34:14.032649,Desayunos · Típica,La Parrilla Dorada Polo,65000,6600,71600
12438,12439,21-10-2020 15:34:14.422467,Desayunos,El Fogón Castellano,8900,3200,12100
12439,12440,21-10-2020 15:34:14.812361,Peruana · Internacional,La Chifería,65000,6600,71600
12440,12441,21-10-2020 15:34:15.051674,Peruana · Internacional,La Chifería,10700,6600,17300
12441,12442,21-10-2020 15:34:15.441649,Desayunos · Panadería,Limarys,11870,6500,18370
12442,12443,21-10-2020 15:34:15.631322,Postres · Desayunos,Jacques Pastelería,15600,5900,21500
12443,12444,21-10-2020 15:34:16.021218,Desayunos · Panadería,Limarys,23000,6500,29500
12444,12445,21-10-2020 15:34:16.210834,Desayunos · Panadería,Siena Café,39700,3700,43400
12445,12446,21-10-2020 15:34:16.350353,Parrilla · Internacional,Taperia de la Plaza,65000,5700,70700
12446,12447,21-10-2020 15:34:16.540125,Saludable · Desayunos,Distrito Gourmet,12500,3700,16200
12447,12448,21-10-2020 15:34:16.930159,Sushi,Kim Pop,24300,5400,29700
12448,12449,21-10-2020 15:34:17.170383,Hamburguesas,Bendito Cordero,15000,5800,20800
12449,12450,21-10-2020 15:34:17.411113,Saludable · Desayunos,Bon Eat - Saludable,45800,4800,50600
12450,12451,21-10-2020 15:34:17.551662,Desayunos,Sr Buñuelo,23000,6400,29400
12451,12452,21-10-2020 15:34:17.942417,Pollo · Desayunos,Caserito Gourmet,37900,6700,44600
12452,12453,21-10-2020 15:34:18.182533,Crepes,La Chabatta,34500,5900,40400
12453,12454,21-10-2020 15:34:18.472329,Pizza,pizza andante,65000,4200,69200
12454,12455,21-10-2020 15:34:18.662192,Asiática,TeT,31800,5900,37700
12455,12456,21-10-2020 15:34:18.951762,Desayunos · Jugos y Batidos,Frutiwow,11870,4100,15970
12456,12457,21-10-2020 15:34:19.192735,Pollo,Chicken House,37900,4200,42100
12457,12458,21-10-2020 15:34:19.382050,Saludable · Parrilla,The Angels Grill and Drinks,11870,6200,18070
12458,12459,21-10-2020 15:34:19.722028,Pescados y Mariscos,Pescadero Héroes del Mar,65000,6600,71600
12459,12460,21-10-2020 15:34:19.962361,Italiana,Bocatto Di Passo,31800,5000,36800
12460,12461,21-10-2020 15:34:20.101895,Pizza,pizza andante,24300,4200,28500
12461,12462,21-10-2020 15:34:20.491970,Pollo · Desayunos,Candelina,18900,5300,24200
12462,12463,21-10-2020 15:34:20.631651,Parrilla,Carnes la Zarza,31800,4900,36700
12463,12464,21-10-2020 15:34:20.821388,Desayunos · Panadería,Juliana Restaurante,24200,6100,30300
12464,12465,21-10-2020 15:34:20.960898,Típica · Parrilla,Typykos,17800,6000,23800
12465,12466,21-10-2020 15:34:21.351063,Desayunos · Panadería,Premium Break Bakery,15000,3700,18700
12466,12467,21-10-2020 15:34:21.590793,Sánduches · China,Peru Mix,17800,5900,23700
12467,12468,21-10-2020 15:34:21.780458,Pollo · Sánduches,Pollos Century,11870,3000,14870
12468,12469,21-10-2020 15:34:22.120829,Postres · Desayunos,Maria Luisa - Postres,53400,4300,57700
12469,12470,21-10-2020 15:34:22.411278,Desayunos · Panadería,Le Pain Quotidien,37900,3900,41800
12470,12471,21-10-2020 15:34:22.601183,Sushi · Asiática,Tu Sushi,23000,6400,29400
12471,12472,21-10-2020 15:34:22.890717,Postres · Saludable,Ana Rebana,45800,6300,52100
12472,12473,21-10-2020 15:34:23.280926,Desayunos · Sánduches,Frutos del Bosque,8900,3500,12400
12473,12474,21-10-2020 15:34:23.571057,Pescados y Mariscos,Fish Place - Del Mar,27800,5400,33200
12474,12475,21-10-2020 15:34:23.961598,Helados,Orso To Go,17800,6800,24600
12475,12476,21-10-2020 15:34:24.303270,Parrilla,Restaurante Bar Mi Ranchito,29500,5200,34700
12476,12477,21-10-2020 15:34:24.593235,Internacional,La Esquina con Sabor Parrilla,27800,3000,30800
12477,12478,21-10-2020 15:34:24.983172,Desayunos · Típica,Papadió - Colombianas,53400,5700,59100
12478,12479,21-10-2020 15:34:25.172663,Saludable,Hanai - Bowls Saludables,39700,5900,45600
12479,12480,21-10-2020 15:34:25.562472,Desayunos · Panadería,Limarys,35000,6500,41500
12480,12481,21-10-2020 15:34:25.902254,Postres · Panadería,RIGHT AWAY FOODS,39700,6600,46300
12481,12482,21-10-2020 15:34:26.142049,Sánduches,Submarin,31800,3800,35600
12482,12483,21-10-2020 15:34:26.281769,Desayunos · Café,Matchacha,45800,5900,51700
12483,12484,21-10-2020 15:34:26.471328,Típica,La Olla de Barro,24200,5300,29500
12484,12485,21-10-2020 15:34:26.761317,Saludable,Amor Propio saludable,35000,4000,39000
12485,12486,21-10-2020 15:34:27.050729,Saludable · Desayunos,Guadalupe - Fruteria,15000,5900,20900
12486,12487,21-10-2020 15:34:27.190379,Mexicana,Cantina La 15,13600,4300,17900
12487,12488,21-10-2020 15:34:27.579992,Saludable · Desayunos,Básico y Elemental,15000,5900,20900
12488,12489,21-10-2020 15:34:27.970134,Hamburguesas,Burger Society,34500,4100,38600
12489,12490,21-10-2020 15:34:28.259919,Postres · Desayunos,Jacques Pastelería,34500,5900,40400
12490,12491,21-10-2020 15:34:28.499959,Desayunos · Típica,Rojo Gourmet,23000,4700,27700
12491,12492,21-10-2020 15:34:28.639613,Mexicana,Cantina La 15,70000,4300,74300
12492,12493,21-10-2020 15:34:28.929683,Desayunos · Café,Norma's Ice Cream Café,23000,6300,29300
12493,12494,21-10-2020 15:34:29.169345,Desayunos · Sánduches,Danilo Colombia,31800,3300,35100
12494,12495,21-10-2020 15:34:29.309937,Pollo,Señor Fantástico,12500,4700,17200
12495,12496,21-10-2020 15:34:29.700149,Típica,El Mondongo y Mucho Mas,35000,5600,40600
12496,12497,21-10-2020 15:34:29.889764,Postres · Helados,Mahé,17800,6000,23800
12497,12498,21-10-2020 15:34:30.029415,Pollo · Saludable,Tremenda Sal y Dulce,48750,6500,55250
12498,12499,21-10-2020 15:34:30.219159,Pizza,18 Scalini,70000,4300,74300
12499,12500,21-10-2020 15:34:30.409458,Desayunos · Empanadas,Empanadas Doraditas.com,15600,3000,18600
12500,12501,21-10-2020 15:34:30.799624,Alta Cocina · Postres,La Pinta,35000,4500,39500
12501,12502,21-10-2020 15:34:30.989842,Asiática,TeT,45800,5900,51700
12502,12503,21-10-2020 15:34:31.380005,Pollo,Oliva Va,8900,5600,14500
12503,12504,21-10-2020 15:34:31.669843,Pollo · Saludable,Tremenda Sal y Dulce,24200,6500,30700
12504,12505,21-10-2020 15:34:31.959801,Desayunos · Típica,90 Calentados,39700,3700,43400
12505,12506,21-10-2020 15:34:32.199531,Típica,Cazuelitas 93,23000,3900,26900
12506,12507,21-10-2020 15:34:32.589552,Desayunos · Comida Rápida,La Veneca,48750,6300,55050
12507,12508,21-10-2020 15:34:32.779157,Desayunos · Panadería,Premium Break Bakery,39700,3700,43400
12508,12509,21-10-2020 15:34:33.069024,Mexicana,Cantina La 15,29500,4300,33800
12509,12510,21-10-2020 15:34:33.459145,Parrilla,Antojo a Domicilio,34500,5000,39500
12510,12511,21-10-2020 15:34:33.749457,Desayunos · Típica,Papadió - Colombianas,13600,5700,19300
12511,12512,21-10-2020 15:34:34.139656,Parrilla,Restaurante Bar Mi Ranchito,31800,5200,37000
12512,12513,21-10-2020 15:34:34.531447,Típica · Parrilla,El Santandereano,24300,5200,29500
12513,12514,21-10-2020 15:34:34.871190,Sushi,Canoa To Go,53400,5900,59300
12514,12515,21-10-2020 15:34:35.261586,Pollo,Heart & Cooking,23000,5000,28000
12515,12516,21-10-2020 15:34:35.551130,Típica,El Cucharón - Tipica,39700,4400,44100
12516,12517,21-10-2020 15:34:35.891040,Postres · Café,Loló Coffee & Snacks,18900,4600,23500
12517,12518,21-10-2020 15:34:36.130847,Internacional,Rio Sabores y Experiencias,31800,4100,35900
12518,12519,21-10-2020 15:34:36.371032,Saludable · Desayunos,Malú,53400,3700,57100
12519,12520,21-10-2020 15:34:36.560595,Desayunos · Pescados y Mariscos,Luzí­a - Mediterranea,31800,5700,37500
12520,12521,21-10-2020 15:34:36.700442,Saludable · Jugos y Batidos,Berdes Drinks & Salads,15000,3500,18500
12521,12522,21-10-2020 15:34:36.939931,Desayunos · Pescados y Mariscos,Gypsy Bistro,7500,4500,12000
12522,12523,21-10-2020 15:34:37.130080,Típica,La Olla de Barro,27800,5300,33100
12523,12524,21-10-2020 15:34:37.420077,Pizza,pizza andante,23000,4200,27200
12524,12525,21-10-2020 15:34:37.710339,Desayunos · Típica,Calentao Express,53400,6000,59400
12525,12526,21-10-2020 15:34:37.899851,Saludable · Desayunos,Copacabana Açai Bowls,24300,3000,27300
12526,12527,21-10-2020 15:34:38.090046,Desayunos · Empanadas,Mis Delicias,53400,3200,56600
12527,12528,21-10-2020 15:34:38.480826,Desayunos · Árabe,Boniato Sabores Vivos,27800,5300,33100
12528,12529,21-10-2020 15:34:38.671443,Perros Calientes,Dog Shop - Rapida,70000,4900,74900
12529,12530,21-10-2020 15:34:38.811805,Pollo · Saludable,Gratina,17800,4200,22000
12530,12531,21-10-2020 15:34:39.202769,Hamburguesas · Panadería,NYC Burgers,34500,6200,40700
12531,12532,21-10-2020 15:34:39.544488,Típica,Juan Chorizo,10700,3900,14600
12532,12533,21-10-2020 15:34:39.835450,Saludable · Desayunos,Raices Bienestar Gourmet,13600,6600,20200
12533,12534,21-10-2020 15:34:40.075198,Postres · Desayunos,KOKOA & co.,7500,4700,12200
12534,12535,21-10-2020 15:34:40.315719,Café · Helados,Sofia heladería y café,37900,5800,43700
12535,12536,21-10-2020 15:34:40.655859,Comida Rápida · Perros Calientes,Similoa - Comida Rapida,53400,3700,57100
12536,12537,21-10-2020 15:34:40.846763,Desayunos · Panadería,Ficchi Panadería,29500,3100,32600
12537,12538,21-10-2020 15:34:41.036527,Postres · Desayunos,Restaurante Cornelia,15600,5500,21100
12538,12539,21-10-2020 15:34:41.227640,Desayunos · Panadería,Decofruta,35000,4700,39700
12539,12540,21-10-2020 15:34:41.417882,Desayunos · Panadería,Premium Break Bakery,13000,3700,16700
12540,12541,21-10-2020 15:34:41.808799,Desayunos · Comida Rápida,La Veneca,45800,6300,52100
12541,12542,21-10-2020 15:34:42.048958,Desayunos · Café,vereda central calle 99,9000,5700,14700
12542,12543,21-10-2020 15:34:42.390162,Parrilla,Restaurante Bar Mi Ranchito,7500,5200,12700
12543,12544,21-10-2020 15:34:42.780415,Típica,Bendita S,23000,4600,27600
12544,12545,21-10-2020 15:34:43.072045,Saludable · Desayunos,Malú,53400,3700,57100
12545,12546,21-10-2020 15:34:43.212129,Peruana · Internacional,La Chifería,9000,6600,15600
12546,12547,21-10-2020 15:34:43.352266,Parrilla,OAK Ahumado y Brebajes,23000,6000,29000
12547,12548,21-10-2020 15:34:43.742729,Desayunos · Típica,D´Porco,23000,3900,26900
12548,12549,21-10-2020 15:34:43.982843,Típica,La Herencia,23000,5900,28900
12549,12550,21-10-2020 15:34:44.323291,Postres · Panadería,RIGHT AWAY FOODS,17800,6600,24400
12550,12551,21-10-2020 15:34:44.463918,Pescados y Mariscos,Pescadero Héroes del Mar,45800,6600,52400
12551,12552,21-10-2020 15:34:44.805567,Desayunos,Sunny Breakfast Brunch,15000,4300,19300
12552,12553,21-10-2020 15:34:45.046049,Típica,Sopitas y Más,31800,4200,36000
12553,12554,21-10-2020 15:34:45.185691,Típica · Pescados y Mariscos,La Vitualla,35000,6300,41300
12554,12555,21-10-2020 15:34:45.525822,Saludable,Amor Propio saludable,35000,4000,39000
12555,12556,21-10-2020 15:34:45.865861,Típica,Bendita S,13600,4600,18200
12556,12557,21-10-2020 15:34:46.256308,Mexicana,Hidalgo Taquería,10700,4900,15600
12557,12558,21-10-2020 15:34:46.596360,Pizza · Italiana,Pisapore - Pizza,65000,6600,71600
12558,12559,21-10-2020 15:34:46.736438,Hamburguesas,Bendito Cordero,9000,5800,14800
12559,12560,21-10-2020 15:34:46.976139,Saludable,Puro Verde,27800,5700,33500
12560,12561,21-10-2020 15:34:47.215897,Desayunos · Típica,90 Calentados,24300,3700,28000
12561,12562,21-10-2020 15:34:47.455878,Pollo · Saludable,Yerbabuena,7500,3900,11400
12562,12563,21-10-2020 15:34:47.796332,Postres · Desayunos,La Folie - Postres,53900,3300,57200
12563,12564,21-10-2020 15:34:47.986160,Desayunos · Árabe,Boniato Sabores Vivos,9000,5300,14300
12564,12565,21-10-2020 15:34:48.126148,Postres · Desayunos,Cosmo Cookies,24300,5900,30200
12565,12566,21-10-2020 15:34:48.366880,Postres · Helados,Mahé,34500,6000,40500
12566,12567,21-10-2020 15:34:48.757093,Saludable · Desayunos,Básico y Elemental,10700,5900,16600
12567,12568,21-10-2020 15:34:49.046825,Saludable · Desayunos,La Cesta,18900,4700,23600
12568,12569,21-10-2020 15:34:49.387010,Desayunos · Italiana,Rceta By Rausch,24300,3600,27900
12569,12570,21-10-2020 15:34:49.577174,Desayunos · Mexicana,La Mera Mera - Mexicana,7500,3100,10600
12570,12571,21-10-2020 15:34:49.818237,Desayunos,Archies Desayunos,23000,3100,26100
12571,12572,21-10-2020 15:34:50.057933,Postres · Desayunos,Vivalight Market.,15000,6500,21500
12572,12573,21-10-2020 15:34:50.399032,Mexicana,Hidalgo Taquería,45800,4900,50700
12573,12574,21-10-2020 15:34:50.739130,Café · Helados,Sofia heladería y café,11870,5800,17670
12574,12575,21-10-2020 15:34:51.079457,Desayunos,Sr Buñuelo,11870,6400,18270
12575,12576,21-10-2020 15:34:51.319401,Desayunos · Panadería,Premium Break Bakery,24300,3700,28000
12576,12577,21-10-2020 15:34:51.509400,Saludable,Ventura Soup y Salad,35000,3800,38800
12577,12578,21-10-2020 15:34:51.700249,Saludable,MIMA,35000,3700,38700
12578,12579,21-10-2020 15:34:52.090964,Pizza,Pastas Laurentina,17800,4800,22600
12579,12580,21-10-2020 15:34:52.331045,Desayunos,Desayunos en Bogotá,11870,3400,15270
12580,12581,21-10-2020 15:34:52.571213,Desayunos · Típica,D´Porco,9000,3900,12900
12581,12582,21-10-2020 15:34:52.962029,Postres · Desayunos,Maltihelados,18900,6200,25100
12582,12583,21-10-2020 15:34:53.201959,Desayunos,Sunny Breakfast Brunch,35000,4300,39300
12583,12584,21-10-2020 15:34:53.541821,Panadería,Boul,35000,3100,38100
12584,12585,21-10-2020 15:34:53.681588,Saludable,The Good Rice Bowls,12500,3500,16000
12585,12586,21-10-2020 15:34:53.972352,Sánduches,Submarin,53900,3800,57700
12586,12587,21-10-2020 15:34:54.163125,Desayunos · Típica,La Parrilla Dorada Polo,13600,6600,20200
12587,12588,21-10-2020 15:34:54.504872,Desayunos · Italiana,Rceta By Rausch,35000,3600,38600
12588,12589,21-10-2020 15:34:54.695662,Desayunos,El Corral - Desayunos,65000,5000,70000
12589,12590,21-10-2020 15:34:54.888801,Pollo · Desayunos,Caserito Gourmet,39700,6700,46400
12590,12591,21-10-2020 15:34:55.229641,China,China Food Col,17800,3600,21400
12591,12592,21-10-2020 15:34:55.371679,Saludable,The Good Rice Bowls,15600,3500,19100
12592,12593,21-10-2020 15:34:55.561918,Saludable · Desayunos,Bawana - Sandwich,27800,3400,31200
12593,12594,21-10-2020 15:34:55.902489,Típica,Cabrito Santandereano,53400,6600,60000
12594,12595,21-10-2020 15:34:56.192712,Postres,Levelma,23000,6200,29200
12595,12596,21-10-2020 15:34:56.585439,Postres · Panadería,RIGHT AWAY FOODS,8900,6600,15500
12596,12597,21-10-2020 15:34:56.976081,Parrilla,OAK Ahumado y Brebajes,24300,6000,30300
12597,12598,21-10-2020 15:34:57.116575,Típica · Parrilla,Mi Ranchito Parrilla,15000,4400,19400
12598,12599,21-10-2020 15:34:57.256480,Pescados y Mariscos,La Gran Cazuela,13000,3200,16200
12599,12600,21-10-2020 15:34:57.548885,Desayunos · Panadería,El Pan de Phillippe,27800,4600,32400
12600,12601,21-10-2020 15:34:57.839361,Parrilla,Carnes la Zarza,70000,4900,74900
12601,12602,21-10-2020 15:34:58.030120,Desayunos · Panadería,Ficchi Panadería,8900,3100,12000
12602,12603,21-10-2020 15:34:58.320657,Desayunos · Típica,La Frijolada,24200,4500,28700
12603,12604,21-10-2020 15:34:58.663433,Hamburguesas,Gofi Burger,23000,5100,28100
12604,12605,21-10-2020 15:34:58.903890,Saludable,Puro Verde,15600,5700,21300
12605,12606,21-10-2020 15:34:59.244539,Helados,Buon Gelato,15000,4400,19400
12606,12607,21-10-2020 15:34:59.534514,Postres · Helados,Mahé,11870,6000,17870
12607,12608,21-10-2020 15:34:59.776827,Típica,Campo Victoria,37900,3000,40900
12608,12609,21-10-2020 15:35:00.118310,Desayunos · Café,Libertario Coffee Roasters,15600,4600,20200
12609,12610,21-10-2020 15:35:00.358470,Italiana,Bocatto Di Passo,13600,5000,18600
12610,12611,21-10-2020 15:35:00.748410,Saludable · Desayunos,La Cesta,11870,4700,16570
12611,12612,21-10-2020 15:35:01.040546,Típica,La Herencia,23000,5900,28900
12612,12613,21-10-2020 15:35:01.181322,Típica,Baondish,23000,5800,28800
12613,12614,21-10-2020 15:35:01.571965,Parrilla · Internacional,Taperia de la Plaza,31800,5700,37500
12614,12615,21-10-2020 15:35:01.812051,Parrilla · Café,Figaro Café/ Restaurante Argentino,12500,5800,18300
12615,12616,21-10-2020 15:35:02.054021,Italiana,Bocatto Di Passo,37900,5000,42900
12616,12617,21-10-2020 15:35:02.344085,Peruana,Uma Cantina Peruana,65000,3200,68200
12617,12618,21-10-2020 15:35:02.584051,Desayunos · Café,Frambas,23000,3400,26400
12618,12619,21-10-2020 15:35:02.823615,Desayunos · Típica,Rojo Gourmet,45800,4700,50500
12619,12620,21-10-2020 15:35:02.965731,Crepes,San Crepes,15600,4900,20500
12620,12621,21-10-2020 15:35:03.156086,Asiática,Thai Station,10700,6000,16700
12621,12622,21-10-2020 15:35:03.496453,Pollo,Chicken House,53400,4200,57600
12622,12623,21-10-2020 15:35:03.636288,Pizza · Italiana,Pisapore - Pizza,27800,6600,34400
12623,12624,21-10-2020 15:35:03.928065,Típica · Parrilla,Parrilla Farandula Gourmet,70000,5100,75100
12624,12625,21-10-2020 15:35:04.168472,Mexicana,La leyenda mexican kitchen,48750,3200,51950
12625,12626,21-10-2020 15:35:04.559128,Alta Cocina · Postres,La Pinta,24200,4500,28700
12626,12627,21-10-2020 15:35:04.949073,Saludable,Hanai - Bowls Saludables,24200,5900,30100
12627,12628,21-10-2020 15:35:05.191825,Saludable · Típica,Saludable Mrg,15600,5800,21400
12628,12629,21-10-2020 15:35:05.382243,Sushi · Asiática,Arigato,31800,5300,37100
12629,12630,21-10-2020 15:35:05.772394,Desayunos · Panadería,El Pan de Phillippe,37900,4600,42500
12630,12631,21-10-2020 15:35:06.062070,Hamburguesas · Pescados y Mariscos,El Velero,35000,6500,41500
12631,12632,21-10-2020 15:35:06.204076,Pollo · Desayunos,Workzone,23000,3100,26100
12632,12633,21-10-2020 15:35:06.544555,Saludable,Amor Propio saludable,12500,4000,16500
12633,12634,21-10-2020 15:35:06.884820,Típica,Sopitas y Más,34500,4200,38700
12634,12635,21-10-2020 15:35:07.075117,Desayunos · Panadería,Juliana Restaurante,17800,6100,23900
12635,12636,21-10-2020 15:35:07.317418,Típica,El Cucharón - Tipica,13600,4400,18000
12636,12637,21-10-2020 15:35:07.458479,Desayunos · Empanadas,Empanadas Doraditas.com,12500,3000,15500
12637,12638,21-10-2020 15:35:07.748801,Postres · Desayunos,Maltihelados,37900,6200,44100
12638,12639,21-10-2020 15:35:07.988689,Desayunos · Sánduches,Frutos del Bosque,70000,3500,73500
12639,12640,21-10-2020 15:35:08.131332,Postres · Desayunos,Jacques Pastelería,27800,5900,33700
12640,12641,21-10-2020 15:35:08.322447,Mexicana,Hidalgo Taquería,13000,4900,17900
12641,12642,21-10-2020 15:35:08.663029,Desayunos · Panadería,Santa Juana Food Bar,37900,5900,43800
12642,12643,21-10-2020 15:35:09.052952,Desayunos,Archies Desayunos,45800,3100,48900
12643,12644,21-10-2020 15:35:09.395261,Desayunos · Jugos y Batidos,Frutiwow,53900,4100,58000
12644,12645,21-10-2020 15:35:09.786528,Típica,Salsig,65000,5600,70600
12645,12646,21-10-2020 15:35:09.926826,Saludable · Típica,Sopas Mrg,18900,3100,22000
12646,12647,21-10-2020 15:35:10.166897,Desayunos · Típica,Alce,53900,4900,58800
12647,12648,21-10-2020 15:35:10.560248,Parrilla · Café,Gaira Café,45800,4400,50200
12648,12649,21-10-2020 15:35:10.750819,Sushi,Canoa To Go,53900,5900,59800
12649,12650,21-10-2020 15:35:10.941402,Típica,Juan Chorizo,39700,3900,43600
12650,12651,21-10-2020 15:35:11.181416,Parrilla,Parrilla Pimentón,27800,3400,31200
12651,12652,21-10-2020 15:35:11.473803,Típica,La Olla de Barro,37900,5300,43200
12652,12653,21-10-2020 15:35:11.714735,Saludable,Ventura Soup y Salad,24300,3800,28100
12653,12654,21-10-2020 15:35:11.955355,Parrilla,Campocina,9000,4600,13600
12654,12655,21-10-2020 15:35:12.195385,Pizza · Italiana,Piatto - Pizza,65000,6600,71600
12655,12656,21-10-2020 15:35:12.537763,Alta Cocina · Italiana,Trattoria de la Plaza,17800,6000,23800
12656,12657,21-10-2020 15:35:12.727977,Parrilla,Antojo a Domicilio,23000,5000,28000
12657,12658,21-10-2020 15:35:13.118367,Desayunos · Típica,La Frijolada,18900,4500,23400
12658,12659,21-10-2020 15:35:13.308385,Desayunos · Jugos y Batidos,Dont Be Hungry,18900,5600,24500
12659,12660,21-10-2020 15:35:13.650708,Desayunos · Típica,Alce,53900,4900,58800
12660,12661,21-10-2020 15:35:14.041395,Típica · Parrilla,Parrilla Farandula Gourmet,13000,5100,18100
12661,12662,21-10-2020 15:35:14.381722,Desayunos · Panadería,El Pan de Phillippe,17800,4600,22400
12662,12663,21-10-2020 15:35:14.721932,Parrilla,Arepaisa de Medellín,35000,5600,40600
12663,12664,21-10-2020 15:35:15.114493,Desayunos · Comida Rápida,Chocolatto,34500,3400,37900
12664,12665,21-10-2020 15:35:15.455578,Postres · Desayunos,KOKOA & co.,13000,4700,17700
12665,12666,21-10-2020 15:35:15.596536,Desayunos · Típica,Alce,23000,4900,27900
12666,12667,21-10-2020 15:35:15.886737,Típica,Sabrosito,8900,4000,12900
12667,12668,21-10-2020 15:35:16.229419,Mexicana,Hidalgo Taquería,65000,4900,69900
12668,12669,21-10-2020 15:35:16.519580,Parrilla · Internacional,Taperia de la Plaza,18900,5700,24600
12669,12670,21-10-2020 15:35:16.910380,Desayunos · Pescados y Mariscos,Luzí­a - Mediterranea,11870,5700,17570
12670,12671,21-10-2020 15:35:17.300457,Internacional,La Esquina con Sabor Parrilla,23000,3000,26000
12671,12672,21-10-2020 15:35:17.492491,Parrilla,Arepaisa de Medellín,11870,5600,17470
12672,12673,21-10-2020 15:35:17.833086,Desayunos · Típica,D'Porco - Lechona,27800,6300,34100
12673,12674,21-10-2020 15:35:18.073367,Parrilla,Coquitas,24300,5600,29900
12674,12675,21-10-2020 15:35:18.263188,Típica,Sabrosito,15000,4000,19000
12675,12676,21-10-2020 15:35:18.455235,Saludable,MIMA,15600,3700,19300
12676,12677,21-10-2020 15:35:18.746294,Peruana · Internacional,La Chifería,9000,6600,15600
12677,12678,21-10-2020 15:35:18.887180,Desayunos · Empanadas,Empanadas Doraditas.com,65000,3000,68000
12678,12679,21-10-2020 15:35:19.027533,Desayunos · Comida Rápida,Chocolatto,65000,3400,68400
12679,12680,21-10-2020 15:35:19.421450,Desayunos · Típica,Alce,29500,4900,34400
12680,12681,21-10-2020 15:35:19.662341,Parrilla · Café,Gaira Café,53900,4400,58300
12681,12682,21-10-2020 15:35:19.902883,Desayunos · Panadería,Santa Juana Food Bar,24200,5900,30100
12682,12683,21-10-2020 15:35:20.192987,Pollo · Saludable,Tremenda Sal y Dulce,53900,6500,60400
12683,12684,21-10-2020 15:35:20.435438,Saludable · Desayunos,Básico y elemental,29500,5000,34500
12684,12685,21-10-2020 15:35:20.776719,Típica,Bandejas Mrg,53900,3800,57700
12685,12686,21-10-2020 15:35:21.017059,Desayunos · Típica,Criollomania,10700,5200,15900
12686,12687,21-10-2020 15:35:21.156865,Postres · Desayunos,Maria Luisa - Postres,7500,4300,11800
12687,12688,21-10-2020 15:35:21.449317,Saludable · Desayunos,Libre de Culpa,23000,4000,27000
12688,12689,21-10-2020 15:35:21.639467,Desayunos · Típica,Papadió - Colombianas,39700,5700,45400
12689,12690,21-10-2020 15:35:21.980211,Jugos y Batidos,Pomponio,27800,3600,31400
12690,12691,21-10-2020 15:35:22.270446,Postres · Saludable,Ana Rebana,31800,6300,38100
12691,12692,21-10-2020 15:35:22.613037,Desayunos · Panadería,Artesanos,53400,4300,57700
12692,12693,21-10-2020 15:35:22.853685,Mexicana,Hidalgo Taquería,65000,4900,69900
12693,12694,21-10-2020 15:35:23.244350,China,China Food Col,15000,3600,18600
12694,12695,21-10-2020 15:35:23.534824,Hamburguesas · Saludable,Restaurant Inn,24200,6100,30300
12695,12696,21-10-2020 15:35:23.677039,Desayunos · Italiana,Rceta By Rausch,18900,3600,22500
12696,12697,21-10-2020 15:35:23.817765,Típica · Pescados y Mariscos,Arroces Mrg,45800,4300,50100
12697,12698,21-10-2020 15:35:23.958690,Hamburguesas · Desayunos,El Inglés Gastro Pub,13600,6600,20200
12698,12699,21-10-2020 15:35:24.149320,Desayunos · Panadería,Le Pain Quotidien,15000,3900,18900
12699,12700,21-10-2020 15:35:24.391988,Desayunos · Típica,Cochon,9000,3300,12300
12700,12701,21-10-2020 15:35:24.533309,Postres · Desayunos,Sharmus,15600,6100,21700
12701,12702,21-10-2020 15:35:24.924242,Saludable · Desayunos,Bon Eat - Saludable,23000,4800,27800
12702,12703,21-10-2020 15:35:25.164961,Típica,Cazuelitas 93,35000,3900,38900
12703,12704,21-10-2020 15:35:25.407499,Saludable,Ventura Soup y Salad,48750,3800,52550
12704,12705,21-10-2020 15:35:25.799108,Postres · Desayunos,Café Quindio,10700,5700,16400
12705,12706,21-10-2020 15:35:25.939207,Sánduches · Pescados y Mariscos,Pacific Comida de Mar,15000,4000,19000
12706,12707,21-10-2020 15:35:26.329603,Crepes,San Crepes,29500,4900,34400
12707,12708,21-10-2020 15:35:26.721965,Típica,Bandejas Mrg,27800,3800,31600
12708,12709,21-10-2020 15:35:26.912413,Parrilla,Rústico Picadería,11870,3800,15670
12709,12710,21-10-2020 15:35:27.303088,Típica,Bendita S,23000,4600,27600
12710,12711,21-10-2020 15:35:27.643392,Desayunos · Panadería,Artesanos,37900,4300,42200
12711,12712,21-10-2020 15:35:27.935975,Pollo · Típica,Auyama,34500,3900,38400
12712,12713,21-10-2020 15:35:28.326672,Parrilla,Coquitas,65000,5600,70600
12713,12714,21-10-2020 15:35:28.667382,Postres · Desayunos,Maltihelado,15600,4500,20100
12714,12715,21-10-2020 15:35:29.057752,Postres · Desayunos,BagBog Bagels,12500,6400,18900
12715,12716,21-10-2020 15:35:29.400173,Desayunos · Típica,D´Porco,34500,3900,38400
12716,12717,21-10-2020 15:35:29.640742,Saludable · Desayunos,Básico y elemental,31800,5000,36800
12717,12718,21-10-2020 15:35:29.981365,Típica · Parrilla,La Ternera Parrilla,24300,5200,29500
12718,12719,21-10-2020 15:35:30.371276,Típica · Parrilla,El Santandereano,11870,5200,17070
12719,12720,21-10-2020 15:35:30.764157,Postres,Beiked,35000,4000,39000
12720,12721,21-10-2020 15:35:31.105676,Sushi · Desayunos,Maki Roll,27800,4300,32100
12721,12722,21-10-2020 15:35:31.396284,Típica,Campo Victoria,13000,3000,16000
12722,12723,21-10-2020 15:35:31.594833,Hamburguesas,Gofi Burger,34500,5100,39600
12723,12724,21-10-2020 15:35:31.887154,Alta Cocina · Parrilla,Criterión,15600,6000,21600
12724,12725,21-10-2020 15:35:32.177816,Alta Cocina · Italiana,Trattoria de la Plaza,31800,6000,37800
12725,12726,21-10-2020 15:35:32.568712,Postres · Helados,Mahé,31800,6000,37800
12726,12727,21-10-2020 15:35:32.959365,Pizza · Italiana,Piatto - Pizza,7500,6600,14100
12727,12728,21-10-2020 15:35:33.351928,Helados,Orso To Go,35000,6800,41800
12728,12729,21-10-2020 15:35:33.692651,Desayunos · Panadería,Ficchi Panadería,18900,3100,22000
12729,12730,21-10-2020 15:35:33.883309,Típica · Parrilla,El Portal de la Antigua,23000,5600,28600
12730,12731,21-10-2020 15:35:34.223899,Jugos y Batidos,Pomponio,23000,3600,26600
12731,12732,21-10-2020 15:35:34.366521,Desayunos · Típica,Papadió - Colombianas,15000,5700,20700
12732,12733,21-10-2020 15:35:34.507074,Saludable · Desayunos,Malú,37900,3700,41600
12733,12734,21-10-2020 15:35:34.847560,Desayunos · Italiana,Rceta By Rausch,24200,3600,27800
12734,12735,21-10-2020 15:35:35.187775,Sánduches · China,Peru Mix,53900,5900,59800
12735,12736,21-10-2020 15:35:35.580420,Desayunos · Típica,Parrilla Farandula Típico,10700,5900,16600
12736,12737,21-10-2020 15:35:35.771130,Pescados y Mariscos,Fish Place - Del Mar,8900,5400,14300
12737,12738,21-10-2020 15:35:35.961926,Típica,Salsig,13600,5600,19200
12738,12739,21-10-2020 15:35:36.203292,Desayunos · Pescados y Mariscos,Gypsy Bistro,15600,4500,20100
12739,12740,21-10-2020 15:35:36.596277,Postres · Desayunos,Sharmus,23000,6100,29100
12740,12741,21-10-2020 15:35:36.937354,Desayunos · Panadería,Juliana Restaurante,70000,6100,76100
12741,12742,21-10-2020 15:35:37.278570,Saludable · Desayunos,Guadalupe - Fruteria,35000,5900,40900
12742,12743,21-10-2020 15:35:37.419600,Postres · Desayunos,Cosmo Cookies,27800,5900,33700
12743,12744,21-10-2020 15:35:37.662456,Típica · Parrilla,El Portal de la Antigua,13000,5600,18600
12744,12745,21-10-2020 15:35:38.053311,Saludable · Desayunos,Re.al Alimentos Reales,13000,4000,17000
12745,12746,21-10-2020 15:35:38.244151,Saludable · Desayunos,La Cesta,15600,4700,20300
12746,12747,21-10-2020 15:35:38.534696,Típica,Lo Nuestro,24200,3100,27300
12747,12748,21-10-2020 15:35:38.776981,Desayunos · Típica,Cochon,7500,3300,10800
12748,12749,21-10-2020 15:35:38.967839,Desayunos,Archies Desayunos,23000,3100,26100
12749,12750,21-10-2020 15:35:39.108767,Desayunos · Típica,Calentao Express,34500,6000,40500
12750,12751,21-10-2020 15:35:39.399475,Desayunos · Helados,San Giorgio Gelateria,17800,3100,20900
12751,12752,21-10-2020 15:35:39.742319,Saludable,A2manos,31800,4200,36000
12752,12753,21-10-2020 15:35:39.982907,Postres · Desayunos,KOKOA & co.,29500,4700,34200
12753,12754,21-10-2020 15:35:40.174325,Saludable,A2manos,70000,4200,74200
12754,12755,21-10-2020 15:35:40.415158,Desayunos,Sr Buñuelo,37900,6400,44300
12755,12756,21-10-2020 15:35:40.607667,Pizza,18 Scalini,9000,4300,13300
12756,12757,21-10-2020 15:35:40.748053,Crepes,San Crepes,23000,4900,27900
12757,12758,21-10-2020 15:35:41.138831,Postres · Desayunos,Maltihelados,7500,6200,13700
12758,12759,21-10-2020 15:35:41.280257,Saludable,The Good Rice Bowls,18900,3500,22400
12759,12760,21-10-2020 15:35:41.623224,Postres · Helados,Mahé,7500,6000,13500
12760,12761,21-10-2020 15:35:41.914020,Pizza,Pizza Andante,23000,6300,29300
12761,12762,21-10-2020 15:35:42.054287,Desayunos · Panadería,Santa Juana Food Bar,23000,5900,28900
12762,12763,21-10-2020 15:35:42.194624,Panadería,Boul,7500,3100,10600
12763,12764,21-10-2020 15:35:42.587179,Postres · Desayunos,Cosmo Cookies,70000,5900,75900
12764,12765,21-10-2020 15:35:42.927944,Postres,Toledo Pastelería,39700,6800,46500
12765,12766,21-10-2020 15:35:43.168704,Desayunos · Sánduches,Danilo Colombia,29500,3300,32800
12766,12767,21-10-2020 15:35:43.509155,Saludable · Desayunos,La Cesta,8900,4700,13600
12767,12768,21-10-2020 15:35:43.801547,Desayunos · Empanadas,Empanadas Doraditas.com,24300,3000,27300
12768,12769,21-10-2020 15:35:44.192373,Desayunos,Cafetería el Kippe,9000,3200,12200
12769,12770,21-10-2020 15:35:44.333325,Pizza,pizza andante,17800,4200,22000
12770,12771,21-10-2020 15:35:44.673723,Desayunos · Típica,Desayunadero de la 42,23000,5900,28900
12771,12772,21-10-2020 15:35:45.016444,Crepes,La Chabatta,34500,5900,40400
12772,12773,21-10-2020 15:35:45.357254,Desayunos · Jugos y Batidos,Frutiwow,53900,4100,58000
12773,12774,21-10-2020 15:35:45.698026,Peruana,Masivo,35000,5800,40800
12774,12775,21-10-2020 15:35:45.988211,Típica · Parrilla,Toya,12500,4200,16700
12775,12776,21-10-2020 15:35:46.230936,Desayunos · Café,Libertario Coffee Roasters,24200,4600,28800
12776,12777,21-10-2020 15:35:46.623043,Parrilla,Rústico Picadería,31800,3800,35600
12777,12778,21-10-2020 15:35:46.763625,Desayunos · Café,Matchacha,17800,5900,23700
12778,12779,21-10-2020 15:35:47.154444,Típica,Lo Nuestro,12500,3100,15600
12779,12780,21-10-2020 15:35:47.496830,Desayunos · Panadería,Siena Café,10700,3700,14400
12780,12781,21-10-2020 15:35:47.787456,Desayunos · Café,Libertario Coffee Roasters,65000,4600,69600
12781,12782,21-10-2020 15:35:48.078093,Postres,Beiked,70000,4000,74000
12782,12783,21-10-2020 15:35:48.268264,Postres · Desayunos,Restaurante Cornelia,37900,5500,43400
12783,12784,21-10-2020 15:35:48.460881,Peruana,Masivo,53400,5800,59200
12784,12785,21-10-2020 15:35:48.801511,Desayunos · Jugos y Batidos,Frutiwow,31800,4100,35900
12785,12786,21-10-2020 15:35:49.192069,Pollo · Pescados y Mariscos,Bang Bang Rice,13600,3400,17000
12786,12787,21-10-2020 15:35:49.482697,Desayunos · Sánduches,Garnish,27800,5200,33000
12787,12788,21-10-2020 15:35:49.775663,Desayunos · Comida Rápida,La Veneca,45800,6300,52100
12788,12789,21-10-2020 15:35:50.016373,Desayunos · Árabe,Boniato Sabores Vivos,13600,5300,18900
12789,12790,21-10-2020 15:35:50.357282,Saludable,MIMA,65000,3700,68700
12790,12791,21-10-2020 15:35:50.597545,Desayunos · Pescados y Mariscos,Luzí­a - Mediterranea,48750,5700,54450
12791,12792,21-10-2020 15:35:50.890158,Típica · Parrilla,Parrilla Farandula Gourmet,17800,5100,22900
12792,12793,21-10-2020 15:35:51.230983,Postres · Desayunos,Amelie Helados,10700,6400,17100
12793,12794,21-10-2020 15:35:51.571775,Típica · Parrilla,La Ternera Parrilla,24200,5200,29400
12794,12795,21-10-2020 15:35:51.963955,Típica,El Cucharón - Tipica,24300,4400,28700
12795,12796,21-10-2020 15:35:52.307129,Pollo · Desayunos,Piaf,8900,6500,15400
12796,12797,21-10-2020 15:35:52.447566,Desayunos · Sánduches,Garnish,24300,5200,29500
12797,12798,21-10-2020 15:35:52.788250,Desayunos · Típica,Fogón Sangileño,11870,5000,16870
12798,12799,21-10-2020 15:35:53.078468,Típica · Pescados y Mariscos,La Vitualla,13600,6300,19900
12799,12800,21-10-2020 15:35:53.221260,Típica,Cazuelitas 93,7500,3900,11400
12800,12801,21-10-2020 15:35:53.362915,Saludable · Típica,Sopas Mrg,17800,3100,20900
12801,12802,21-10-2020 15:35:53.604134,Crepes,San Crepes,24300,4900,29200
12802,12803,21-10-2020 15:35:53.995084,Desayunos · Panadería,Pasteleite,35000,5900,40900
12803,12804,21-10-2020 15:35:54.337931,Típica,Bendita S,37900,4600,42500
12804,12805,21-10-2020 15:35:54.628899,Saludable · Desayunos,Copacabana Açai Bowls,45800,3000,48800
12805,12806,21-10-2020 15:35:54.869898,Pollo,Heart & Cooking,18900,5000,23900
12806,12807,21-10-2020 15:35:55.060000,Internacional,Rio Sabores y Experiencias,17800,4100,21900
12807,12808,21-10-2020 15:35:55.352503,Saludable,Hanai - Bowls Saludables,34500,5900,40400
12808,12809,21-10-2020 15:35:55.743372,Desayunos · Pescados y Mariscos,Luzí­a - Mediterranea,27800,5700,33500
12809,12810,21-10-2020 15:35:56.084440,Desayunos,Desayunos en Bogotá,10700,3400,14100
12810,12811,21-10-2020 15:35:56.324815,Sánduches · Pescados y Mariscos,Pacific Comida de Mar,18900,4000,22900
12811,12812,21-10-2020 15:35:56.617582,Pollo · Pescados y Mariscos,Bang Bang Rice,31800,3400,35200
12812,12813,21-10-2020 15:35:56.908247,Típica,Baondish,15000,5800,20800
12813,12814,21-10-2020 15:35:57.049655,Saludable,A2manos,35000,4200,39200
12814,12815,21-10-2020 15:35:57.339956,Desayunos · Mexicana,La Mera Mera - Mexicana,53900,3100,57000
12815,12816,21-10-2020 15:35:57.582333,Postres,Beiked,15600,4000,19600
12816,12817,21-10-2020 15:35:57.723036,Saludable · Desayunos,Re.al Alimentos Reales,11870,4000,15870
12817,12818,21-10-2020 15:35:58.114285,Panadería,Boul,11870,3100,14970
12818,12819,21-10-2020 15:35:58.454539,Pizza · Italiana,Piatto - Pizza,31800,6600,38400
12819,12820,21-10-2020 15:35:58.797261,Crepes,La Chabatta,23000,5900,28900
12820,12821,21-10-2020 15:35:59.087910,Hamburguesas,Bendito Cordero,13000,5800,18800
12821,12822,21-10-2020 15:35:59.228412,Postres · Saludable,Ana Rebana,48750,6300,55050
12822,12823,21-10-2020 15:35:59.369040,Pollo · Desayunos,Candelina,12500,5300,17800
12823,12824,21-10-2020 15:35:59.561815,Saludable · Desayunos,Agua Dulce,17800,3700,21500
12824,12825,21-10-2020 15:35:59.802490,Parrilla,Rústico Picadería,7500,3800,11300
12825,12826,21-10-2020 15:36:00.043238,Parrilla,OAK Ahumado y Brebajes,7500,6000,13500
12826,12827,21-10-2020 15:36:00.233946,Parrilla · Café,Figaro Café/ Restaurante Argentino,10700,5800,16500
12827,12828,21-10-2020 15:36:00.627275,Pizza,pizza andante,37900,4200,42100
12828,12829,21-10-2020 15:36:00.867848,Desayunos · Típica,La Frijolada,48750,4500,53250
12829,12830,21-10-2020 15:36:01.108674,Postres · Café,Celestino Café,15600,5900,21500
12830,12831,21-10-2020 15:36:01.299129,Desayunos,Sunny Breakfast Brunch,12500,4300,16800
12831,12832,21-10-2020 15:36:01.692186,Saludable,Hanai - Bowls Saludables,70000,5900,75900
12832,12833,21-10-2020 15:36:01.932938,Típica,Sopitas y Más,53400,4200,57600
12833,12834,21-10-2020 15:36:02.124405,Típica,Salsig,15000,5600,20600
12834,12835,21-10-2020 15:36:02.364880,Saludable · Desayunos,Bon Eat - Saludable,45800,4800,50600
12835,12836,21-10-2020 15:36:02.707822,Pizza,pizza andante,24300,4200,28500
12836,12837,21-10-2020 15:36:03.048533,Desayunos · Café,Moramia,53400,4700,58100
12837,12838,21-10-2020 15:36:03.389748,Típica · Parrilla,La Parilla de David,15600,3100,18700
12838,12839,21-10-2020 15:36:03.780690,Pizza · Italiana,Piatto - Pizza,29500,6600,36100
12839,12840,21-10-2020 15:36:03.973316,Desayunos · Sánduches,Garnish,34500,5200,39700
12840,12841,21-10-2020 15:36:04.314483,Desayunos · Típica,La Frijolada,27800,4500,32300
12841,12842,21-10-2020 15:36:04.605533,Postres,La Galeta,35000,3000,38000
12842,12843,21-10-2020 15:36:04.896095,Postres · Desayunos,Sweet Tale,18900,5800,24700
12843,12844,21-10-2020 15:36:05.038672,Típica · Pescados y Mariscos,La Vitualla,8900,6300,15200
12844,12845,21-10-2020 15:36:05.179267,Parrilla,Campocina,15600,4600,20200
12845,12846,21-10-2020 15:36:05.520209,Típica · Parrilla,Toya,12500,4200,16700
12846,12847,21-10-2020 15:36:05.760719,Desayunos · Panadería,Pasteleite,29500,5900,35400
12847,12848,21-10-2020 15:36:06.153604,Italiana,Bocatto Di Passo,7500,5000,12500
12848,12849,21-10-2020 15:36:06.494647,Desayunos · Panadería,Ficchi Panadería,39700,3100,42800
12849,12850,21-10-2020 15:36:06.785562,Pizza,Pastas Laurentina,24300,4800,29100
12850,12851,21-10-2020 15:36:07.076246,Típica,La Olla de Barro,29500,5300,34800
12851,12852,21-10-2020 15:36:07.220249,Pescados y Mariscos,La Gran Cazuela,13000,3200,16200
12852,12853,21-10-2020 15:36:07.511529,Saludable · Desayunos,Agua Dulce,23000,3700,26700
12853,12854,21-10-2020 15:36:07.902698,Desayunos · Pescados y Mariscos,Luzí­a - Mediterranea,24200,5700,29900
12854,12855,21-10-2020 15:36:08.143160,Desayunos · Comida Rápida,Chocolatto,70000,3400,73400
12855,12856,21-10-2020 15:36:08.335926,Crepes,San Crepes,23000,4900,27900
12856,12857,21-10-2020 15:36:08.627643,Desayunos,Señor Desayuno,35000,6800,41800
12857,12858,21-10-2020 15:36:08.818396,Desayunos,Archies Desayunos,53900,3100,57000
12858,12859,21-10-2020 15:36:09.159071,Sánduches,Submarin,35000,3800,38800
12859,12860,21-10-2020 15:36:09.451885,Postres · Desayunos,Vivalight Market.,53900,6500,60400
12860,12861,21-10-2020 15:36:09.843175,Típica,El Cucharón - Tipica,24200,4400,28600
12861,12862,21-10-2020 15:36:10.084104,Desayunos · Panadería,Limarys,65000,6500,71500
12862,12863,21-10-2020 15:36:10.224610,Internacional,Rio Sabores y Experiencias,18900,4100,23000
12863,12864,21-10-2020 15:36:10.567458,Alta Cocina · Italiana,Trattoria de la Plaza,23000,6000,29000
12864,12865,21-10-2020 15:36:10.908419,Desayunos · Pescados y Mariscos,Gypsy Bistro,35000,4500,39500
12865,12866,21-10-2020 15:36:11.299515,Desayunos · Panadería,Choclofee,15600,4700,20300
12866,12867,21-10-2020 15:36:11.590174,Pescados y Mariscos,La Gran Cazuela,24300,3200,27500
12867,12868,21-10-2020 15:36:11.832876,Saludable · Desayunos,Libre de Culpa,7500,4000,11500
12868,12869,21-10-2020 15:36:12.225156,Saludable · Desayunos,Bon Eat - Saludable,35000,4800,39800
12869,12870,21-10-2020 15:36:12.365786,Poke,Poke Go,53400,4600,58000
12870,12871,21-10-2020 15:36:12.556100,Desayunos · Panadería,Artesanos,15600,4300,19900
12871,12872,21-10-2020 15:36:12.949829,Saludable,Ventura Soup y Salad,13600,3800,17400
12872,12873,21-10-2020 15:36:13.340898,Desayunos,Sunny Breakfast Brunch,11870,4300,16170
12873,12874,21-10-2020 15:36:13.682238,Saludable · Desayunos,Bon Eat - Saludable,65000,4800,69800
12874,12875,21-10-2020 15:36:13.922812,Desayunos · Pescados y Mariscos,Luzí­a - Mediterranea,23000,5700,28700
12875,12876,21-10-2020 15:36:14.165555,Saludable · Desayunos,Raices Bienestar Gourmet,24200,6600,30800
12876,12877,21-10-2020 15:36:14.506714,Desayunos · Típica,Alce,53400,4900,58300
12877,12878,21-10-2020 15:36:14.797620,Sánduches · China,Peru Mix,24300,5900,30200
12878,12879,21-10-2020 15:36:15.138276,Saludable,The Good Rice Bowls,12500,3500,16000
12879,12880,21-10-2020 15:36:15.331193,Típica · Parrilla,El Portal de la Antigua,48750,5600,54350
12880,12881,21-10-2020 15:36:15.472505,Desayunos · Jugos y Batidos,Kuriwaji,18900,6300,25200
12881,12882,21-10-2020 15:36:15.763679,Pollo · Pescados y Mariscos,Bang Bang Rice,31800,3400,35200
12882,12883,21-10-2020 15:36:15.904378,Postres,Toledo Pastelería,11870,6800,18670
12883,12884,21-10-2020 15:36:16.197542,Hamburguesas,Bendito Cordero,27800,5800,33600
12884,12885,21-10-2020 15:36:16.438877,Comida Rápida,Fiesta Digital Andrés,23000,3100,26100
12885,12886,21-10-2020 15:36:16.780106,Típica · Parrilla,Parrilla Farandula Gourmet,23000,5100,28100
12886,12887,21-10-2020 15:36:16.970640,Desayunos · Típica,Cochon,31800,3300,35100
12887,12888,21-10-2020 15:36:17.365078,Parrilla,Antojo a Domicilio,24200,5000,29200
12888,12889,21-10-2020 15:36:17.556181,Desayunos · Mexicana,La Mera Mera - Mexicana,23000,3100,26100
12889,12890,21-10-2020 15:36:17.697317,Desayunos,Bagel Shop,24300,3200,27500
12890,12891,21-10-2020 15:36:18.088193,Desayunos,Archies Desayunos,45800,3100,48900
12891,12892,21-10-2020 15:36:18.231381,Típica,Campo Victoria,39700,3000,42700
12892,12893,21-10-2020 15:36:18.473237,Perros Calientes,Dog Shop - Rapida,18900,4900,23800
12893,12894,21-10-2020 15:36:18.864828,Desayunos · Panadería,Ficchi Panadería,24200,3100,27300
12894,12895,21-10-2020 15:36:19.005469,Pollo,Señor Fantástico,27800,4700,32500
12895,12896,21-10-2020 15:36:19.399010,Típica,Campo Victoria,10700,3000,13700
12896,12897,21-10-2020 15:36:19.790292,Típica · Parrilla,Mi Ranchito Parrilla,45800,4400,50200
12897,12898,21-10-2020 15:36:20.182005,Postres · Saludable,Ana Rebana,13000,6300,19300
12898,12899,21-10-2020 15:36:20.322369,Desayunos · Café,Matchacha,48750,5900,54650
12899,12900,21-10-2020 15:36:20.465583,Postres · Desayunos,Buñuelos nacho,8900,6600,15500
12900,12901,21-10-2020 15:36:20.756962,Desayunos · Típica,La Parrilla Dorada Polo,7500,6600,14100
12901,12902,21-10-2020 15:36:21.098118,Desayunos · Típica,Desayunadero de la 42,13600,5900,19500
12902,12903,21-10-2020 15:36:21.439395,Postres,La Galeta,37900,3000,40900
12903,12904,21-10-2020 15:36:21.732443,Postres · Desayunos,Gelateria Da Favola,15000,6500,21500
12904,12905,21-10-2020 15:36:22.073672,Postres · Desayunos,Café Quindio,15600,5700,21300
12905,12906,21-10-2020 15:36:22.465665,Postres,La Galeta,13600,3000,16600
12906,12907,21-10-2020 15:36:22.756399,Desayunos · Café,vereda central calle 99,24300,5700,30000
12907,12908,21-10-2020 15:36:23.049225,Parrilla · Café,Gaira Café,8900,4400,13300
12908,12909,21-10-2020 15:36:23.190048,Pollo · Pescados y Mariscos,Bang Bang Rice,9000,3400,12400
12909,12910,21-10-2020 15:36:23.531435,Postres · Desayunos,KOKOA & co.,12500,4700,17200
12910,12911,21-10-2020 15:36:23.722172,Postres · Desayunos,KOKOA & co.,24200,4700,28900
12911,12912,21-10-2020 15:36:23.964927,Desayunos · Típica,La Frijolada,35000,4500,39500
12912,12913,21-10-2020 15:36:24.155846,Desayunos · Panadería,Limarys,35000,6500,41500
12913,12914,21-10-2020 15:36:24.447268,Típica,Carbón & Mondongos,23000,6400,29400
12914,12915,21-10-2020 15:36:24.738231,Pollo,Heart & Cooking,10700,5000,15700
12915,12916,21-10-2020 15:36:24.981056,Desayunos · Panadería,Artesanos,29500,4300,33800
12916,12917,21-10-2020 15:36:25.222712,Típica · Pescados y Mariscos,La Vitualla,13600,6300,19900
12917,12918,21-10-2020 15:36:25.363488,Desayunos · Típica,Cochon,9000,3300,12300
12918,12919,21-10-2020 15:36:25.654645,Postres · Desayunos,Amelie Helados,53400,6400,59800
12919,12920,21-10-2020 15:36:25.797599,Típica,Lo Nuestro,70000,3100,73100
12920,12921,21-10-2020 15:36:26.038349,Pollo · China,China Tao,27800,3500,31300
12921,12922,21-10-2020 15:36:26.429526,Postres · Café,Celestino Café,24200,5900,30100
12922,12923,21-10-2020 15:36:26.770374,Pizza,pizza andante,7500,4200,11700
12923,12924,21-10-2020 15:36:27.113623,Saludable · Desayunos,Libre de Culpa,24300,4000,28300
12924,12925,21-10-2020 15:36:27.405018,Pizza,Pastas Laurentina,48750,4800,53550
12925,12926,21-10-2020 15:36:27.597074,Saludable,The Good Rice Bowls,29500,3500,33000
12926,12927,21-10-2020 15:36:27.888016,Postres · Desayunos,Sharmus,24300,6100,30400
12927,12928,21-10-2020 15:36:28.131588,Postres · Desayunos,La Folie - Postres,8900,3300,12200
12928,12929,21-10-2020 15:36:28.372656,Saludable · Desayunos,Fresh Co,10700,5600,16300
12929,12930,21-10-2020 15:36:28.613831,Desayunos · Café,Moramia,12500,4700,17200
12930,12931,21-10-2020 15:36:28.854352,Sushi · Asiática,Arigato,15600,5300,20900
12931,12932,21-10-2020 15:36:29.197586,Postres,La Tertulia,48750,3400,52150
12932,12933,21-10-2020 15:36:29.388551,Pescados y Mariscos,Fish Place - Del Mar,7500,5400,12900
12933,12934,21-10-2020 15:36:29.780117,Desayunos · Comida Rápida,Chocolatto,18900,3400,22300
12934,12935,21-10-2020 15:36:29.920729,Postres · Desayunos,Maltihelados,65000,6200,71200
12935,12936,21-10-2020 15:36:30.113728,Desayunos · Café,Norma's Ice Cream Café,17800,6300,24100
12936,12937,21-10-2020 15:36:30.305043,Parrilla,Campocina,35000,4600,39600
12937,12938,21-10-2020 15:36:30.696252,Parrilla · Internacional,Taperia de la Plaza,10700,5700,16400
12938,12939,21-10-2020 15:36:31.087230,Alta Cocina · Italiana,Trattoria de la Plaza,31800,6000,37800
12939,12940,21-10-2020 15:36:31.330163,Saludable,The Good Rice Bowls,65000,3500,68500
12940,12941,21-10-2020 15:36:31.521413,Desayunos,Fratelli - Desayunos,12500,4600,17100
12941,12942,21-10-2020 15:36:31.912570,Desayunos · Empanadas,Empanadas Doraditas.com,10700,3000,13700
12942,12943,21-10-2020 15:36:32.103371,Saludable · Desayunos,Bawana - Sandwich,34500,3400,37900
12943,12944,21-10-2020 15:36:32.396579,Típica,Salsig,23000,5600,28600
12944,12945,21-10-2020 15:36:32.789208,Típica · Pescados y Mariscos,Arroces Mrg,7500,4300,11800
12945,12946,21-10-2020 15:36:32.980196,Desayunos · Panadería,El Pan de Phillippe,29500,4600,34100
12946,12947,21-10-2020 15:36:33.321052,Saludable · Desayunos,Fresh Co,70000,5600,75600
12947,12948,21-10-2020 15:36:33.514687,Típica,Sabrosito,13000,4000,17000
12948,12949,21-10-2020 15:36:33.656068,Desayunos · Árabe,Boniato Sabores Vivos,9000,5300,14300
12949,12950,21-10-2020 15:36:33.947923,Desayunos · Helados,San Giorgio Gelateria,18900,3100,22000
12950,12951,21-10-2020 15:36:34.289340,Saludable · Desayunos,Raices Bienestar Gourmet,53900,6600,60500
12951,12952,21-10-2020 15:36:34.683123,Desayunos · Típica,Papadió - Colombianas,45800,5700,51500
12952,12953,21-10-2020 15:36:35.024721,Desayunos · Típica,La Parrilla Dorada Polo,13000,6600,19600
12953,12954,21-10-2020 15:36:35.416963,Postres · Desayunos,Protein Bakes,48750,5900,54650
12954,12955,21-10-2020 15:36:35.657645,Desayunos · Típica,Papadió - Colombianas,35000,5700,40700
12955,12956,21-10-2020 15:36:35.800683,Saludable · Desayunos,La Cesta,7500,4700,12200
12956,12957,21-10-2020 15:36:36.191834,Saludable,MIMA,65000,3700,68700
12957,12958,21-10-2020 15:36:36.333475,Desayunos · Sánduches,Danilo Colombia,31800,3300,35100
12958,12959,21-10-2020 15:36:36.474332,Saludable,The Good Rice Bowls,53400,3500,56900
12959,12960,21-10-2020 15:36:36.667405,Desayunos · Típica,Criollomania,34500,5200,39700
12960,12961,21-10-2020 15:36:37.058913,Típica,Sopitas y Más,7500,4200,11700
12961,12962,21-10-2020 15:36:37.400798,Parrilla,Rústico Picadería,8900,3800,12700
12962,12963,21-10-2020 15:36:37.642123,Desayunos,El Fogón Castellano,53900,3200,57100
12963,12964,21-10-2020 15:36:37.986477,Postres · Desayunos,Aury Postres - Comidas & Picadas,31800,4700,36500
12964,12965,21-10-2020 15:36:38.177402,Perros Calientes,Dog Shop - Rapida,11870,4900,16770
12965,12966,21-10-2020 15:36:38.568955,Típica,El Cucharón - Tipica,70000,4400,74400
12966,12967,21-10-2020 15:36:38.959894,Saludable · Típica,Saludable Mrg,48750,5800,54550
12967,12968,21-10-2020 15:36:39.153046,Sánduches,Submarin,13000,3800,16800
12968,12969,21-10-2020 15:36:39.544606,Postres · Café,Loló Coffee & Snacks,53900,4600,58500
12969,12970,21-10-2020 15:36:39.936451,Sánduches · China,Peru Mix,29500,5900,35400
12970,12971,21-10-2020 15:36:40.227601,Típica · Pescados y Mariscos,Arroces Mrg,7500,4300,11800
12971,12972,21-10-2020 15:36:40.421048,Postres · Desayunos,Café Quindio,39700,5700,45400
12972,12973,21-10-2020 15:36:40.562098,Postres · Desayunos,Café Quindio,37900,5700,43600
12973,12974,21-10-2020 15:36:40.703601,Hamburguesas · Alitas,Beer,53400,6600,60000
12974,12975,21-10-2020 15:36:40.944622,Postres · Desayunos,KOKOA & co.,13000,4700,17700
12975,12976,21-10-2020 15:36:41.238009,Peruana,Masivo,11870,5800,17670
12976,12977,21-10-2020 15:36:41.529107,Desayunos · Café,Matchacha,24200,5900,30100
12977,12978,21-10-2020 15:36:41.920166,Crepes,San Crepes,7500,4900,12400
12978,12979,21-10-2020 15:36:42.161037,Desayunos · Jugos y Batidos,Kuriwaji,10700,6300,17000
12979,12980,21-10-2020 15:36:42.404453,Desayunos,Sr Buñuelo,12500,6400,18900
12980,12981,21-10-2020 15:36:42.545509,Desayunos,Señor Desayuno,53900,6800,60700
12981,12982,21-10-2020 15:36:42.886863,Parrilla,Arroces Maria Paula,23000,6800,29800
12982,12983,21-10-2020 15:36:43.278408,Mexicana,Hidalgo Taquería,23000,4900,27900
12983,12984,21-10-2020 15:36:43.422372,Saludable,Amor Propio saludable,13600,4000,17600
12984,12985,21-10-2020 15:36:43.613986,Desayunos · Panadería,Limarys,24200,6500,30700
12985,12986,21-10-2020 15:36:43.805901,Desayunos · Típica,Fogón Sangileño,39700,5000,44700
12986,12987,21-10-2020 15:36:43.946801,Desayunos · Empanadas,Mis Delicias,35000,3200,38200
12987,12988,21-10-2020 15:36:44.290273,Desayunos · Panadería,El Pan de Phillippe,10700,4600,15300
12988,12989,21-10-2020 15:36:44.431982,Desayunos · Panadería,Decofruta,34500,4700,39200
12989,12990,21-10-2020 15:36:44.724750,Saludable · Desayunos,Agua Dulce,17800,3700,21500
12990,12991,21-10-2020 15:36:44.966579,Típica,Sopitas y Más,37900,4200,42100
12991,12992,21-10-2020 15:36:45.110802,Sushi · Asiática,Arigato,65000,5300,70300
12992,12993,21-10-2020 15:36:45.302940,Hamburguesas,Gofi Burger,35000,5100,40100
12993,12994,21-10-2020 15:36:45.545168,Sánduches · Pescados y Mariscos,Pacific Comida de Mar,48750,4000,52750
12994,12995,21-10-2020 15:36:45.737113,Postres · Desayunos,Maltihelado,15600,4500,20100
12995,12996,21-10-2020 15:36:46.081524,Desayunos · Panadería,Pasteleite,48750,5900,54650
12996,12997,21-10-2020 15:36:46.424561,Pollo · Pescados y Mariscos,Bang Bang Rice,48750,3400,52150
12997,12998,21-10-2020 15:36:46.817677,Sushi · Desayunos,Maki Roll,35000,4300,39300
12998,12999,21-10-2020 15:36:47.059548,Parrilla,Carnes la Zarza,13600,4900,18500
12999,13000,21-10-2020 15:36:47.354211,Parrilla · Internacional,Taperia de la Plaza,7500,5700,13200
13000,13001,21-10-2020 15:36:47.647192,Postres · Desayunos,Café Quindio,39700,5700,45400
13001,13002,21-10-2020 15:36:47.989254,Desayunos · Típica,Alce,23000,4900,27900
13002,13003,21-10-2020 15:36:48.283374,Sushi,Kim Pop,15000,5400,20400
13003,13004,21-10-2020 15:36:48.427587,Desayunos · Internacional,Camilia,31800,3900,35700
13004,13005,21-10-2020 15:36:48.820172,Alta Cocina · Parrilla,Criterión,24200,6000,30200
13005,13006,21-10-2020 15:36:49.011482,Alta Cocina · Parrilla,Criterión,24300,6000,30300
13006,13007,21-10-2020 15:36:49.153659,Desayunos · Parrilla,Mi Patria,34500,4600,39100
13007,13008,21-10-2020 15:36:49.297301,Parrilla,Arroces Maria Paula,7500,6800,14300
13008,13009,21-10-2020 15:36:49.640056,Desayunos · Panadería,El Pan de Phillippe,11870,4600,16470
13009,13010,21-10-2020 15:36:49.831322,Desayunos · Típica,Papadió - Colombianas,9000,5700,14700
13010,13011,21-10-2020 15:36:50.223860,Italiana,Bocatto Di Passo,7500,5000,12500
13011,13012,21-10-2020 15:36:50.367543,Desayunos,La Frijolada Desayunos,18900,4400,23300
13012,13013,21-10-2020 15:36:50.710309,Pizza · Italiana,Piatto - Pizza,13000,6600,19600
13013,13014,21-10-2020 15:36:50.851560,Típica · Parrilla,El Santandereano,53400,5200,58600
13014,13015,21-10-2020 15:36:51.243544,Postres · Helados,Mahé,11870,6000,17870
13015,13016,21-10-2020 15:36:51.537425,Pescados y Mariscos,Pescadero Héroes del Mar,53900,6600,60500
13016,13017,21-10-2020 15:36:51.829196,Desayunos,El Fogón Castellano,35000,3200,38200
13017,13018,21-10-2020 15:36:52.221111,Típica · Pescados y Mariscos,Arroces Mrg,7500,4300,11800
13018,13019,21-10-2020 15:36:52.412902,Alta Cocina · Postres,La Pinta,8900,4500,13400
13019,13020,21-10-2020 15:36:52.806808,Sushi,Umi,18900,5600,24500
13020,13021,21-10-2020 15:36:52.998497,Desayunos · Típica,D'Porco - Lechona,23000,6300,29300
13021,13022,21-10-2020 15:36:53.190399,Saludable,MIMA,48750,3700,52450
13022,13023,21-10-2020 15:36:53.482967,Sánduches · Pescados y Mariscos,Pacific Comida de Mar,35000,4000,39000
13023,13024,21-10-2020 15:36:53.876176,Desayunos · Panadería,Ficchi Panadería,65000,3100,68100
13024,13025,21-10-2020 15:36:54.017582,Postres · Desayunos,Gelateria Da Favola,65000,6500,71500
13025,13026,21-10-2020 15:36:54.359247,Postres · Desayunos,Restaurante Cornelia,31800,5500,37300
13026,13027,21-10-2020 15:36:54.500876,Desayunos · Típica,Calentao Express,13600,6000,19600
13027,13028,21-10-2020 15:36:54.794199,Pollo,Señor Fantástico,35000,4700,39700
13028,13029,21-10-2020 15:36:55.135866,Saludable · Desayunos,Agua Dulce,12500,3700,16200
13029,13030,21-10-2020 15:36:55.327321,Pollo,Señor Fantástico,29500,4700,34200
13030,13031,21-10-2020 15:36:55.467953,Parrilla,Rústico Picadería,34500,3800,38300
13031,13032,21-10-2020 15:36:55.611460,Típica · Parrilla,Mi Ranchito Parrilla,10700,4400,15100
13032,13033,21-10-2020 15:36:55.753080,Desayunos,La Frijolada Desayunos,17800,4400,22200
13033,13034,21-10-2020 15:36:56.094885,Desayunos · Sánduches,Frutos del Bosque,15000,3500,18500
13034,13035,21-10-2020 15:36:56.436177,Desayunos · Mexicana,La Mera Mera - Mexicana,35000,3100,38100
13035,13036,21-10-2020 15:36:56.629871,Hamburguesas · Desayunos,El Inglés Gastro Pub,23000,6600,29600
13036,13037,21-10-2020 15:36:56.921468,Desayunos · Helados,San Giorgio Gelateria,15600,3100,18700
13037,13038,21-10-2020 15:36:57.113090,Hamburguesas,Monchis - Hamburguesa,53900,4300,58200
13038,13039,21-10-2020 15:36:57.304066,Pollo,Oliva Va,11870,5600,17470
13039,13040,21-10-2020 15:36:57.497496,Típica,Campo Victoria,18900,3000,21900
13040,13041,21-10-2020 15:36:57.838864,Saludable · Desayunos,Copacabana Açai Bowls,23000,3000,26000
13041,13042,21-10-2020 15:36:58.231258,Postres · Café,Loló Coffee & Snacks,31800,4600,36400
13042,13043,21-10-2020 15:36:58.523502,Parrilla,Restaurante Bar Mi Ranchito,24200,5200,29400
13043,13044,21-10-2020 15:36:58.766986,Pollo,Oliva Va,13000,5600,18600
13044,13045,21-10-2020 15:36:59.108758,Parrilla,El Tambor,7500,6800,14300
13045,13046,21-10-2020 15:36:59.500976,Desayunos · Típica,Rojo Gourmet,23000,4700,27700
13046,13047,21-10-2020 15:36:59.892456,Desayunos · Panadería,Juliana Restaurante,7500,6100,13600
13047,13048,21-10-2020 15:37:00.086356,Parrilla,Carnes la Zarza,53900,4900,58800
13048,13049,21-10-2020 15:37:00.478220,Desayunos · Típica,D'Porco - Lechona,24300,6300,30600
13049,13050,21-10-2020 15:37:00.769922,Desayunos · Típica,Alce,34500,4900,39400
13050,13051,21-10-2020 15:37:01.060695,Mexicana,Hidalgo Taquería,27800,4900,32700
13051,13052,21-10-2020 15:37:01.254001,Desayunos · Café,El Gualilo,11870,6200,18070
13052,13053,21-10-2020 15:37:01.595372,Postres · Helados,Mahé,70000,6000,76000
13053,13054,21-10-2020 15:37:01.887011,Desayunos,Bagel Shop,65000,3200,68200
13054,13055,21-10-2020 15:37:02.177647,Helados,Buon Gelato,12500,4400,16900
13055,13056,21-10-2020 15:37:02.320471,Típica,Carbón & Mondongos,53900,6400,60300
13056,13057,21-10-2020 15:37:02.612360,Desayunos · Típica,Peninsula Calentados y Parrilla,70000,3400,73400
13057,13058,21-10-2020 15:37:02.853903,Pescados y Mariscos,La Gran Cazuela,8900,3200,12100
13058,13059,21-10-2020 15:37:03.144619,Postres · Desayunos,Café Quindio,27800,5700,33500
13059,13060,21-10-2020 15:37:03.488466,Pollo · Saludable,Tremenda Sal y Dulce,15600,6500,22100
13060,13061,21-10-2020 15:37:03.730591,Parrilla,Carnes la Zarza,7500,4900,12400
13061,13062,21-10-2020 15:37:03.921885,Crepes,San Crepes,11870,4900,16770
13062,13063,21-10-2020 15:37:04.262774,Parrilla · Internacional,Taperia de la Plaza,45800,5700,51500
13063,13064,21-10-2020 15:37:04.406396,Parrilla,Arroces Maria Paula,45800,6800,52600
13064,13065,21-10-2020 15:37:04.697945,Desayunos · Italiana,Rceta By Rausch,13600,3600,17200
13065,13066,21-10-2020 15:37:04.839309,Hamburguesas,Bendito Cordero,24300,5800,30100
13066,13067,21-10-2020 15:37:05.030684,Pizza · Parrilla,Urban Lunch,24300,4000,28300
13067,13068,21-10-2020 15:37:05.224092,Postres,Toledo Pastelería,34500,6800,41300
13068,13069,21-10-2020 15:37:05.515836,Parrilla,Antojo a Domicilio,35000,5000,40000
13069,13070,21-10-2020 15:37:05.707448,Típica,Baondish,8900,5800,14700
13070,13071,21-10-2020 15:37:06.098451,Desayunos · Árabe,Boniato Sabores Vivos,10700,5300,16000
13071,13072,21-10-2020 15:37:06.241906,Hamburguesas · Alitas,Beer,12500,6600,19100
13072,13073,21-10-2020 15:37:06.483245,Postres · Panadería,RIGHT AWAY FOODS,23000,6600,29600
13073,13074,21-10-2020 15:37:06.674394,Desayunos,Don Leo,13600,6000,19600
13074,13075,21-10-2020 15:37:06.915499,Desayunos · Panadería,Choclofee,37900,4700,42600
13075,13076,21-10-2020 15:37:07.259183,Postres · Desayunos,Aury Postres - Comidas & Picadas,10700,4700,15400
13076,13077,21-10-2020 15:37:07.501066,Postres · Desayunos,Maltihelado,35000,4500,39500
13077,13078,21-10-2020 15:37:07.842745,Típica · Parrilla,Parrilla Farandula Gourmet,15600,5100,20700
13078,13079,21-10-2020 15:37:08.084002,Desayunos · Árabe,Boniato Sabores Vivos,12500,5300,17800
13079,13080,21-10-2020 15:37:08.477737,Postres · Desayunos,La Folie - Postres,34500,3300,37800
13080,13081,21-10-2020 15:37:08.669081,Saludable · Desayunos,La Cesta,27800,4700,32500
13081,13082,21-10-2020 15:37:08.811346,Típica · Pescados y Mariscos,La Vitualla,35000,6300,41300
13082,13083,21-10-2020 15:37:09.052225,Parrilla · Café,Gaira Café,65000,4400,69400
13083,13084,21-10-2020 15:37:09.295876,Típica,Sopitas y Más,70000,4200,74200
13084,13085,21-10-2020 15:37:09.438178,Desayunos · Jugos y Batidos,Kuriwaji,10700,6300,17000
13085,13086,21-10-2020 15:37:09.780321,Pizza · Parrilla,Urban Lunch,34500,4000,38500
13086,13087,21-10-2020 15:37:10.171485,Típica,Sopitas y Más,12500,4200,16700
13087,13088,21-10-2020 15:37:10.564685,Saludable · Típica,Saludable Mrg,27800,5800,33600
13088,13089,21-10-2020 15:37:10.756179,Hamburguesas,Monchis - Hamburguesa,12500,4300,16800
13089,13090,21-10-2020 15:37:11.097853,Postres · Desayunos,Buñuelos nacho,48750,6600,55350
13090,13091,21-10-2020 15:37:11.389063,Café · Helados,Sofia heladería y café,37900,5800,43700
13091,13092,21-10-2020 15:37:11.632948,Pescados y Mariscos,La Gran Cazuela,39700,3200,42900
13092,13093,21-10-2020 15:37:12.024610,Poke,Poke Go,70000,4600,74600
13093,13094,21-10-2020 15:37:12.266118,Hamburguesas · Pescados y Mariscos,El Velero,53400,6500,59900
13094,13095,21-10-2020 15:37:12.657280,Peruana · Internacional,La Chifería,23000,6600,29600
13095,13096,21-10-2020 15:37:12.850731,Sushi,Kim Pop,31800,5400,37200
13096,13097,21-10-2020 15:37:13.192273,Saludable · Desayunos,Fresh Co,8900,5600,14500
13097,13098,21-10-2020 15:37:13.533821,Comida Rápida,Fiesta Digital Andrés,23000,3100,26100
13098,13099,21-10-2020 15:37:13.825621,Panadería,Boul,65000,3100,68100
13099,13100,21-10-2020 15:37:13.969073,Saludable · Típica,Sopas Mrg,45800,3100,48900
13100,13101,21-10-2020 15:37:14.110538,Típica,Bandejas Mrg,53900,3800,57700
13101,13102,21-10-2020 15:37:14.402382,Desayunos · Café,Moramia,15600,4700,20300
13102,13103,21-10-2020 15:37:14.593579,Desayunos · Pescados y Mariscos,Gypsy Bistro,15000,4500,19500
13103,13104,21-10-2020 15:37:14.886895,Desayunos,Desayunos en Bogotá,8900,3400,12300
13104,13105,21-10-2020 15:37:15.128604,Hamburguesas · Alitas,Beer,9000,6600,15600
13105,13106,21-10-2020 15:37:15.420542,Típica · Parrilla,Parrilla Farandula Gourmet,53400,5100,58500
13106,13107,21-10-2020 15:37:15.811588,Desayunos,Don Leo,31800,6000,37800
13107,13108,21-10-2020 15:37:16.055139,Mexicana,Cantina La 15,15000,4300,19300
13108,13109,21-10-2020 15:37:16.346747,Peruana · Internacional,La Chifería,45800,6600,52400
13109,13110,21-10-2020 15:37:16.487703,Desayunos · Helados,San Giorgio Gelateria,39700,3100,42800
13110,13111,21-10-2020 15:37:16.828500,Mexicana,La leyenda mexican kitchen,48750,3200,51950
13111,13112,21-10-2020 15:37:16.972072,Pizza,Pizza Andante,70000,6300,76300
13112,13113,21-10-2020 15:37:17.213611,Típica,Carbón & Mondongos,13600,6400,20000
13113,13114,21-10-2020 15:37:17.354929,Desayunos · Panadería,Premium Break Bakery,23000,3700,26700
13114,13115,21-10-2020 15:37:17.545777,Saludable,A2manos,15600,4200,19800
13115,13116,21-10-2020 15:37:17.738867,Típica,El Mondongo y Mucho Mas,13600,5600,19200
13116,13117,21-10-2020 15:37:17.930812,Parrilla,Arroces Maria Paula,10700,6800,17500
13117,13118,21-10-2020 15:37:18.322445,Postres · Desayunos,Sweet Tale,23000,5800,28800
13118,13119,21-10-2020 15:37:18.613551,Parrilla,Beraca Parrilla Bbq,8900,5600,14500
13119,13120,21-10-2020 15:37:18.958106,Saludable · Desayunos,Maracuyá,23000,6700,29700
13120,13121,21-10-2020 15:37:19.149528,Pollo · China,China Tao,13600,3500,17100
13121,13122,21-10-2020 15:37:19.541311,Saludable · Desayunos,Raices Bienestar Gourmet,48750,6600,55350
13122,13123,21-10-2020 15:37:19.933280,Típica · Parrilla,Typykos,15600,6000,21600
13123,13124,21-10-2020 15:37:20.127511,Desayunos · Panadería,Ficchi Panadería,17800,3100,20900
13124,13125,21-10-2020 15:37:20.370734,Pizza,Pizza Andante,29500,6300,35800
13125,13126,21-10-2020 15:37:20.762822,Parrilla,Parrilla Pimentón,35000,3400,38400
13126,13127,21-10-2020 15:37:20.954300,Saludable,A2manos,7500,4200,11700
13127,13128,21-10-2020 15:37:21.298418,Postres · Desayunos,Sharmus,23000,6100,29100
13128,13129,21-10-2020 15:37:21.440206,Típica,El Cucharón - Tipica,18900,4400,23300
13129,13130,21-10-2020 15:37:21.832095,Postres · Desayunos,Aury Postres - Comidas & Picadas,24200,4700,28900
13130,13131,21-10-2020 15:37:22.023339,Típica,Sabores De Mi Tierra,35000,5400,40400
13131,13132,21-10-2020 15:37:22.267479,Crepes,San Crepes,24300,4900,29200
13132,13133,21-10-2020 15:37:22.459225,Asiática,Thai Station,39700,6000,45700
13133,13134,21-10-2020 15:37:22.751929,Típica,El Cucharón - Tipica,11870,4400,16270
13134,13135,21-10-2020 15:37:23.093587,Postres · Desayunos,Sharmus,11870,6100,17970
13135,13136,21-10-2020 15:37:23.387554,Típica,Carbón & Mondongos,34500,6400,40900
13136,13137,21-10-2020 15:37:23.529658,Postres · Café,Loló Coffee & Snacks,48750,4600,53350
13137,13138,21-10-2020 15:37:23.821465,Comida Rápida,Fiesta Digital Andrés,18900,3100,22000
13138,13139,21-10-2020 15:37:24.013910,Saludable · Típica,Saludable Mrg,8900,5800,14700
13139,13140,21-10-2020 15:37:24.408093,Saludable · Desayunos,Raices Bienestar Gourmet,24200,6600,30800
13140,13141,21-10-2020 15:37:24.750624,Saludable · Desayunos,Agua Dulce,35000,3700,38700
13141,13142,21-10-2020 15:37:25.092430,Desayunos · Típica,La Frijolada,45800,4500,50300
13142,13143,21-10-2020 15:37:25.333818,Parrilla · Café,Figaro Café/ Restaurante Argentino,48750,5800,54550
13143,13144,21-10-2020 15:37:25.728094,Desayunos · Típica,Criollomania,23000,5200,28200
13144,13145,21-10-2020 15:37:26.069934,Parrilla · Café,Figaro Café/ Restaurante Argentino,9000,5800,14800
13145,13146,21-10-2020 15:37:26.211448,Postres · Café,Loló Coffee & Snacks,18900,4600,23500
13146,13147,21-10-2020 15:37:26.452846,Típica,Carbón & Mondongos,45800,6400,52200
13147,13148,21-10-2020 15:37:26.596585,Pollo · Típica,Auyama,13000,3900,16900
13148,13149,21-10-2020 15:37:26.888278,Pollo · Desayunos,Workzone,23000,3100,26100
13149,13150,21-10-2020 15:37:27.180276,Desayunos · Panadería,Juliana Restaurante,27800,6100,33900
13150,13151,21-10-2020 15:37:27.522013,Saludable,MIMA,29500,3700,33200
13151,13152,21-10-2020 15:37:27.716319,Perros Calientes,Dog Shop - Rapida,9000,4900,13900
13152,13153,21-10-2020 15:37:28.108329,Saludable,A2manos,35000,4200,39200
13153,13154,21-10-2020 15:37:28.250166,Peruana · Internacional,La Chifería,70000,6600,76600
13154,13155,21-10-2020 15:37:28.491203,Pollo,Señor Fantástico,12500,4700,17200
13155,13156,21-10-2020 15:37:28.734622,Saludable · Desayunos,Copacabana Açai Bowls,31800,3000,34800
13156,13157,21-10-2020 15:37:28.875850,Parrilla,Beraca Parrilla Bbq,27800,5600,33400
13157,13158,21-10-2020 15:37:29.118850,Pizza · Italiana,Piatto - Pizza,13600,6600,20200
13158,13159,21-10-2020 15:37:29.460375,Desayunos · Sánduches,Garnish,45800,5200,51000
13159,13160,21-10-2020 15:37:29.653882,Saludable,MIMA,53400,3700,57100
13160,13161,21-10-2020 15:37:29.845499,Postres · Desayunos,La Folie - Postres,11870,3300,15170
13161,13162,21-10-2020 15:37:30.086875,Desayunos · Comida Rápida,Chocolatto,31800,3400,35200
13162,13163,21-10-2020 15:37:30.228241,Sushi,Umi,70000,5600,75600
13163,13164,21-10-2020 15:37:30.371558,Típica · Parrilla,Typykos,29500,6000,35500
13164,13165,21-10-2020 15:37:30.613115,Perros Calientes,Dog Shop - Rapida,7500,4900,12400
13165,13166,21-10-2020 15:37:30.904715,Típica,La Olla de Barro,24200,5300,29500
13166,13167,21-10-2020 15:37:31.246053,Desayunos · Café,Matchacha,31800,5900,37700
13167,13168,21-10-2020 15:37:31.639613,Desayunos · Café,Norma's Ice Cream Café,31800,6300,38100
13168,13169,21-10-2020 15:37:31.931401,Desayunos · Café,Matchacha,53900,5900,59800
13169,13170,21-10-2020 15:37:32.173206,Postres · Desayunos,Café Quindio,53400,5700,59100
13170,13171,21-10-2020 15:37:32.514371,Desayunos · Panadería,Premium Break Bakery,39700,3700,43400
13171,13172,21-10-2020 15:37:32.658057,Saludable · Desayunos,Libre de Culpa,31800,4000,35800
13172,13173,21-10-2020 15:37:32.899604,Típica,Sabores De Mi Tierra,53900,5400,59300
13173,13174,21-10-2020 15:37:33.191396,Postres · Desayunos,Aury Postres - Comidas & Picadas,70000,4700,74700
13174,13175,21-10-2020 15:37:33.483317,Postres · Desayunos,Restaurante Cornelia,10700,5500,16200
13175,13176,21-10-2020 15:37:33.777011,Postres · Desayunos,Vivalight Market.,48750,6500,55250
13176,13177,21-10-2020 15:37:34.120098,Comida Rápida · Perros Calientes,Similoa - Comida Rapida,53900,3700,57600
13177,13178,21-10-2020 15:37:34.311431,Desayunos · Jugos y Batidos,Dont Be Hungry,10700,5600,16300
13178,13179,21-10-2020 15:37:34.502684,Desayunos · Helados,San Giorgio Gelateria,70000,3100,73100
13179,13180,21-10-2020 15:37:34.796235,Desayunos,Cafetería el Kippe,70000,3200,73200
13180,13181,21-10-2020 15:37:35.037764,Desayunos,Señor Desayuno,29500,6800,36300
13181,13182,21-10-2020 15:37:35.329476,Desayunos · Sánduches,Danilo Colombia,15000,3300,18300
13182,13183,21-10-2020 15:37:35.520287,Postres · Desayunos,Restaurante Cornelia,18900,5500,24400
13183,13184,21-10-2020 15:37:35.763679,Parrilla · Café,Gaira Café,37900,4400,42300
13184,13185,21-10-2020 15:37:36.155480,Desayunos · Típica,Fogón Sangileño,12500,5000,17500
13185,13186,21-10-2020 15:37:36.297069,Postres · Saludable,Ana Rebana,45800,6300,52100
13186,13187,21-10-2020 15:37:36.538488,Desayunos,La Frijolada Desayunos,35000,4400,39400
13187,13188,21-10-2020 15:37:36.732076,Desayunos · Sánduches,Danilo Colombia,7500,3300,10800
13188,13189,21-10-2020 15:37:37.023721,Pizza · Italiana,Pisapore - Pizza,34500,6600,41100
13189,13190,21-10-2020 15:37:37.415855,Pizza · Parrilla,Urban Lunch,18900,4000,22900
13190,13191,21-10-2020 15:37:37.557472,Postres · Desayunos,Maria Luisa - Postres,53400,4300,57700
13191,13192,21-10-2020 15:37:37.801478,Pollo · Desayunos,Piaf,12500,6500,19000
13192,13193,21-10-2020 15:37:38.193170,Desayunos · Típica,Peninsula Calentados y Parrilla,15600,3400,19000
13193,13194,21-10-2020 15:37:38.384602,Desayunos · Típica,Rojo Gourmet,15600,4700,20300
13194,13195,21-10-2020 15:37:38.726063,Saludable · Desayunos,La Cesta,39700,4700,44400
13195,13196,21-10-2020 15:37:39.121021,Saludable · Desayunos,Básico y elemental,34500,5000,39500
13196,13197,21-10-2020 15:37:39.413108,Pollo,Señor Fantástico,24200,4700,28900
13197,13198,21-10-2020 15:37:39.754981,Sánduches · China,Peru Mix,11870,5900,17770
13198,13199,21-10-2020 15:37:40.096272,Sushi · Desayunos,Maki Roll,24200,4300,28500
13199,13200,21-10-2020 15:37:40.490248,Típica,Sabores De Mi Tierra,29500,5400,34900
13200,13201,21-10-2020 15:37:40.731987,Típica · Parrilla,Mi Ranchito Parrilla,18900,4400,23300
13201,13202,21-10-2020 15:37:40.924239,Típica · Parrilla,El Santandereano,15000,5200,20200
13202,13203,21-10-2020 15:37:41.215742,Pescados y Mariscos,Fish Place - Del Mar,10700,5400,16100
13203,13204,21-10-2020 15:37:41.409879,Desayunos · Pescados y Mariscos,Gypsy Bistro,48750,4500,53250
13204,13205,21-10-2020 15:37:41.601616,Desayunos · Panadería,Artesanos,48750,4300,53050
13205,13206,21-10-2020 15:37:41.793721,Típica,El Mondongo y Mucho Mas,9000,5600,14600
13206,13207,21-10-2020 15:37:41.934601,Helados,Buon Gelato,39700,4400,44100
13207,13208,21-10-2020 15:37:42.178185,Desayunos · Panadería,Artesanos,17800,4300,22100
13208,13209,21-10-2020 15:37:42.469946,Desayunos · Comida Rápida,Chocolatto,10700,3400,14100
13209,13210,21-10-2020 15:37:42.711655,Desayunos · Panadería,Choclofee,15000,4700,19700
13210,13211,21-10-2020 15:37:43.002816,Parrilla,El Tambor,7500,6800,14300
13211,13212,21-10-2020 15:37:43.296879,Postres · Desayunos,Maria Luisa - Postres,48750,4300,53050
13212,13213,21-10-2020 15:37:43.588913,Pollo · Desayunos,Workzone,24200,3100,27300
13213,13214,21-10-2020 15:37:43.730449,Desayunos · Panadería,Artesanos,17800,4300,22100
13214,13215,21-10-2020 15:37:44.122909,Postres · Panadería,RIGHT AWAY FOODS,35000,6600,41600
13215,13216,21-10-2020 15:37:44.266877,Típica,La Cocina,23000,4600,27600
13216,13217,21-10-2020 15:37:44.408504,Postres,Beiked,15600,4000,19600
13217,13218,21-10-2020 15:37:44.650316,Desayunos · Sánduches,Frutos del Bosque,13600,3500,17100
13218,13219,21-10-2020 15:37:44.791591,Crepes,La Chabatta,18900,5900,24800
13219,13220,21-10-2020 15:37:44.985173,Hamburguesas,Burger Society,39700,4100,43800
13220,13221,21-10-2020 15:37:45.126727,Desayunos · Típica,La Frijolada,8900,4500,13400
13221,13222,21-10-2020 15:37:45.469319,Desayunos · Sánduches,Garnish,13600,5200,18800
13222,13223,21-10-2020 15:37:45.810795,Asiática,TeT,31800,5900,37700
13223,13224,21-10-2020 15:37:46.204794,Desayunos · Café,Norma's Ice Cream Café,10700,6300,17000
13224,13225,21-10-2020 15:37:46.496551,Desayunos · Café,Matchacha,23000,5900,28900
13225,13226,21-10-2020 15:37:46.788888,Saludable · Desayunos,La Cesta,15600,4700,20300
13226,13227,21-10-2020 15:37:47.130874,Desayunos · Típica,La Frijolada,65000,4500,69500
13227,13228,21-10-2020 15:37:47.324591,Mexicana,Hidalgo Taquería,48750,4900,53650
13228,13229,21-10-2020 15:37:47.566349,Desayunos · Típica,Alce,8900,4900,13800
13229,13230,21-10-2020 15:37:47.858555,Pizza,Pastas Laurentina,11870,4800,16670
13230,13231,21-10-2020 15:37:48.150293,Pollo,Heart & Cooking,13600,5000,18600
13231,13232,21-10-2020 15:37:48.344224,Saludable · Desayunos,Raices Bienestar Gourmet,13600,6600,20200
13232,13233,21-10-2020 15:37:48.736366,Postres,La Galeta,10700,3000,13700
13233,13234,21-10-2020 15:37:48.877975,Hamburguesas · Pescados y Mariscos,El Velero,17800,6500,24300
13234,13235,21-10-2020 15:37:49.019892,Típica · Parrilla,Typykos,9000,6000,15000
13235,13236,21-10-2020 15:37:49.264991,Desayunos · Típica,Rojo Gourmet,24300,4700,29000
13236,13237,21-10-2020 15:37:49.666864,Pollo · Desayunos,Caserito Gourmet,27800,6700,34500
13237,13238,21-10-2020 15:37:49.808647,Típica,Salsig,12500,5600,18100
13238,13239,21-10-2020 15:37:50.000565,Asiática,TeT,8900,5900,14800
13239,13240,21-10-2020 15:37:50.194523,Típica,Carbón & Mondongos,48750,6400,55150
13240,13241,21-10-2020 15:37:50.536595,Pollo · Sánduches,Pollos Century,15000,3000,18000
13241,13242,21-10-2020 15:37:50.728524,Pizza,Pastas Laurentina,65000,4800,69800
13242,13243,21-10-2020 15:37:51.020661,Sushi · Desayunos,Maki Roll,53900,4300,58200
13243,13244,21-10-2020 15:37:51.214540,Saludable · Desayunos,Agua Dulce,7500,3700,11200
13244,13245,21-10-2020 15:37:51.606537,Pollo,Oliva Va,12500,5600,18100
13245,13246,21-10-2020 15:37:51.798601,Alta Cocina · Parrilla,Criterión,24300,6000,30300
13246,13247,21-10-2020 15:37:51.990676,Desayunos · Típica,Desayunadero de la 42,53900,5900,59800
13247,13248,21-10-2020 15:37:52.384618,Parrilla,Rústico Picadería,29500,3800,33300
13248,13249,21-10-2020 15:37:52.627246,China,China Food Col,9000,3600,12600
13249,13250,21-10-2020 15:37:52.919375,Parrilla,Arroces Maria Paula,23000,6800,29800
13250,13251,21-10-2020 15:37:53.311331,Peruana · Internacional,La Chifería,53400,6600,60000
13251,13252,21-10-2020 15:37:53.505500,Pescados y Mariscos,Pescadero Héroes del Mar,53900,6600,60500
13252,13253,21-10-2020 15:37:53.697407,Saludable · Típica,Sopas Mrg,7500,3100,10600
13253,13254,21-10-2020 15:37:53.889276,Postres · Café,Celestino Café,11870,5900,17770
13254,13255,21-10-2020 15:37:54.080503,Desayunos,Bagel Shop,29500,3200,32700
13255,13256,21-10-2020 15:37:54.476075,Mexicana,Cantina La 15,10700,4300,15000
13256,13257,21-10-2020 15:37:54.618130,Hamburguesas,Gofi Burger,7500,5100,12600
13257,13258,21-10-2020 15:37:54.910016,Desayunos · Jugos y Batidos,Frutiwow,53900,4100,58000
13258,13259,21-10-2020 15:37:55.302322,Saludable · Desayunos,Guadalupe - Fruteria,13000,5900,18900
13259,13260,21-10-2020 15:37:55.646375,Sánduches,Submarin,34500,3800,38300
13260,13261,21-10-2020 15:37:55.888767,Postres · Desayunos,Maltihelado,48750,4500,53250
13261,13262,21-10-2020 15:37:56.131374,Postres · Desayunos,Gelateria Da Favola,37900,6500,44400
13262,13263,21-10-2020 15:37:56.373179,Desayunos · Típica,Rojo Gourmet,24200,4700,28900
13263,13264,21-10-2020 15:37:56.566876,Pizza · Parrilla,Urban Lunch,9000,4000,13000
13264,13265,21-10-2020 15:37:56.758681,Saludable · Parrilla,The Angels Grill and Drinks,23000,6200,29200
13265,13266,21-10-2020 15:37:57.000865,Típica,Lo Nuestro,70000,3100,73100
13266,13267,21-10-2020 15:37:57.292737,Saludable,The Good Rice Bowls,9000,3500,12500
13267,13268,21-10-2020 15:37:57.587197,Saludable,Hanai - Bowls Saludables,34500,5900,40400
13268,13269,21-10-2020 15:37:57.979480,Alta Cocina · Italiana,Trattoria de la Plaza,9000,6000,15000
13269,13270,21-10-2020 15:37:58.122286,Desayunos,Don Leo,39700,6000,45700
13270,13271,21-10-2020 15:37:58.464307,Saludable · Desayunos,Fresh Co,27800,5600,33400
13271,13272,21-10-2020 15:37:58.858602,Desayunos · Panadería,Santa Juana Food Bar,15600,5900,21500
13272,13273,21-10-2020 15:37:59.000518,Internacional,Rio Sabores y Experiencias,39700,4100,43800
13273,13274,21-10-2020 15:37:59.292873,Desayunos,Señor Desayuno,23000,6800,29800
13274,13275,21-10-2020 15:37:59.635333,Postres,Levelma,48750,6200,54950
13275,13276,21-10-2020 15:37:59.829238,Típica,Baondish,53900,5800,59700
13276,13277,21-10-2020 15:38:00.071246,Postres · Desayunos,Cosmo Cookies,53400,5900,59300
13277,13278,21-10-2020 15:38:00.363468,Típica,Campo Victoria,13600,3000,16600
13278,13279,21-10-2020 15:38:00.755291,Internacional,La Esquina con Sabor Parrilla,70000,3000,73000
13279,13280,21-10-2020 15:38:01.149453,Desayunos · Panadería,Limarys,70000,6500,76500
13280,13281,21-10-2020 15:38:01.441469,Pollo · Desayunos,Candelina,45800,5300,51100
13281,13282,21-10-2020 15:38:01.583563,Parrilla · Café,Gaira Café,15600,4400,20000
13282,13283,21-10-2020 15:38:01.725337,Parrilla,Beraca Parrilla Bbq,18900,5600,24500
13283,13284,21-10-2020 15:38:01.969520,Desayunos · Panadería,Choclofee,9000,4700,13700
13284,13285,21-10-2020 15:38:02.361626,Típica,Carbón & Mondongos,8900,6400,15300
13285,13286,21-10-2020 15:38:02.704490,Postres · Café,Loló Coffee & Snacks,15000,4600,19600
13286,13287,21-10-2020 15:38:02.846299,Desayunos · Pescados y Mariscos,Gypsy Bistro,15600,4500,20100
13287,13288,21-10-2020 15:38:03.240460,Típica,Bendita S,34500,4600,39100
13288,13289,21-10-2020 15:38:03.582899,Postres · Desayunos,KOKOA & co.,70000,4700,74700
13289,13290,21-10-2020 15:38:03.825070,Pizza · Italiana,Piatto - Pizza,23000,6600,29600
13290,13291,21-10-2020 15:38:04.066578,Saludable · Desayunos,Básico y elemental,24200,5000,29200
13291,13292,21-10-2020 15:38:04.210267,Hamburguesas · Pescados y Mariscos,El Velero,31800,6500,38300
13292,13293,21-10-2020 15:38:04.602870,Desayunos · Café,vereda central calle 99,37900,5700,43600
13293,13294,21-10-2020 15:38:04.946418,Desayunos · Sánduches,Garnish,29500,5200,34700
13294,13295,21-10-2020 15:38:05.288454,Típica · Parrilla,La Parilla de David,27800,3100,30900
13295,13296,21-10-2020 15:38:05.483096,Pollo · Desayunos,Abasto,23000,3600,26600
13296,13297,21-10-2020 15:38:05.826677,Desayunos,Cafetería el Kippe,35000,3200,38200
13297,13298,21-10-2020 15:38:06.068906,Saludable · Parrilla,Box,23000,3700,26700
13298,13299,21-10-2020 15:38:06.410984,Pescados y Mariscos,La Gran Cazuela,9000,3200,12200
13299,13300,21-10-2020 15:38:06.605763,Desayunos · Típica,D´Porco,48750,3900,52650
13300,13301,21-10-2020 15:38:06.798105,Hamburguesas · Desayunos,El Inglés Gastro Pub,15000,6600,21600
13301,13302,21-10-2020 15:38:06.940104,Típica,Carbón & Mondongos,13000,6400,19400
13302,13303,21-10-2020 15:38:07.081792,Saludable · Parrilla,The Angels Grill and Drinks,18900,6200,25100
13303,13304,21-10-2020 15:38:07.476050,Típica,Carbón & Mondongos,12500,6400,18900
13304,13305,21-10-2020 15:38:07.668301,Desayunos · Panadería,Choclofee,23000,4700,27700
13305,13306,21-10-2020 15:38:07.810170,Parrilla,Carnes la Zarza,8900,4900,13800
13306,13307,21-10-2020 15:38:08.152867,Típica,Bandejas Mrg,53400,3800,57200
13307,13308,21-10-2020 15:38:08.397391,Desayunos · Helados,San Giorgio Gelateria,27800,3100,30900
13308,13309,21-10-2020 15:38:08.740441,Desayunos · Típica,D'Porco - Lechona,18900,6300,25200
13309,13310,21-10-2020 15:38:08.882293,Saludable,Amor Propio saludable,8900,4000,12900
13310,13311,21-10-2020 15:38:09.074023,Postres · Desayunos,Sharmus,65000,6100,71100
13311,13312,21-10-2020 15:38:09.268445,Saludable · Parrilla,Box,45800,3700,49500
13312,13313,21-10-2020 15:38:09.560768,Sánduches · Pescados y Mariscos,Pacific Comida de Mar,13000,4000,17000
13313,13314,21-10-2020 15:38:09.753561,Alta Cocina · Parrilla,Criterión,24200,6000,30200
13314,13315,21-10-2020 15:38:10.146678,Pollo · Saludable,Gratina,9000,4200,13200
13315,13316,21-10-2020 15:38:10.290635,Desayunos,Sunny Breakfast Brunch,39700,4300,44000
13316,13317,21-10-2020 15:38:10.532725,Postres · Panadería,RIGHT AWAY FOODS,31800,6600,38400
13317,13318,21-10-2020 15:38:10.725330,Hamburguesas · Alitas,Beer,12500,6600,19100
13318,13319,21-10-2020 15:38:11.017032,Desayunos · Sánduches,Danilo Colombia,11870,3300,15170
13319,13320,21-10-2020 15:38:11.361025,Desayunos · Típica,D'Porco - Lechona,15600,6300,21900
13320,13321,21-10-2020 15:38:11.653453,Saludable · Típica,Saludable Mrg,24300,5800,30100
13321,13322,21-10-2020 15:38:11.895474,Pollo · China,China Tao,48750,3500,52250
13322,13323,21-10-2020 15:38:12.137479,Parrilla,Coquitas,13600,5600,19200
13323,13324,21-10-2020 15:38:12.281502,Saludable · Parrilla,Box,35000,3700,38700
13324,13325,21-10-2020 15:38:12.523463,Pizza,18 Scalini,39700,4300,44000
13325,13326,21-10-2020 15:38:12.865616,Italiana,F*cking Good Pizza,29500,4200,33700
13326,13327,21-10-2020 15:38:13.007404,Sushi · Asiática,Tu Sushi,13600,6400,20000
13327,13328,21-10-2020 15:38:13.201406,Desayunos · Típica,Desayunadero de la 42,45800,5900,51700
13328,13329,21-10-2020 15:38:13.543981,Parrilla,Arepaisa de Medellín,27800,5600,33400
13329,13330,21-10-2020 15:38:13.886280,Desayunos · Árabe,Boniato Sabores Vivos,37900,5300,43200
13330,13331,21-10-2020 15:38:14.278345,Desayunos · Comida Rápida,La Veneca,53400,6300,59700
13331,13332,21-10-2020 15:38:14.522471,Pollo · Pescados y Mariscos,Bang Bang Rice,23000,3400,26400
13332,13333,21-10-2020 15:38:14.714621,Desayunos,Cafetería el Kippe,8900,3200,12100
13333,13334,21-10-2020 15:38:14.856814,Desayunos · Típica,Calentao Express,24200,6000,30200
13334,13335,21-10-2020 15:38:14.998491,Postres · Café,Loló Coffee & Snacks,39700,4600,44300
13335,13336,21-10-2020 15:38:15.343344,Pollo · Saludable,Yerbabuena,24200,3900,28100
13336,13337,21-10-2020 15:38:15.735684,Pizza,pizza andante,12500,4200,16700
13337,13338,21-10-2020 15:38:16.028008,Sushi · Desayunos,Maki Roll,15000,4300,19300
13338,13339,21-10-2020 15:38:16.369878,Hamburguesas · Alitas,Beer,9000,6600,15600
13339,13340,21-10-2020 15:38:16.563852,Sushi · Asiática,Arigato,15000,5300,20300
13340,13341,21-10-2020 15:38:16.956238,Desayunos · Panadería,Le Pain Quotidien,8900,3900,12800
13341,13342,21-10-2020 15:38:17.148539,Alta Cocina · Parrilla,Criterión,17800,6000,23800
13342,13343,21-10-2020 15:38:17.390717,Alta Cocina · Parrilla,Criterión,24200,6000,30200
13343,13344,21-10-2020 15:38:17.734800,Pollo · Saludable,Yerbabuena,13000,3900,16900
13344,13345,21-10-2020 15:38:17.876702,Helados,Buon Gelato,9000,4400,13400
13345,13346,21-10-2020 15:38:18.119003,Saludable · Desayunos,Fresh Co,37900,5600,43500
13346,13347,21-10-2020 15:38:18.260561,Pescados y Mariscos,Fish Place - Del Mar,24200,5400,29600
13347,13348,21-10-2020 15:38:18.504387,Desayunos · Panadería,Santa Juana Food Bar,8900,5900,14800
13348,13349,21-10-2020 15:38:18.796580,Postres · Café,Celestino Café,17800,5900,23700
13349,13350,21-10-2020 15:38:19.089392,Alta Cocina · Postres,La Pinta,9000,4500,13500
13350,13351,21-10-2020 15:38:19.232077,Desayunos · Panadería,Ficchi Panadería,9000,3100,12100
13351,13352,21-10-2020 15:38:19.377347,Desayunos · Café,Aromacafé el Placer de Compartir,7500,5000,12500
13352,13353,21-10-2020 15:38:19.669874,Típica · Pescados y Mariscos,La Vitualla,27800,6300,34100
13353,13354,21-10-2020 15:38:19.812045,Italiana,F*cking Good Pizza,18900,4200,23100
13354,13355,21-10-2020 15:38:20.154011,Desayunos · Típica,Desayunadero de la 42,39700,5900,45600
13355,13356,21-10-2020 15:38:20.448167,Peruana,Masivo,35000,5800,40800
13356,13357,21-10-2020 15:38:20.590375,Parrilla,Arroces Maria Paula,23000,6800,29800
13357,13358,21-10-2020 15:38:20.882835,Saludable · Desayunos,Fresh Co,23000,5600,28600
13358,13359,21-10-2020 15:38:21.024407,Típica,Bendita S,13000,4600,17600
13359,13360,21-10-2020 15:38:21.268611,Hamburguesas · Pescados y Mariscos,El Velero,39700,6500,46200
13360,13361,21-10-2020 15:38:21.461195,Típica,Sopitas y Más,35000,4200,39200
13361,13362,21-10-2020 15:38:21.703468,Postres · Desayunos,Restaurante Cornelia,12500,5500,18000
13362,13363,21-10-2020 15:38:21.945414,Panadería,Boul,23000,3100,26100
13363,13364,21-10-2020 15:38:22.290100,Parrilla,Arepaisa de Medellín,48750,5600,54350
13364,13365,21-10-2020 15:38:22.432093,Hamburguesas · Panadería,NYC Burgers,7500,6200,13700
13365,13366,21-10-2020 15:38:22.574546,Típica · Parrilla,El Portal de la Antigua,15600,5600,21200
13366,13367,21-10-2020 15:38:22.967668,Hamburguesas,Gofi Burger,15000,5100,20100
13367,13368,21-10-2020 15:38:23.362143,Helados,Orso To Go,31800,6800,38600
13368,13369,21-10-2020 15:38:23.654627,Desayunos,Archies Desayunos,29500,3100,32600
13369,13370,21-10-2020 15:38:23.846785,Italiana,F*cking Good Pizza,8900,4200,13100
13370,13371,21-10-2020 15:38:24.188817,Alta Cocina · Parrilla,Criterión,37900,6000,43900
13371,13372,21-10-2020 15:38:24.483413,Saludable · Desayunos,Bon Eat - Saludable,53900,4800,58700
13372,13373,21-10-2020 15:38:24.676181,Desayunos,Don Leo,24200,6000,30200
13373,13374,21-10-2020 15:38:24.818278,Sánduches · Pescados y Mariscos,Pacific Comida de Mar,15600,4000,19600
13374,13375,21-10-2020 15:38:24.960163,Desayunos · Panadería,Artesanos,29500,4300,33800
13375,13376,21-10-2020 15:38:25.255312,Desayunos · Pescados y Mariscos,Gypsy Bistro,39700,4500,44200
13376,13377,21-10-2020 15:38:25.448048,Saludable · Desayunos,Distrito Gourmet,15600,3700,19300
13377,13378,21-10-2020 15:38:25.590935,Desayunos · Típica,Rojo Gourmet,34500,4700,39200
13378,13379,21-10-2020 15:38:25.933470,Postres · Desayunos,BagBog Bagels,37900,6400,44300
13379,13380,21-10-2020 15:38:26.178073,Desayunos · Panadería,Juliana Restaurante,34500,6100,40600
13380,13381,21-10-2020 15:38:26.570640,Saludable · Desayunos,La Estampilla,34500,6000,40500
13381,13382,21-10-2020 15:38:26.713305,Saludable,Amor Propio saludable,7500,4000,11500
13382,13383,21-10-2020 15:38:26.954937,Parrilla,Beraca Parrilla Bbq,29500,5600,35100
13383,13384,21-10-2020 15:38:27.249369,Comida Rápida · Perros Calientes,Similoa - Comida Rapida,35000,3700,38700
13384,13385,21-10-2020 15:38:27.541448,Pollo · Desayunos,Candelina,15000,5300,20300
13385,13386,21-10-2020 15:38:27.883653,Saludable,Hanai - Bowls Saludables,15000,5900,20900
13386,13387,21-10-2020 15:38:28.276217,Desayunos · Sánduches,Frutos del Bosque,29500,3500,33000
13387,13388,21-10-2020 15:38:28.420792,Helados,Orso To Go,45800,6800,52600
13388,13389,21-10-2020 15:38:28.713243,Desayunos,El Corral - Desayunos,17800,5000,22800
13389,13390,21-10-2020 15:38:28.855236,Desayunos · Panadería,Premium Break Bakery,12500,3700,16200
13390,13391,21-10-2020 15:38:29.247760,Pollo · Desayunos,Candelina,31800,5300,37100
13391,13392,21-10-2020 15:38:29.493061,Desayunos · Típica,La Parrilla Dorada Polo,8900,6600,15500
13392,13393,21-10-2020 15:38:29.635848,Postres · Café,Celestino Café,15600,5900,21500
13393,13394,21-10-2020 15:38:29.778531,Postres · Desayunos,Sweet Tale,31800,5800,37600
13394,13395,21-10-2020 15:38:30.171352,Desayunos · Mexicana,La Mera Mera - Mexicana,53400,3100,56500
13395,13396,21-10-2020 15:38:30.416201,Desayunos · Típica,Rojo Gourmet,53900,4700,58600
13396,13397,21-10-2020 15:38:30.658978,Desayunos · Café,Matchacha,7500,5900,13400
13397,13398,21-10-2020 15:38:30.951833,Desayunos,El Corral - Desayunos,37900,5000,42900
13398,13399,21-10-2020 15:38:31.144227,Desayunos · Café,vereda central calle 99,18900,5700,24600
13399,13400,21-10-2020 15:38:31.488951,Hamburguesas,Bendito Cordero,37900,5800,43700
13400,13401,21-10-2020 15:38:31.831459,Desayunos · Típica,D´Porco,70000,3900,73900
13401,13402,21-10-2020 15:38:32.174301,Desayunos · Típica,Criollomania,27800,5200,33000
13402,13403,21-10-2020 15:38:32.366544,Desayunos · Típica,D'Porco - Lechona,8900,6300,15200
13403,13404,21-10-2020 15:38:32.560825,Típica · Parrilla,El Portal de la Antigua,13600,5600,19200
13404,13405,21-10-2020 15:38:32.703536,Típica · Parrilla,La Ternera Parrilla,48750,5200,53950
13405,13406,21-10-2020 15:38:33.045980,Saludable,Puro Verde,8900,5700,14600
13406,13407,21-10-2020 15:38:33.289101,Hamburguesas,Bendito Cordero,8900,5800,14700
13407,13408,21-10-2020 15:38:33.433871,Saludable · Parrilla,The Angels Grill and Drinks,11870,6200,18070
13408,13409,21-10-2020 15:38:33.676241,Postres · Desayunos,Maltihelados,17800,6200,24000
13409,13410,21-10-2020 15:38:34.068811,Parrilla · Café,Gaira Café,7500,4400,11900
13410,13411,21-10-2020 15:38:34.210888,Desayunos · Árabe,Boniato Sabores Vivos,37900,5300,43200
13411,13412,21-10-2020 15:38:34.555628,Saludable · Jugos y Batidos,Berdes Drinks & Salads,9000,3500,12500
13412,13413,21-10-2020 15:38:34.798734,Postres · Desayunos,La Folie - Postres,24200,3300,27500
13413,13414,21-10-2020 15:38:34.991975,Desayunos · Café,Norma's Ice Cream Café,65000,6300,71300
13414,13415,21-10-2020 15:38:35.234914,Postres · Desayunos,Protein Bakes,11870,5900,17770
13415,13416,21-10-2020 15:38:35.379960,Desayunos,Cafetería el Kippe,39700,3200,42900
13416,13417,21-10-2020 15:38:35.573107,Pollo · Típica,Auyama,24200,3900,28100
13417,13418,21-10-2020 15:38:35.715916,Típica,El Cucharón - Tipica,23000,4400,27400
13418,13419,21-10-2020 15:38:35.958533,Postres · Saludable,Ana Rebana,24200,6300,30500
13419,13420,21-10-2020 15:38:36.103072,Postres · Desayunos,Amelie Helados,65000,6400,71400
13420,13421,21-10-2020 15:38:36.245837,Saludable · Desayunos,Re.al Alimentos Reales,39700,4000,43700
13421,13422,21-10-2020 15:38:36.589007,Desayunos,Sunny Breakfast Brunch,24300,4300,28600
13422,13423,21-10-2020 15:38:36.831677,Pollo · Desayunos,Workzone,35000,3100,38100
13423,13424,21-10-2020 15:38:37.176398,Pollo · Desayunos,Abasto,48750,3600,52350
13424,13425,21-10-2020 15:38:37.519300,Pescados y Mariscos,Fish Place - Del Mar,24200,5400,29600
13425,13426,21-10-2020 15:38:37.762217,Desayunos · Café,El Gualilo,23000,6200,29200
13426,13427,21-10-2020 15:38:38.104598,Típica · Parrilla,El Portal de la Antigua,18900,5600,24500
13427,13428,21-10-2020 15:38:38.249040,Desayunos · Panadería,Decofruta,34500,4700,39200
13428,13429,21-10-2020 15:38:38.443307,Saludable · Típica,Saludable Mrg,37900,5800,43700
13429,13430,21-10-2020 15:38:38.635877,Desayunos · Empanadas,Mis Delicias,53900,3200,57100
13430,13431,21-10-2020 15:38:39.028417,Típica,Campo Victoria,11870,3000,14870
13431,13432,21-10-2020 15:38:39.373556,Desayunos · Café,El Gualilo,24300,6200,30500
13432,13433,21-10-2020 15:38:39.716497,Sushi,Canoa To Go,13000,5900,18900
13433,13434,21-10-2020 15:38:39.859287,Hamburguesas · Alitas,Beer,12500,6600,19100
13434,13435,21-10-2020 15:38:40.252801,Pollo · Desayunos,Workzone,13000,3100,16100
13435,13436,21-10-2020 15:38:40.497743,Desayunos · Empanadas,Empanadas Doraditas.com,23000,3000,26000
13436,13437,21-10-2020 15:38:40.740868,Desayunos,La Frijolada Desayunos,9000,4400,13400
13437,13438,21-10-2020 15:38:41.033670,Pollo · Sánduches,Pollos Century,18900,3000,21900
13438,13439,21-10-2020 15:38:41.426528,Desayunos · Parrilla,Mi Patria,17800,4600,22400
13439,13440,21-10-2020 15:38:41.671418,Desayunos,Archies Desayunos,13000,3100,16100
13440,13441,21-10-2020 15:38:42.014456,Desayunos · Típica,La Parrilla Dorada Polo,18900,6600,25500
13441,13442,21-10-2020 15:38:42.357371,Desayunos · Panadería,Artesanos,35000,4300,39300
13442,13443,21-10-2020 15:38:42.599594,Postres · Desayunos,Jacques Pastelería,34500,5900,40400
13443,13444,21-10-2020 15:38:42.944904,Típica,Cabrito Santandereano,12500,6600,19100
13444,13445,21-10-2020 15:38:43.337955,Hamburguesas,Monchis - Hamburguesa,35000,4300,39300
13445,13446,21-10-2020 15:38:43.682081,Desayunos · Panadería,Juliana Restaurante,35000,6100,41100
13446,13447,21-10-2020 15:38:44.025377,Desayunos · Internacional,Camilia,23000,3900,26900
13447,13448,21-10-2020 15:38:44.323372,Típica,Sopitas y Más,53900,4200,58100
13448,13449,21-10-2020 15:38:44.716411,Saludable · Desayunos,Bon Eat - Saludable,23000,4800,27800
13449,13450,21-10-2020 15:38:45.009830,Alta Cocina · Parrilla,Criterión,7500,6000,13500
13450,13451,21-10-2020 15:38:45.252796,Café · Helados,Sofia heladería y café,34500,5800,40300
13451,13452,21-10-2020 15:38:45.648135,Parrilla,Restaurante Bar Mi Ranchito,11870,5200,17070
13452,13453,21-10-2020 15:38:45.890893,Típica,Juan Chorizo,35000,3900,38900
13453,13454,21-10-2020 15:38:46.133636,Típica,Cazuelitas 93,35000,3900,38900
13454,13455,21-10-2020 15:38:46.476207,Hamburguesas · Desayunos,El Inglés Gastro Pub,13000,6600,19600
13455,13456,21-10-2020 15:38:46.721817,Desayunos,El Corral - Desayunos,11870,5000,16870
13456,13457,21-10-2020 15:38:47.064988,Típica · Pescados y Mariscos,La Vitualla,7500,6300,13800
13457,13458,21-10-2020 15:38:47.208008,Pollo · Desayunos,Abasto,31800,3600,35400
13458,13459,21-10-2020 15:38:47.601004,Postres · Desayunos,La Folie - Postres,65000,3300,68300
13459,13460,21-10-2020 15:38:47.846170,Postres · Desayunos,BagBog Bagels,23000,6400,29400
13460,13461,21-10-2020 15:38:48.189852,Helados,Orso To Go,7500,6800,14300
13461,13462,21-10-2020 15:38:48.434182,Saludable · Jugos y Batidos,Berdes Drinks & Salads,17800,3500,21300
13462,13463,21-10-2020 15:38:48.576840,Saludable · Desayunos,La Estampilla,29500,6000,35500
13463,13464,21-10-2020 15:38:48.873751,Pizza · Parrilla,Urban Lunch,15000,4000,19000
13464,13465,21-10-2020 15:38:49.217166,Mexicana,Mexicanachos,53400,3900,57300
13465,13466,21-10-2020 15:38:49.510357,Desayunos · Sánduches,Garnish,12500,5200,17700
13466,13467,21-10-2020 15:38:49.802622,Peruana · Internacional,La Chifería,24300,6600,30900
13467,13468,21-10-2020 15:38:50.197365,Saludable · Desayunos,Distrito Gourmet,17800,3700,21500
13468,13469,21-10-2020 15:38:50.439945,China,China Food Col,23000,3600,26600
13469,13470,21-10-2020 15:38:50.832733,Típica · Parrilla,Parrilla Farandula Gourmet,35000,5100,40100
13470,13471,21-10-2020 15:38:51.175371,Postres · Desayunos,Jacques Pastelería,53900,5900,59800
13471,13472,21-10-2020 15:38:51.470319,Postres · Desayunos,KOKOA & co.,15000,4700,19700
13472,13473,21-10-2020 15:38:51.612530,Típica,La Herencia,15600,5900,21500
13473,13474,21-10-2020 15:38:51.955351,Asiática,TeT,24200,5900,30100
13474,13475,21-10-2020 15:38:52.147625,Pizza,18 Scalini,53900,4300,58200
13475,13476,21-10-2020 15:38:52.292003,Hamburguesas,Monchis - Hamburguesa,31800,4300,36100
13476,13477,21-10-2020 15:38:52.684458,Desayunos · Típica,Casa Vieja,12500,6000,18500
13477,13478,21-10-2020 15:38:52.976927,Parrilla,Coquitas,15600,5600,21200
13478,13479,21-10-2020 15:38:53.269488,Postres · Saludable,Ana Rebana,8900,6300,15200
13479,13480,21-10-2020 15:38:53.564413,Peruana · Internacional,La Chifería,23000,6600,29600
13480,13481,21-10-2020 15:38:53.908065,Sushi · Asiática,Tu Sushi,24200,6400,30600
13481,13482,21-10-2020 15:38:54.150717,Desayunos,Sr Buñuelo,23000,6400,29400
13482,13483,21-10-2020 15:38:54.543303,Postres · Desayunos,Café Quindio,17800,5700,23500
13483,13484,21-10-2020 15:38:54.788319,Desayunos · Típica,Calentao Express,7500,6000,13500
13484,13485,21-10-2020 15:38:55.180898,Pizza · Parrilla,Urban Lunch,37900,4000,41900
13485,13486,21-10-2020 15:38:55.473906,Desayunos · Helados,San Giorgio Gelateria,23000,3100,26100
13486,13487,21-10-2020 15:38:55.615975,Postres,Levelma,8900,6200,15100
13487,13488,21-10-2020 15:38:56.010805,Parrilla · Café,Gaira Café,11870,4400,16270
13488,13489,21-10-2020 15:38:56.153254,Pollo,Señor Fantástico,39700,4700,44400
13489,13490,21-10-2020 15:38:56.295829,Helados,Buon Gelato,53900,4400,58300
13490,13491,21-10-2020 15:38:56.587844,Peruana,Uma Cantina Peruana,45800,3200,49000
13491,13492,21-10-2020 15:38:56.782523,Postres · Desayunos,Buñuelos nacho,31800,6600,38400
13492,13493,21-10-2020 15:38:56.924988,Peruana,Masivo,53400,5800,59200
13493,13494,21-10-2020 15:38:57.117470,Pollo · Desayunos,Workzone,45800,3100,48900
13494,13495,21-10-2020 15:38:57.410270,Pizza,Pizza Andante,24300,6300,30600
13495,13496,21-10-2020 15:38:57.554613,Desayunos · Típica,D´Porco,35000,3900,38900
13496,13497,21-10-2020 15:38:57.947711,Típica,El Mondongo y Mucho Mas,13000,5600,18600
13497,13498,21-10-2020 15:38:58.340420,Postres · Desayunos,Aury Postres - Comidas & Picadas,70000,4700,74700
13498,13499,21-10-2020 15:38:58.696113,Desayunos · Jugos y Batidos,Frutiwow,10700,4100,14800
13499,13500,21-10-2020 15:38:58.840564,Desayunos · Panadería,Decofruta,17800,4700,22500
13500,13501,21-10-2020 15:38:59.083326,Pizza,18 Scalini,7500,4300,11800
13501,13502,21-10-2020 15:38:59.426425,Desayunos,Butter,48750,6700,55450
13502,13503,21-10-2020 15:38:59.819657,Típica,Juan Chorizo,24200,3900,28100
13503,13504,21-10-2020 15:39:00.064264,Desayunos,Butter,45800,6700,52500
13504,13505,21-10-2020 15:39:00.456952,Crepes,San Crepes,11870,4900,16770
13505,13506,21-10-2020 15:39:00.799533,Típica,Carbón & Mondongos,18900,6400,25300
13506,13507,21-10-2020 15:39:00.941561,Desayunos · Panadería,Ficchi Panadería,27800,3100,30900
13507,13508,21-10-2020 15:39:01.186262,China,China Food Col,8900,3600,12500
13508,13509,21-10-2020 15:39:01.578741,Pizza · Parrilla,Urban Lunch,23000,4000,27000
13509,13510,21-10-2020 15:39:01.921452,Sánduches · Pescados y Mariscos,Pacific Comida de Mar,39700,4000,43700
13510,13511,21-10-2020 15:39:02.313831,Desayunos · Típica,Alce,11870,4900,16770
13511,13512,21-10-2020 15:39:02.708534,Desayunos,Butter,15000,6700,21700
13512,13513,21-10-2020 15:39:02.951164,Parrilla,Beraca Parrilla Bbq,18900,5600,24500
13513,13514,21-10-2020 15:39:03.344220,Pollo,Chicken House,39700,4200,43900
13514,13515,21-10-2020 15:39:03.636625,Pescados y Mariscos,Fish Place - Del Mar,31800,5400,37200
13515,13516,21-10-2020 15:39:03.831382,Panadería,Boul,13600,3100,16700
13516,13517,21-10-2020 15:39:04.074180,Desayunos · Típica,Casa Vieja,18900,6000,24900
13517,13518,21-10-2020 15:39:04.317569,Pizza · Parrilla,Urban Lunch,70000,4000,74000
13518,13519,21-10-2020 15:39:04.459817,Postres · Desayunos,Vivalight Market.,17800,6500,24300
13519,13520,21-10-2020 15:39:04.704354,Mexicana,Mexicanachos,48750,3900,52650
13520,13521,21-10-2020 15:39:05.047020,Sánduches · China,Peru Mix,70000,5900,75900
13521,13522,21-10-2020 15:39:05.339337,Jugos y Batidos,Pomponio,35000,3600,38600
13522,13523,21-10-2020 15:39:05.531792,Poke,Poke Go,17800,4600,22400
13523,13524,21-10-2020 15:39:05.876249,Típica,El Cucharón - Tipica,27800,4400,32200
13524,13525,21-10-2020 15:39:06.269486,Típica · Parrilla,Toya,37900,4200,42100
13525,13526,21-10-2020 15:39:06.412494,Típica · Pescados y Mariscos,Arroces Mrg,27800,4300,32100
13526,13527,21-10-2020 15:39:06.604696,Postres · Desayunos,Aury Postres - Comidas & Picadas,53900,4700,58600
13527,13528,21-10-2020 15:39:06.999589,Alta Cocina · Parrilla,Criterión,11870,6000,17870
13528,13529,21-10-2020 15:39:07.342512,Postres · Saludable,Ana Rebana,35000,6300,41300
13529,13530,21-10-2020 15:39:07.485605,Desayunos · Parrilla,Mi Patria,13000,4600,17600
13530,13531,21-10-2020 15:39:07.728255,Saludable · Desayunos,Básico y elemental,10700,5000,15700
13531,13532,21-10-2020 15:39:07.923237,Comida Rápida,Fiesta Digital Andrés,12500,3100,15600
13532,13533,21-10-2020 15:39:08.066047,Parrilla,Carnes la Zarza,48750,4900,53650
13533,13534,21-10-2020 15:39:08.309076,Desayunos,El Corral - Desayunos,13000,5000,18000
13534,13535,21-10-2020 15:39:08.551608,Típica,El Mondongo y Mucho Mas,31800,5600,37400
13535,13536,21-10-2020 15:39:08.696181,Desayunos · Café,Norma's Ice Cream Café,15000,6300,21300
13536,13537,21-10-2020 15:39:08.988907,China,China Food Col,34500,3600,38100
13537,13538,21-10-2020 15:39:09.131465,Saludable · Típica,Sopas Mrg,10700,3100,13800
13538,13539,21-10-2020 15:39:09.524647,Postres,La Galeta,24300,3000,27300
13539,13540,21-10-2020 15:39:09.919715,Típica,Sabores De Mi Tierra,12500,5400,17900
13540,13541,21-10-2020 15:39:10.112387,Sánduches,Submarin,15000,3800,18800
13541,13542,21-10-2020 15:39:10.505385,Desayunos,Butter,31800,6700,38500
13542,13543,21-10-2020 15:39:10.747870,Postres · Desayunos,Jacques Pastelería,13000,5900,18900
13543,13544,21-10-2020 15:39:11.092760,Saludable · Desayunos,Básico y elemental,27800,5000,32800
13544,13545,21-10-2020 15:39:11.235581,Desayunos · Parrilla,Mi Patria,35000,4600,39600
13545,13546,21-10-2020 15:39:11.428324,Desayunos · Típica,Rojo Gourmet,8900,4700,13600
13546,13547,21-10-2020 15:39:11.620939,Desayunos · Comida Rápida,Chocolatto,8900,3400,12300
13547,13548,21-10-2020 15:39:12.015375,Típica,La Herencia,9000,5900,14900
13548,13549,21-10-2020 15:39:12.158413,Saludable · Desayunos,La Estampilla,70000,6000,76000
13549,13550,21-10-2020 15:39:12.301334,Postres · Desayunos,Sharmus,15000,6100,21100
13550,13551,21-10-2020 15:39:12.694000,Postres · Desayunos,Amelie Helados,35000,6400,41400
13551,13552,21-10-2020 15:39:12.838966,Saludable · Desayunos,Guadalupe - Fruteria,15600,5900,21500
13552,13553,21-10-2020 15:39:12.981760,Pollo,Heart & Cooking,15600,5000,20600
13553,13554,21-10-2020 15:39:13.274367,Sánduches,Submarin,35000,3800,38800
13554,13555,21-10-2020 15:39:13.566619,Típica,Cazuelitas 93,45800,3900,49700
13555,13556,21-10-2020 15:39:13.761595,Típica,Bendita S,35000,4600,39600
13556,13557,21-10-2020 15:39:14.054189,Desayunos · Panadería,Limarys,9000,6500,15500
13557,13558,21-10-2020 15:39:14.447448,Desayunos · Panadería,Juliana Restaurante,27800,6100,33900
13558,13559,21-10-2020 15:39:14.640764,Desayunos,Desayunos en Bogotá,70000,3400,73400
13559,13560,21-10-2020 15:39:14.785421,Saludable · Parrilla,The Angels Grill and Drinks,70000,6200,76200
13560,13561,21-10-2020 15:39:14.977932,Pollo · Saludable,Gratina,53900,4200,58100
13561,13562,21-10-2020 15:39:15.321038,Típica,La Cocina,18900,4600,23500
13562,13563,21-10-2020 15:39:15.613920,Pollo · Desayunos,Workzone,9000,3100,12100
13563,13564,21-10-2020 15:39:15.809337,Desayunos · Café,El Gualilo,39700,6200,45900
13564,13565,21-10-2020 15:39:15.951805,Desayunos · Panadería,Ficchi Panadería,23000,3100,26100
13565,13566,21-10-2020 15:39:16.295206,Desayunos · Italiana,Rceta By Rausch,24200,3600,27800
13566,13567,21-10-2020 15:39:16.587575,Típica · Parrilla,El Portal de la Antigua,10700,5600,16300
13567,13568,21-10-2020 15:39:16.732223,Saludable · Desayunos,Básico y elemental,12500,5000,17500
13568,13569,21-10-2020 15:39:16.924919,Hamburguesas · Pescados y Mariscos,El Velero,23000,6500,29500
13569,13570,21-10-2020 15:39:17.268436,Saludable,MIMA,39700,3700,43400
13570,13571,21-10-2020 15:39:17.561245,Hamburguesas,Bendito Cordero,8900,5800,14700
13571,13572,21-10-2020 15:39:17.956161,Postres · Desayunos,Sharmus,8900,6100,15000
13572,13573,21-10-2020 15:39:18.299228,Postres · Desayunos,Gelateria Da Favola,45800,6500,52300
13573,13574,21-10-2020 15:39:18.442235,Pizza,pizza andante,48750,4200,52950
13574,13575,21-10-2020 15:39:18.584645,Desayunos · Típica,Papadió - Colombianas,48750,5700,54450
13575,13576,21-10-2020 15:39:18.829611,Postres · Desayunos,Buñuelos nacho,29500,6600,36100
13576,13577,21-10-2020 15:39:19.072446,Pollo · Típica,Auyama,27800,3900,31700
13577,13578,21-10-2020 15:39:19.465639,Postres · Café,Celestino Café,15600,5900,21500
13578,13579,21-10-2020 15:39:19.858973,Peruana · Internacional,La Chifería,11870,6600,18470
13579,13580,21-10-2020 15:39:20.204061,Desayunos · Sánduches,Frutos del Bosque,45800,3500,49300
13580,13581,21-10-2020 15:39:20.497757,Pizza · Italiana,Pisapore - Pizza,8900,6600,15500
13581,13582,21-10-2020 15:39:20.691382,Desayunos · Típica,La Frijolada,15600,4500,20100
13582,13583,21-10-2020 15:39:20.934514,Desayunos,Desayunos en Bogotá,37900,3400,41300
13583,13584,21-10-2020 15:39:21.280110,Desayunos · Panadería,Premium Break Bakery,48750,3700,52450
13584,13585,21-10-2020 15:39:21.623457,Poke,Poke Go,39700,4600,44300
13585,13586,21-10-2020 15:39:21.866594,Desayunos,Archies Desayunos,15000,3100,18100
13586,13587,21-10-2020 15:39:22.059496,Parrilla,El Tambor,13600,6800,20400
13587,13588,21-10-2020 15:39:22.404898,Desayunos · Pescados y Mariscos,Gypsy Bistro,34500,4500,39000
13588,13589,21-10-2020 15:39:22.597729,Sánduches,Submarin,13600,3800,17400
13589,13590,21-10-2020 15:39:22.840588,Postres,Beiked,53900,4000,57900
13590,13591,21-10-2020 15:39:22.983390,Perros Calientes,Dog Shop - Rapida,13000,4900,17900
13591,13592,21-10-2020 15:39:23.128810,Jugos y Batidos,Pomponio,45800,3600,49400
13592,13593,21-10-2020 15:39:23.522185,Postres · Helados,Mahé,24200,6000,30200
13593,13594,21-10-2020 15:39:23.665395,Desayunos,Sunny Breakfast Brunch,15600,4300,19900
13594,13595,21-10-2020 15:39:24.058109,Desayunos,Bagel Shop,70000,3200,73200
13595,13596,21-10-2020 15:39:24.303372,Desayunos · Panadería,Limarys,11870,6500,18370
13596,13597,21-10-2020 15:39:24.546089,Sushi,Sushi Reel,48750,4700,53450
13597,13598,21-10-2020 15:39:24.738985,Desayunos · Empanadas,Mis Delicias,24300,3200,27500
13598,13599,21-10-2020 15:39:24.932055,Parrilla,Parrilla Pimentón,65000,3400,68400
13599,13600,21-10-2020 15:39:25.277635,Desayunos,Bagel Shop,23000,3200,26200
13600,13601,21-10-2020 15:39:25.420789,Desayunos,Señor Desayuno,9000,6800,15800
13601,13602,21-10-2020 15:39:25.613893,Comida Rápida,Fiesta Digital Andrés,29500,3100,32600
13602,13603,21-10-2020 15:39:25.956989,Parrilla,Rústico Picadería,7500,3800,11300
13603,13604,21-10-2020 15:39:26.302287,Alta Cocina · Parrilla,Criterión,24200,6000,30200
13604,13605,21-10-2020 15:39:26.595092,Pescados y Mariscos,Pescadero Héroes del Mar,24300,6600,30900
13605,13606,21-10-2020 15:39:26.887932,Típica,Carbón & Mondongos,11870,6400,18270
13606,13607,21-10-2020 15:39:27.180233,Sushi · Asiática,Arigato,8900,5300,14200
13607,13608,21-10-2020 15:39:27.475368,Desayunos · Panadería,Le Pain Quotidien,15600,3900,19500
13608,13609,21-10-2020 15:39:27.868606,Pollo · Saludable,Yerbabuena,13000,3900,16900
13609,13610,21-10-2020 15:39:28.211938,Saludable · Desayunos,Malú,29500,3700,33200
13610,13611,21-10-2020 15:39:28.354590,Asiática,TeT,53900,5900,59800
13611,13612,21-10-2020 15:39:28.749974,Saludable · Desayunos,Distrito Gourmet,53900,3700,57600
13612,13613,21-10-2020 15:39:28.942581,Mexicana,La leyenda mexican kitchen,23000,3200,26200
13613,13614,21-10-2020 15:39:29.185687,Mexicana,Mexicanachos,7500,3900,11400
13614,13615,21-10-2020 15:39:29.378221,Parrilla · Internacional,Taperia de la Plaza,53400,5700,59100
13615,13616,21-10-2020 15:39:29.623331,Parrilla,OAK Ahumado y Brebajes,23000,6000,29000
13616,13617,21-10-2020 15:39:29.865925,Desayunos · Café,vereda central calle 99,35000,5700,40700
13617,13618,21-10-2020 15:39:30.108796,Postres · Desayunos,Protein Bakes,9000,5900,14900
13618,13619,21-10-2020 15:39:30.501531,Saludable · Desayunos,Fresh Co,34500,5600,40100
13619,13620,21-10-2020 15:39:30.646830,Saludable · Desayunos,Básico y elemental,17800,5000,22800
13620,13621,21-10-2020 15:39:31.040079,Pollo · China,China Tao,39700,3500,43200
13621,13622,21-10-2020 15:39:31.183103,Mexicana,La leyenda mexican kitchen,48750,3200,51950
13622,13623,21-10-2020 15:39:31.475847,Desayunos · Típica,D'Porco - Lechona,23000,6300,29300
13623,13624,21-10-2020 15:39:31.671140,Helados,Orso To Go,13000,6800,19800
13624,13625,21-10-2020 15:39:31.913868,Saludable · Típica,Saludable Mrg,15000,5800,20800
13625,13626,21-10-2020 15:39:32.056630,Pollo · China,China Tao,11870,3500,15370
13626,13627,21-10-2020 15:39:32.399401,Postres · Desayunos,Maltihelado,24300,4500,28800
13627,13628,21-10-2020 15:39:32.544528,Internacional,La Esquina con Sabor Parrilla,31800,3000,34800
13628,13629,21-10-2020 15:39:32.687342,Sushi,Canoa To Go,24300,5900,30200
13629,13630,21-10-2020 15:39:33.080198,Comida Rápida · Perros Calientes,Similoa - Comida Rapida,8900,3700,12600
13630,13631,21-10-2020 15:39:33.222941,Postres · Desayunos,Buñuelos nacho,27800,6600,34400
13631,13632,21-10-2020 15:39:33.367558,Desayunos,Archies Desayunos,29500,3100,32600
13632,13633,21-10-2020 15:39:33.660686,Saludable · Desayunos,Re.al Alimentos Reales,39700,4000,43700
13633,13634,21-10-2020 15:39:33.853815,Típica · Pescados y Mariscos,Arroces Mrg,35000,4300,39300
13634,13635,21-10-2020 15:39:34.196584,Saludable · Desayunos,Guadalupe - Fruteria,15600,5900,21500
13635,13636,21-10-2020 15:39:34.591964,Postres,Toledo Pastelería,10700,6800,17500
13636,13637,21-10-2020 15:39:34.885308,Pollo · Desayunos,Abasto,15600,3600,19200
13637,13638,21-10-2020 15:39:35.078646,Hamburguesas · Alitas,Beer,11870,6600,18470
13638,13639,21-10-2020 15:39:35.272695,Pollo,Oliva Va,31800,5600,37400
13639,13640,21-10-2020 15:39:35.667967,Peruana,Masivo,53900,5800,59700
13640,13641,21-10-2020 15:39:35.910723,Postres,Beiked,45800,4000,49800
13641,13642,21-10-2020 15:39:36.203921,Saludable · Desayunos,Agua Dulce,24200,3700,27900
13642,13643,21-10-2020 15:39:36.346602,Desayunos · Café,Frambas,7500,3400,10900
13643,13644,21-10-2020 15:39:36.691883,Saludable,The Good Rice Bowls,31800,3500,35300
13644,13645,21-10-2020 15:39:36.935344,Típica,Carbón & Mondongos,23000,6400,29400
13645,13646,21-10-2020 15:39:37.178953,Típica,Cabrito Santandereano,27800,6600,34400
13646,13647,21-10-2020 15:39:37.422194,Desayunos,Fratelli - Desayunos,18900,4600,23500
13647,13648,21-10-2020 15:39:37.667574,Desayunos · Típica,Papadió - Colombianas,27800,5700,33500
13648,13649,21-10-2020 15:39:37.910605,Pollo,Chicken House,39700,4200,43900
13649,13650,21-10-2020 15:39:38.304308,Típica · Parrilla,El Portal de la Antigua,13600,5600,19200
13650,13651,21-10-2020 15:39:38.547268,Sushi · Asiática,Arigato,31800,5300,37100
13651,13652,21-10-2020 15:39:38.842792,Típica,La Cocina,53400,4600,58000
13652,13653,21-10-2020 15:39:39.236389,Típica · Parrilla,La Parilla de David,24300,3100,27400
13653,13654,21-10-2020 15:39:39.579750,Parrilla,El Tambor,13000,6800,19800
13654,13655,21-10-2020 15:39:39.972711,Desayunos,Cafetería el Kippe,15600,3200,18800
13655,13656,21-10-2020 15:39:40.117579,Pollo · Desayunos,Caserito Gourmet,27800,6700,34500
13656,13657,21-10-2020 15:39:40.311257,Parrilla,Restaurante Bar Mi Ranchito,53400,5200,58600
13657,13658,21-10-2020 15:39:40.504595,Típica · Parrilla,La Parilla de David,8900,3100,12000
13658,13659,21-10-2020 15:39:40.697253,Desayunos,La Frijolada Desayunos,53900,4400,58300
13659,13660,21-10-2020 15:39:40.892107,Desayunos · Café,El Gualilo,35000,6200,41200
13660,13661,21-10-2020 15:39:41.135037,Postres · Desayunos,Amelie Helados,39700,6400,46100
13661,13662,21-10-2020 15:39:41.328347,Desayunos · Café,Libertario Coffee Roasters,53900,4600,58500
13662,13663,21-10-2020 15:39:41.471321,Postres · Desayunos,Jacques Pastelería,48750,5900,54650
13663,13664,21-10-2020 15:39:41.866368,Desayunos · Café,Frambas,37900,3400,41300
13664,13665,21-10-2020 15:39:42.109479,Desayunos · Sánduches,Danilo Colombia,24200,3300,27500
13665,13666,21-10-2020 15:39:42.352495,Postres · Desayunos,Maltihelado,48750,4500,53250
13666,13667,21-10-2020 15:39:42.494933,Típica,Lo Nuestro,24200,3100,27300
13667,13668,21-10-2020 15:39:42.889959,Alta Cocina · Parrilla,Criterión,31800,6000,37800
13668,13669,21-10-2020 15:39:43.233097,Desayunos · Jugos y Batidos,Frutiwow,23000,4100,27100
13669,13670,21-10-2020 15:39:43.375974,Típica · Parrilla,Mi Ranchito Parrilla,35000,4400,39400
13670,13671,21-10-2020 15:39:43.619318,Desayunos · Mexicana,La Mera Mera - Mexicana,48750,3100,51850
13671,13672,21-10-2020 15:39:43.914941,Saludable · Desayunos,Bon Eat - Saludable,8900,4800,13700
13672,13673,21-10-2020 15:39:44.208161,Típica,La Olla de Barro,45800,5300,51100
13673,13674,21-10-2020 15:39:44.551091,Saludable · Desayunos,Bawana - Sandwich,35000,3400,38400
13674,13675,21-10-2020 15:39:44.843702,Peruana,Uma Cantina Peruana,39700,3200,42900
13675,13676,21-10-2020 15:39:45.088480,Pollo · China,China Tao,23000,3500,26500
13676,13677,21-10-2020 15:39:45.432467,Saludable,Hanai - Bowls Saludables,24300,5900,30200
13677,13678,21-10-2020 15:39:45.575444,Pollo,Heart & Cooking,35000,5000,40000
13678,13679,21-10-2020 15:39:45.868092,Hamburguesas,Burger Society,18900,4100,23000
13679,13680,21-10-2020 15:39:46.263534,Postres · Desayunos,Café Quindio,27800,5700,33500
13680,13681,21-10-2020 15:39:46.506625,Desayunos · Jugos y Batidos,Dont Be Hungry,24300,5600,29900
13681,13682,21-10-2020 15:39:46.899804,Saludable · Típica,Sopas Mrg,70000,3100,73100
13682,13683,21-10-2020 15:39:47.192591,Saludable · Jugos y Batidos,Berdes Drinks & Salads,34500,3500,38000
13683,13684,21-10-2020 15:39:47.587797,Sánduches · Pescados y Mariscos,Pacific Comida de Mar,17800,4000,21800
13684,13685,21-10-2020 15:39:47.881244,Típica · Parrilla,La Parilla de David,7500,3100,10600
13685,13686,21-10-2020 15:39:48.274604,Postres · Desayunos,BagBog Bagels,23000,6400,29400
13686,13687,21-10-2020 15:39:48.517376,Desayunos · Típica,Cochon,48750,3300,52050
13687,13688,21-10-2020 15:39:48.812585,Postres,La Tertulia,45800,3400,49200
13688,13689,21-10-2020 15:39:49.205910,Típica,La Herencia,15000,5900,20900
13689,13690,21-10-2020 15:39:49.399345,Desayunos · Típica,D´Porco,29500,3900,33400
13690,13691,21-10-2020 15:39:49.592460,Pollo · Desayunos,Candelina,7500,5300,12800
13691,13692,21-10-2020 15:39:49.787843,Sushi,Kim Pop,12500,5400,17900
13692,13693,21-10-2020 15:39:50.181767,Comida Rápida · Perros Calientes,Similoa - Comida Rapida,37900,3700,41600
13693,13694,21-10-2020 15:39:50.324743,Desayunos · Panadería,Pasteleite,53400,5900,59300
13694,13695,21-10-2020 15:39:50.719383,Saludable · Jugos y Batidos,Berdes Drinks & Salads,11870,3500,15370
13695,13696,21-10-2020 15:39:51.064831,Típica,Salsig,10700,5600,16300
13696,13697,21-10-2020 15:39:51.308543,Saludable · Parrilla,Box,29500,3700,33200
13697,13698,21-10-2020 15:39:51.551583,Típica,Sopitas y Más,34500,4200,38700
13698,13699,21-10-2020 15:39:51.944400,Sushi,Kim Pop,45800,5400,51200
13699,13700,21-10-2020 15:39:52.140360,Desayunos · Típica,90 Calentados,65000,3700,68700
13700,13701,21-10-2020 15:39:52.283481,Desayunos · Café,vereda central calle 99,65000,5700,70700
13701,13702,21-10-2020 15:39:52.577035,Postres · Desayunos,Protein Bakes,65000,5900,70900
13702,13703,21-10-2020 15:39:52.870352,Desayunos · Café,Matchacha,53900,5900,59800
13703,13704,21-10-2020 15:39:53.166172,Mexicana,Cantina La 15,15600,4300,19900
13704,13705,21-10-2020 15:39:53.459913,Sánduches,Submarin,48750,3800,52550
13705,13706,21-10-2020 15:39:53.753225,Típica,Bendita S,13600,4600,18200
13706,13707,21-10-2020 15:39:54.096280,Desayunos · Sánduches,Frutos del Bosque,23000,3500,26500
13707,13708,21-10-2020 15:39:54.341483,Helados,Buon Gelato,48750,4400,53150
13708,13709,21-10-2020 15:39:54.734938,Postres · Café,Loló Coffee & Snacks,23000,4600,27600
13709,13710,21-10-2020 15:39:54.978102,Postres · Desayunos,Jacques Pastelería,15600,5900,21500
13710,13711,21-10-2020 15:39:55.320815,Típica,El Cucharón - Tipica,53900,4400,58300
13711,13712,21-10-2020 15:39:55.515753,Parrilla,Parrilla Pimentón,37900,3400,41300
13712,13713,21-10-2020 15:39:55.759994,Desayunos · Típica,Criollomania,23000,5200,28200
13713,13714,21-10-2020 15:39:55.903078,Desayunos · Típica,D'Porco - Lechona,7500,6300,13800
13714,13715,21-10-2020 15:39:56.246135,Desayunos · Comida Rápida,La Veneca,35000,6300,41300
13715,13716,21-10-2020 15:39:56.641695,Peruana · Internacional,La Chifería,8900,6600,15500
13716,13717,21-10-2020 15:39:56.834761,Postres · Desayunos,Maltihelado,24300,4500,28800
13717,13718,21-10-2020 15:39:57.077733,Desayunos · Panadería,Santa Juana Food Bar,24200,5900,30100
13718,13719,21-10-2020 15:39:57.220580,Saludable · Desayunos,Distrito Gourmet,48750,3700,52450
13719,13720,21-10-2020 15:39:57.416547,Saludable · Desayunos,Fresh Co,11870,5600,17470
13720,13721,21-10-2020 15:39:57.559554,Italiana,Bocatto Di Passo,45800,5000,50800
13721,13722,21-10-2020 15:39:57.702626,Desayunos · Panadería,Juliana Restaurante,23000,6100,29100
13722,13723,21-10-2020 15:39:57.995296,Pollo · Saludable,Gratina,13600,4200,17800
13723,13724,21-10-2020 15:39:58.340650,Italiana,Bocatto Di Passo,13600,5000,18600
13724,13725,21-10-2020 15:39:58.533827,Desayunos · Mexicana,La Mera Mera - Mexicana,35000,3100,38100
13725,13726,21-10-2020 15:39:58.927192,Desayunos · Panadería,Ficchi Panadería,15600,3100,18700
13726,13727,21-10-2020 15:39:59.119956,Café · Helados,Sofia heladería y café,7500,5800,13300
13727,13728,21-10-2020 15:39:59.515688,Saludable,Puro Verde,9000,5700,14700
13728,13729,21-10-2020 15:39:59.859421,Desayunos · Típica,Desayunadero de la 42,53900,5900,59800
13729,13730,21-10-2020 15:40:00.052414,Desayunos · Mexicana,La Mera Mera - Mexicana,24200,3100,27300
13730,13731,21-10-2020 15:40:00.194771,Saludable · Desayunos,Agua Dulce,45800,3700,49500
13731,13732,21-10-2020 15:40:00.339737,Desayunos · Típica,Rojo Gourmet,24200,4700,28900
13732,13733,21-10-2020 15:40:00.733423,Desayunos · Típica,La Frijolada,13600,4500,18100
13733,13734,21-10-2020 15:40:00.877366,Sushi · Asiática,Arigato,23000,5300,28300
13734,13735,21-10-2020 15:40:01.170437,Saludable · Típica,Sopas Mrg,31800,3100,34900
13735,13736,21-10-2020 15:40:01.315465,Típica · Parrilla,Toya,31800,4200,36000
13736,13737,21-10-2020 15:40:01.509045,Parrilla,OAK Ahumado y Brebajes,70000,6000,76000
13737,13738,21-10-2020 15:40:01.802620,Perros Calientes,Dog Shop - Rapida,35000,4900,39900
13738,13739,21-10-2020 15:40:02.145554,Postres · Desayunos,KOKOA & co.,27800,4700,32500
13739,13740,21-10-2020 15:40:02.490665,Parrilla,Arroces Maria Paula,15600,6800,22400
13740,13741,21-10-2020 15:40:02.783834,Panadería,Boul,11870,3100,14970
13741,13742,21-10-2020 15:40:03.027028,Saludable · Desayunos,Básico y Elemental,23000,5900,28900
13742,13743,21-10-2020 15:40:03.169666,Postres · Desayunos,Gelateria Da Favola,45800,6500,52300
13743,13744,21-10-2020 15:40:03.364854,Típica,Bandejas Mrg,15600,3800,19400
13744,13745,21-10-2020 15:40:03.608276,Hamburguesas · Alitas,Beer,23000,6600,29600
13745,13746,21-10-2020 15:40:03.901529,Postres · Desayunos,Maria Luisa - Postres,17800,4300,22100
13746,13747,21-10-2020 15:40:04.044352,Peruana,Masivo,15000,5800,20800
13747,13748,21-10-2020 15:40:04.390140,Pizza,18 Scalini,23000,4300,27300
13748,13749,21-10-2020 15:40:04.583323,Típica,Bendita S,8900,4600,13500
13749,13750,21-10-2020 15:40:04.726688,Saludable · Desayunos,Distrito Gourmet,7500,3700,11200
13750,13751,21-10-2020 15:40:04.970012,Desayunos · Panadería,Ficchi Panadería,15000,3100,18100
13751,13752,21-10-2020 15:40:05.165629,Hamburguesas · Alitas,Beer,39700,6600,46300
13752,13753,21-10-2020 15:40:05.309337,Mexicana,Mexicanachos,9000,3900,12900
13753,13754,21-10-2020 15:40:05.552571,Desayunos · Típica,Rojo Gourmet,39700,4700,44400
13754,13755,21-10-2020 15:40:05.896782,Típica,Salsig,53900,5600,59500
13755,13756,21-10-2020 15:40:06.192100,Mexicana,Cantina La 15,65000,4300,69300
13756,13757,21-10-2020 15:40:06.385392,Jugos y Batidos,Pomponio,37900,3600,41500
13757,13758,21-10-2020 15:40:06.578767,Postres · Panadería,RIGHT AWAY FOODS,8900,6600,15500
13758,13759,21-10-2020 15:40:06.972285,Desayunos · Café,vereda central calle 99,8900,5700,14600
13759,13760,21-10-2020 15:40:07.168201,Mexicana,Mexicanachos,23000,3900,26900
13760,13761,21-10-2020 15:40:07.312323,Desayunos · Helados,San Giorgio Gelateria,39700,3100,42800
13761,13762,21-10-2020 15:40:07.556152,Saludable · Desayunos,Raices Bienestar Gourmet,13600,6600,20200
13762,13763,21-10-2020 15:40:07.899754,Pizza,18 Scalini,45800,4300,50100
13763,13764,21-10-2020 15:40:08.295997,Desayunos · Panadería,Pasteleite,10700,5900,16600
13764,13765,21-10-2020 15:40:08.489749,Saludable,Hanai - Bowls Saludables,34500,5900,40400
13765,13766,21-10-2020 15:40:08.683058,Saludable · Desayunos,Malú,34500,3700,38200
13766,13767,21-10-2020 15:40:08.825696,Saludable,Amor Propio saludable,10700,4000,14700
13767,13768,21-10-2020 15:40:08.971131,Jugos y Batidos,Pomponio,29500,3600,33100
13768,13769,21-10-2020 15:40:09.364603,Desayunos,El Fogón Castellano,10700,3200,13900
13769,13770,21-10-2020 15:40:09.708545,Pollo · China,China Tao,15000,3500,18500
13770,13771,21-10-2020 15:40:09.851460,Desayunos · Café,Frambas,23000,3400,26400
13771,13772,21-10-2020 15:40:10.197246,Asiática,TeT,15600,5900,21500
13772,13773,21-10-2020 15:40:10.340340,Postres · Desayunos,Sharmus,13600,6100,19700
13773,13774,21-10-2020 15:40:10.483827,Desayunos · Sánduches,Danilo Colombia,12500,3300,15800
13774,13775,21-10-2020 15:40:10.826953,Parrilla,El Tambor,29500,6800,36300
13775,13776,21-10-2020 15:40:10.974083,Parrilla,Arroces Maria Paula,70000,6800,76800
13776,13777,21-10-2020 15:40:11.317875,Típica,Cabrito Santandereano,24300,6600,30900
13777,13778,21-10-2020 15:40:11.612270,Típica · Pescados y Mariscos,Arroces Mrg,18900,4300,23200
13778,13779,21-10-2020 15:40:11.755412,Desayunos · Típica,90 Calentados,29500,3700,33200
13779,13780,21-10-2020 15:40:12.101243,Pescados y Mariscos,Fish Place - Del Mar,53400,5400,58800
13780,13781,21-10-2020 15:40:12.394830,Desayunos,Sr Buñuelo,70000,6400,76400
13781,13782,21-10-2020 15:40:12.739005,Pollo · Desayunos,Abasto,13000,3600,16600
13782,13783,21-10-2020 15:40:13.082113,Saludable,Hanai - Bowls Saludables,34500,5900,40400
13783,13784,21-10-2020 15:40:13.377728,Desayunos · Panadería,Artesanos,12500,4300,16800
13784,13785,21-10-2020 15:40:13.571780,Desayunos · Internacional,Camilia,27800,3900,31700
13785,13786,21-10-2020 15:40:13.864955,Pollo · Desayunos,Workzone,37900,3100,41000
13786,13787,21-10-2020 15:40:14.107948,Saludable,A2manos,27800,4200,32000
13787,13788,21-10-2020 15:40:14.353106,Saludable · Desayunos,Bawana - Sandwich,24200,3400,27600
13788,13789,21-10-2020 15:40:14.546274,Desayunos,Butter,39700,6700,46400
13789,13790,21-10-2020 15:40:14.839547,Saludable,Amor Propio saludable,18900,4000,22900
13790,13791,21-10-2020 15:40:15.132843,Postres,La Tertulia,13000,3400,16400
13791,13792,21-10-2020 15:40:15.428360,Postres · Saludable,Ana Rebana,24200,6300,30500
13792,13793,21-10-2020 15:40:15.722459,Crepes,La Chabatta,10700,5900,16600
13793,13794,21-10-2020 15:40:15.966239,Desayunos · Comida Rápida,La Veneca,45800,6300,52100
13794,13795,21-10-2020 15:40:16.259887,Saludable,MIMA,15600,3700,19300
13795,13796,21-10-2020 15:40:16.656123,Postres,Toledo Pastelería,18900,6800,25700
13796,13797,21-10-2020 15:40:17.000014,Mexicana,Hidalgo Taquería,31800,4900,36700
13797,13798,21-10-2020 15:40:17.243973,Típica · Parrilla,La Ternera Parrilla,27800,5200,33000
13798,13799,21-10-2020 15:40:17.637366,Saludable,MIMA,39700,3700,43400
13799,13800,21-10-2020 15:40:17.782880,Saludable,Amor Propio saludable,11870,4000,15870
13800,13801,21-10-2020 15:40:18.026392,Saludable · Desayunos,Libre de Culpa,39700,4000,43700
13801,13802,21-10-2020 15:40:18.170403,Pescados y Mariscos,Fish Place - Del Mar,13000,5400,18400
13802,13803,21-10-2020 15:40:18.463697,Típica,Juan Chorizo,9000,3900,12900
13803,13804,21-10-2020 15:40:18.609423,Desayunos · Panadería,Pasteleite,39700,5900,45600
13804,13805,21-10-2020 15:40:19.002608,Típica · Parrilla,El Santandereano,53400,5200,58600
13805,13806,21-10-2020 15:40:19.196023,Desayunos,Sunny Breakfast Brunch,27800,4300,32100
13806,13807,21-10-2020 15:40:19.488971,Mexicana,Cantina La 15,17800,4300,22100
13807,13808,21-10-2020 15:40:19.634984,Desayunos,Bagel Shop,9000,3200,12200
13808,13809,21-10-2020 15:40:19.778851,Postres · Desayunos,Aury Postres - Comidas & Picadas,39700,4700,44400
13809,13810,21-10-2020 15:40:20.173420,Pizza · Italiana,Piatto - Pizza,17800,6600,24400
13810,13811,21-10-2020 15:40:20.367274,Desayunos · Típica,Casa Vieja,10700,6000,16700
13811,13812,21-10-2020 15:40:20.713054,Típica,La Herencia,70000,5900,75900
13812,13813,21-10-2020 15:40:20.856420,Postres · Desayunos,Restaurante Cornelia,45800,5500,51300
13813,13814,21-10-2020 15:40:21.099846,Desayunos · Café,Libertario Coffee Roasters,15600,4600,20200
13814,13815,21-10-2020 15:40:21.494280,Alta Cocina · Postres,La Pinta,35000,4500,39500
13815,13816,21-10-2020 15:40:21.689745,Hamburguesas · Alitas,Beer,24200,6600,30800
13816,13817,21-10-2020 15:40:21.884330,Desayunos · Café,El Gualilo,39700,6200,45900
13817,13818,21-10-2020 15:40:22.128677,Desayunos · Panadería,Santa Juana Food Bar,8900,5900,14800
13818,13819,21-10-2020 15:40:22.373671,Saludable · Típica,Saludable Mrg,24200,5800,30000
13819,13820,21-10-2020 15:40:22.617559,Típica,Salsig,18900,5600,24500
13820,13821,21-10-2020 15:40:22.861895,Pescados y Mariscos,La Gran Cazuela,23000,3200,26200
13821,13822,21-10-2020 15:40:23.256424,Típica,Cazuelitas 93,11870,3900,15770
13822,13823,21-10-2020 15:40:23.601394,Pollo,Señor Fantástico,70000,4700,74700
13823,13824,21-10-2020 15:40:23.945422,Típica · Parrilla,La Ternera Parrilla,34500,5200,39700
13824,13825,21-10-2020 15:40:24.090286,Café · Helados,Sofia heladería y café,34500,5800,40300
13825,13826,21-10-2020 15:40:24.384810,Comida Rápida,Fiesta Digital Andrés,53900,3100,57000
13826,13827,21-10-2020 15:40:24.778328,Desayunos · Café,Norma's Ice Cream Café,10700,6300,17000
13827,13828,21-10-2020 15:40:25.074064,Mexicana,Cantina La 15,34500,4300,38800
13828,13829,21-10-2020 15:40:25.419524,Pollo · Desayunos,Caserito Gourmet,8900,6700,15600
13829,13830,21-10-2020 15:40:25.814463,Pollo · Típica,Auyama,15600,3900,19500
13830,13831,21-10-2020 15:40:26.009236,Desayunos · Típica,Fogón Sangileño,65000,5000,70000
13831,13832,21-10-2020 15:40:26.353653,Parrilla,Beraca Parrilla Bbq,24200,5600,29800
13832,13833,21-10-2020 15:40:26.649580,Poke,Poke Go,24300,4600,28900
13833,13834,21-10-2020 15:40:26.843644,Desayunos · Panadería,Artesanos,23000,4300,27300
13834,13835,21-10-2020 15:40:27.188595,Típica · Parrilla,La Ternera Parrilla,15600,5200,20800
13835,13836,21-10-2020 15:40:27.482844,Desayunos · Típica,Peninsula Calentados y Parrilla,18900,3400,22300
13836,13837,21-10-2020 15:40:27.827939,Perros Calientes,Dog Shop - Rapida,35000,4900,39900
13837,13838,21-10-2020 15:40:28.022150,Desayunos,Bagel Shop,24300,3200,27500
13838,13839,21-10-2020 15:40:28.267146,Desayunos,Butter,29500,6700,36200
13839,13840,21-10-2020 15:40:28.660919,Postres,Beiked,15600,4000,19600
13840,13841,21-10-2020 15:40:28.855346,Desayunos · Jugos y Batidos,Dont Be Hungry,37900,5600,43500
13841,13842,21-10-2020 15:40:29.199550,Hamburguesas,Bendito Cordero,15000,5800,20800
13842,13843,21-10-2020 15:40:29.344124,Pollo · Pescados y Mariscos,Bang Bang Rice,18900,3400,22300
13843,13844,21-10-2020 15:40:29.688465,Típica · Parrilla,Parrilla Farandula Gourmet,15000,5100,20100
13844,13845,21-10-2020 15:40:29.983393,Desayunos,Desayunos en Bogotá,10700,3400,14100
13845,13846,21-10-2020 15:40:30.377682,Desayunos,El Fogón Castellano,7500,3200,10700
13846,13847,21-10-2020 15:40:30.572191,Postres · Desayunos,Café Quindio,18900,5700,24600
13847,13848,21-10-2020 15:40:30.966397,Mexicana,Cantina La 15,35000,4300,39300
13848,13849,21-10-2020 15:40:31.111243,Postres · Desayunos,Buñuelos nacho,65000,6600,71600
13849,13850,21-10-2020 15:40:31.305934,Postres · Desayunos,Amelie Helados,65000,6400,71400
13850,13851,21-10-2020 15:40:31.500833,Postres · Desayunos,BagBog Bagels,34500,6400,40900
13851,13852,21-10-2020 15:40:31.645321,Desayunos · Típica,Peninsula Calentados y Parrilla,15600,3400,19000
13852,13853,21-10-2020 15:40:31.991464,Postres · Saludable,Ana Rebana,53400,6300,59700
13853,13854,21-10-2020 15:40:32.335828,Desayunos · Panadería,Ficchi Panadería,53400,3100,56500
13854,13855,21-10-2020 15:40:32.631347,Desayunos · Típica,Fogón Sangileño,53900,5000,58900
13855,13856,21-10-2020 15:40:32.925848,Típica · Parrilla,Parrilla Farandula Gourmet,13600,5100,18700
13856,13857,21-10-2020 15:40:33.070616,Postres · Desayunos,Maria Luisa - Postres,23000,4300,27300
13857,13858,21-10-2020 15:40:33.264921,Pizza,pizza andante,70000,4200,74200
13858,13859,21-10-2020 15:40:33.560037,Desayunos · Sánduches,Frutos del Bosque,13600,3500,17100
13859,13860,21-10-2020 15:40:33.854505,Postres · Desayunos,La Folie - Postres,31800,3300,35100
13860,13861,21-10-2020 15:40:33.999832,Desayunos · Típica,Casa Vieja,18900,6000,24900
13861,13862,21-10-2020 15:40:34.194165,Desayunos · Panadería,Ficchi Panadería,35000,3100,38100
13862,13863,21-10-2020 15:40:34.589071,Postres · Desayunos,Sharmus,15000,6100,21100
13863,13864,21-10-2020 15:40:34.983881,Saludable,Hanai - Bowls Saludables,11870,5900,17770
13864,13865,21-10-2020 15:40:35.329690,Desayunos · Café,Matchacha,35000,5900,40900
13865,13866,21-10-2020 15:40:35.524378,Pizza,Pizza Andante,45800,6300,52100
13866,13867,21-10-2020 15:40:35.920852,Postres · Desayunos,Buñuelos nacho,29500,6600,36100
13867,13868,21-10-2020 15:40:36.065654,Postres · Desayunos,Gelateria Da Favola,15000,6500,21500
13868,13869,21-10-2020 15:40:36.462965,Desayunos · Típica,Desayunadero de la 42,48750,5900,54650
13869,13870,21-10-2020 15:40:36.657770,Saludable · Desayunos,Bon Eat - Saludable,23000,4800,27800
13870,13871,21-10-2020 15:40:36.902748,Postres · Desayunos,La Folie - Postres,37900,3300,41200
13871,13872,21-10-2020 15:40:37.148994,Pescados y Mariscos,Fish Place - Del Mar,31800,5400,37200
13872,13873,21-10-2020 15:40:37.394303,Postres,La Tertulia,23000,3400,26400
13873,13874,21-10-2020 15:40:37.639829,Parrilla,Carnes la Zarza,23000,4900,27900
13874,13875,21-10-2020 15:40:37.784141,Hamburguesas · Alitas,Beer,37900,6600,44500
13875,13876,21-10-2020 15:40:38.131202,Parrilla,Arroces Maria Paula,65000,6800,71800
13876,13877,21-10-2020 15:40:38.327504,Desayunos · Típica,Alce,53400,4900,58300
13877,13878,21-10-2020 15:40:38.672133,Mexicana,La leyenda mexican kitchen,27800,3200,31000
13878,13879,21-10-2020 15:40:38.817408,Mexicana,Hidalgo Taquería,37900,4900,42800
13879,13880,21-10-2020 15:40:39.011994,Parrilla,Restaurante Bar Mi Ranchito,53900,5200,59100
13880,13881,21-10-2020 15:40:39.407158,Parrilla,Arroces Maria Paula,48750,6800,55550
13881,13882,21-10-2020 15:40:39.553382,Poke,Poke Go,39700,4600,44300
13882,13883,21-10-2020 15:40:39.797947,Postres · Desayunos,Restaurante Cornelia,27800,5500,33300
13883,13884,21-10-2020 15:40:39.992419,Pescados y Mariscos,La Gran Cazuela,27800,3200,31000
13884,13885,21-10-2020 15:40:40.187308,Pollo · Saludable,Tremenda Sal y Dulce,53900,6500,60400
13885,13886,21-10-2020 15:40:40.381112,Saludable,MIMA,70000,3700,73700
13886,13887,21-10-2020 15:40:40.677491,Desayunos · Internacional,Camilia,15600,3900,19500
13887,13888,21-10-2020 15:40:40.922195,Desayunos · Jugos y Batidos,Dont Be Hungry,31800,5600,37400
13888,13889,21-10-2020 15:40:41.117711,Desayunos · Típica,Parrilla Farandula Típico,9000,5900,14900
13889,13890,21-10-2020 15:40:41.361681,Desayunos · Panadería,Choclofee,9000,4700,13700
13890,13891,21-10-2020 15:40:41.507596,Saludable · Desayunos,Básico y elemental,53900,5000,58900
13891,13892,21-10-2020 15:40:41.652411,Hamburguesas,Burger Society,48750,4100,52850
13892,13893,21-10-2020 15:40:41.847610,Parrilla,El Tambor,23000,6800,29800
13893,13894,21-10-2020 15:40:41.991792,Panadería,Boul,53400,3100,56500
13894,13895,21-10-2020 15:40:42.189328,Desayunos,Archies Desayunos,10700,3100,13800
13895,13896,21-10-2020 15:40:42.333680,Saludable · Desayunos,Libre de Culpa,29500,4000,33500
13896,13897,21-10-2020 15:40:42.579012,Postres · Desayunos,Amelie Helados,34500,6400,40900
13897,13898,21-10-2020 15:40:42.923220,Típica · Parrilla,La Ternera Parrilla,35000,5200,40200
13898,13899,21-10-2020 15:40:43.069809,Pollo,Heart & Cooking,23000,5000,28000
13899,13900,21-10-2020 15:40:43.364374,Desayunos · Árabe,Boniato Sabores Vivos,12500,5300,17800
13900,13901,21-10-2020 15:40:43.660419,Postres,Beiked,31800,4000,35800
13901,13902,21-10-2020 15:40:44.005068,Desayunos,Cafetería el Kippe,17800,3200,21000
13902,13903,21-10-2020 15:40:44.352349,Desayunos · Sánduches,Garnish,70000,5200,75200
13903,13904,21-10-2020 15:40:44.697427,Asiática,Thai Station,34500,6000,40500
13904,13905,21-10-2020 15:40:45.043719,Desayunos · Internacional,Camilia,45800,3900,49700
13905,13906,21-10-2020 15:40:45.388313,Hamburguesas,Bendito Cordero,10700,5800,16500
13906,13907,21-10-2020 15:40:45.785585,Desayunos · Panadería,Premium Break Bakery,15000,3700,18700
13907,13908,21-10-2020 15:40:45.980291,Desayunos · Típica,Papadió - Colombianas,35000,5700,40700
13908,13909,21-10-2020 15:40:46.175692,Postres · Desayunos,Aury Postres - Comidas & Picadas,70000,4700,74700
13909,13910,21-10-2020 15:40:46.319936,Postres · Desayunos,Café Quindio,45800,5700,51500
13910,13911,21-10-2020 15:40:46.667077,Postres,La Galeta,53400,3000,56400
13911,13912,21-10-2020 15:40:46.961775,Desayunos · Típica,Alce,23000,4900,27900
13912,13913,21-10-2020 15:40:47.308123,Saludable,Amor Propio saludable,35000,4000,39000
13913,13914,21-10-2020 15:40:47.502477,Desayunos · Panadería,El Pan de Phillippe,23000,4600,27600
13914,13915,21-10-2020 15:40:47.699312,Postres · Desayunos,Sweet Tale,23000,5800,28800
13915,13916,21-10-2020 15:40:48.044615,Típica · Parrilla,Mi Ranchito Parrilla,31800,4400,36200
13916,13917,21-10-2020 15:40:48.190135,Pollo · Desayunos,Abasto,15000,3600,18600
13917,13918,21-10-2020 15:40:48.534842,Típica,Salsig,45800,5600,51400
13918,13919,21-10-2020 15:40:48.881752,Desayunos · Panadería,Pasteleite,65000,5900,70900
13919,13920,21-10-2020 15:40:49.127565,Típica,El Cucharón - Tipica,27800,4400,32200
13920,13921,21-10-2020 15:40:49.474008,Típica,El Mondongo y Mucho Mas,37900,5600,43500
13921,13922,21-10-2020 15:40:49.819211,Desayunos · Típica,Papadió - Colombianas,35000,5700,40700
13922,13923,21-10-2020 15:40:50.066457,Pollo,Heart & Cooking,24300,5000,29300
13923,13924,21-10-2020 15:40:50.361632,Saludable · Jugos y Batidos,Berdes Drinks & Salads,48750,3500,52250
13924,13925,21-10-2020 15:40:50.556689,Hamburguesas,Bendito Cordero,48750,5800,54550
13925,13926,21-10-2020 15:40:50.901068,Pizza,pizza andante,13600,4200,17800
13926,13927,21-10-2020 15:40:51.197563,Postres · Desayunos,Vivalight Market.,23000,6500,29500
13927,13928,21-10-2020 15:40:51.592309,Sushi · Asiática,Arigato,7500,5300,12800
13928,13929,21-10-2020 15:40:51.887556,Desayunos · Típica,Desayunadero de la 42,9000,5900,14900
13929,13930,21-10-2020 15:40:52.282024,Mexicana,Cantina La 15,24200,4300,28500
13930,13931,21-10-2020 15:40:52.579636,Peruana,Uma Cantina Peruana,11870,3200,15070
13931,13932,21-10-2020 15:40:52.724658,Postres,La Galeta,39700,3000,42700
13932,13933,21-10-2020 15:40:53.019753,Sánduches,Submarin,29500,3800,33300
13933,13934,21-10-2020 15:40:53.214115,Típica · Parrilla,Parrilla Farandula Gourmet,23000,5100,28100
13934,13935,21-10-2020 15:40:53.510584,Postres,La Galeta,53900,3000,56900
13935,13936,21-10-2020 15:40:53.655116,Desayunos · Café,Moramia,53400,4700,58100
13936,13937,21-10-2020 15:40:54.050562,Sánduches · Pescados y Mariscos,Pacific Comida de Mar,70000,4000,74000
13937,13938,21-10-2020 15:40:54.445447,Parrilla · Café,Gaira Café,17800,4400,22200
13938,13939,21-10-2020 15:40:54.842151,Típica,Cabrito Santandereano,31800,6600,38400
13939,13940,21-10-2020 15:40:55.187143,Pizza,pizza andante,12500,4200,16700
13940,13941,21-10-2020 15:40:55.332471,Desayunos · Comida Rápida,Chocolatto,35000,3400,38400
13941,13942,21-10-2020 15:40:55.676891,Desayunos · Jugos y Batidos,Dont Be Hungry,10700,5600,16300
13942,13943,21-10-2020 15:40:55.873268,Desayunos · Panadería,Siena Café,23000,3700,26700
13943,13944,21-10-2020 15:40:56.268142,Pollo · Saludable,Yerbabuena,31800,3900,35700
13944,13945,21-10-2020 15:40:56.663619,Típica,Carbón & Mondongos,34500,6400,40900
13945,13946,21-10-2020 15:40:56.807625,Postres · Desayunos,Maria Luisa - Postres,23000,4300,27300
13946,13947,21-10-2020 15:40:57.154161,Sushi · Asiática,Arigato,23000,5300,28300
13947,13948,21-10-2020 15:40:57.549231,Saludable,The Good Rice Bowls,7500,3500,11000
13948,13949,21-10-2020 15:40:57.895693,Parrilla · Café,Figaro Café/ Restaurante Argentino,48750,5800,54550
13949,13950,21-10-2020 15:40:58.140095,Postres,La Galeta,17800,3000,20800
13950,13951,21-10-2020 15:40:58.537354,Postres · Café,Celestino Café,34500,5900,40400
13951,13952,21-10-2020 15:40:58.832436,Saludable,Ventura Soup y Salad,11870,3800,15670
13952,13953,21-10-2020 15:40:58.978212,Saludable · Típica,Saludable Mrg,35000,5800,40800
13953,13954,21-10-2020 15:40:59.122533,Típica · Parrilla,Typykos,18900,6000,24900
13954,13955,21-10-2020 15:40:59.319112,Desayunos · Empanadas,Mis Delicias,23000,3200,26200
13955,13956,21-10-2020 15:40:59.663748,Saludable · Desayunos,La Estampilla,65000,6000,71000
13956,13957,21-10-2020 15:40:59.909377,Peruana · Internacional,La Chifería,15600,6600,22200
13957,13958,21-10-2020 15:41:00.053374,Típica,La Cocina,10700,4600,15300
13958,13959,21-10-2020 15:41:00.199824,Típica,La Olla de Barro,65000,5300,70300
13959,13960,21-10-2020 15:41:00.544723,Sushi,Kim Pop,31800,5400,37200
13960,13961,21-10-2020 15:41:00.940362,Sushi,Kim Pop,24200,5400,29600
13961,13962,21-10-2020 15:41:01.184600,Desayunos · Empanadas,Mis Delicias,37900,3200,41100
13962,13963,21-10-2020 15:41:01.481158,Peruana,Uma Cantina Peruana,53400,3200,56600
13963,13964,21-10-2020 15:41:01.625885,Helados,Orso To Go,15600,6800,22400
13964,13965,21-10-2020 15:41:01.821659,Hamburguesas,Burger Society,15600,4100,19700
13965,13966,21-10-2020 15:41:02.166276,Desayunos,Desayunos en Bogotá,24200,3400,27600
13966,13967,21-10-2020 15:41:02.562573,Postres · Desayunos,La Folie - Postres,31800,3300,35100
13967,13968,21-10-2020 15:41:02.908350,Desayunos · Café,Norma's Ice Cream Café,70000,6300,76300
13968,13969,21-10-2020 15:41:03.304462,Desayunos · Panadería,Pasteleite,8900,5900,14800
13969,13970,21-10-2020 15:41:03.699346,Postres · Desayunos,Amelie Helados,13000,6400,19400
13970,13971,21-10-2020 15:41:04.046068,Sushi · Desayunos,Maki Roll,35000,4300,39300
13971,13972,21-10-2020 15:41:04.440871,Pollo · Saludable,Tremenda Sal y Dulce,24300,6500,30800
13972,13973,21-10-2020 15:41:04.586391,Desayunos · Helados,San Giorgio Gelateria,53900,3100,57000
13973,13974,21-10-2020 15:41:04.981034,Desayunos,Bagel Shop,24200,3200,27400
13974,13975,21-10-2020 15:41:05.377594,Típica,Sabrosito,53900,4000,57900
13975,13976,21-10-2020 15:41:05.572298,Desayunos · Típica,Peninsula Calentados y Parrilla,10700,3400,14100
13976,13977,21-10-2020 15:41:05.867814,Saludable · Desayunos,Básico y elemental,35000,5000,40000
13977,13978,21-10-2020 15:41:06.012064,Típica · Parrilla,El Santandereano,35000,5200,40200
13978,13979,21-10-2020 15:41:06.208463,Desayunos · Panadería,Santa Juana Food Bar,13600,5900,19500
13979,13980,21-10-2020 15:41:06.352932,Mexicana,Hidalgo Taquería,48750,4900,53650
13980,13981,21-10-2020 15:41:06.498372,Desayunos · Pescados y Mariscos,Luzí­a - Mediterranea,15000,5700,20700
13981,13982,21-10-2020 15:41:06.692726,Parrilla,Campocina,35000,4600,39600
13982,13983,21-10-2020 15:41:06.889379,Desayunos · Típica,Peninsula Calentados y Parrilla,29500,3400,32900
13983,13984,21-10-2020 15:41:07.284720,Típica · Parrilla,Toya,13000,4200,17200
13984,13985,21-10-2020 15:41:07.680377,Pescados y Mariscos,Pescadero Héroes del Mar,35000,6600,41600
13985,13986,21-10-2020 15:41:07.824712,Desayunos · Café,vereda central calle 99,23000,5700,28700
13986,13987,21-10-2020 15:41:08.171735,Típica,Cazuelitas 93,17800,3900,21700
13987,13988,21-10-2020 15:41:08.566890,Saludable · Desayunos,Malú,48750,3700,52450
13988,13989,21-10-2020 15:41:08.962598,Desayunos · Árabe,Boniato Sabores Vivos,24200,5300,29500
13989,13990,21-10-2020 15:41:09.207343,Desayunos,Don Leo,23000,6000,29000
13990,13991,21-10-2020 15:41:09.354325,Desayunos · Árabe,Boniato Sabores Vivos,35000,5300,40300
13991,13992,21-10-2020 15:41:09.699150,Desayunos · Típica,Peninsula Calentados y Parrilla,8900,3400,12300
13992,13993,21-10-2020 15:41:09.945190,Saludable · Desayunos,Agua Dulce,27800,3700,31500
13993,13994,21-10-2020 15:41:10.339947,Desayunos,Archies Desayunos,15600,3100,18700
13994,13995,21-10-2020 15:41:10.636739,Desayunos · Típica,Casa Vieja,18900,6000,24900
13995,13996,21-10-2020 15:41:10.831819,Saludable · Desayunos,Básico y elemental,23000,5000,28000
13996,13997,21-10-2020 15:41:10.977025,Saludable · Desayunos,Raices Bienestar Gourmet,35000,6600,41600
13997,13998,21-10-2020 15:41:11.371973,Saludable · Típica,Saludable Mrg,37900,5800,43700
13998,13999,21-10-2020 15:41:11.716581,Comida Rápida · Perros Calientes,Similoa - Comida Rapida,31800,3700,35500
13999,14000,21-10-2020 15:41:12.112298,Postres · Desayunos,Gelateria Da Favola,11870,6500,18370
14000,14001,21-10-2020 15:41:12.306855,Desayunos · Sánduches,Garnish,34500,5200,39700
14001,14002,21-10-2020 15:41:12.502332,Desayunos · Típica,D´Porco,7500,3900,11400
14002,14003,21-10-2020 15:41:12.896702,Desayunos · Comida Rápida,Chocolatto,15000,3400,18400
14003,14004,21-10-2020 15:41:13.041395,Parrilla · Café,Gaira Café,48750,4400,53150
14004,14005,21-10-2020 15:41:13.436798,China,China Food Col,13000,3600,16600
14005,14006,21-10-2020 15:41:13.731725,Postres · Desayunos,Amelie Helados,53900,6400,60300
14006,14007,21-10-2020 15:41:14.125912,Hamburguesas,Bendito Cordero,27800,5800,33600
14007,14008,21-10-2020 15:41:14.422516,Hamburguesas · Pescados y Mariscos,El Velero,23000,6500,29500
14008,14009,21-10-2020 15:41:14.716721,Pescados y Mariscos,La Gran Cazuela,53900,3200,57100
14009,14010,21-10-2020 15:41:14.911352,Típica,Carbón & Mondongos,34500,6400,40900
14010,14011,21-10-2020 15:41:15.155585,Parrilla · Internacional,Taperia de la Plaza,12500,5700,18200
14011,14012,21-10-2020 15:41:15.550769,Postres · Café,Loló Coffee & Snacks,13600,4600,18200
14012,14013,21-10-2020 15:41:15.844641,Desayunos · Típica,D'Porco - Lechona,24200,6300,30500
14013,14014,21-10-2020 15:41:16.039482,Desayunos · Café,Aromacafé el Placer de Compartir,70000,5000,75000
14014,14015,21-10-2020 15:41:16.433804,Pollo,Chicken House,39700,4200,43900
14015,14016,21-10-2020 15:41:16.828368,Postres · Desayunos,Sweet Tale,27800,5800,33600
14016,14017,21-10-2020 15:41:17.173244,Desayunos · Pescados y Mariscos,Luzí­a - Mediterranea,7500,5700,13200
14017,14018,21-10-2020 15:41:17.317999,Pollo · Típica,Auyama,10700,3900,14600
14018,14019,21-10-2020 15:41:17.511884,Postres · Desayunos,BagBog Bagels,53900,6400,60300
14019,14020,21-10-2020 15:41:17.657048,Pollo · Desayunos,Caserito Gourmet,7500,6700,14200
14020,14021,21-10-2020 15:41:17.950940,Parrilla,Campocina,23000,4600,27600
14021,14022,21-10-2020 15:41:18.346300,Desayunos · Café,Moramia,35000,4700,39700
14022,14023,21-10-2020 15:41:18.591589,Pizza,18 Scalini,34500,4300,38800
14023,14024,21-10-2020 15:41:18.936752,Postres · Desayunos,Jacques Pastelería,65000,5900,70900
14024,14025,21-10-2020 15:41:19.130881,Desayunos · Café,El Gualilo,31800,6200,38000
14025,14026,21-10-2020 15:41:19.325948,Pizza,Pizza Andante,9000,6300,15300
14026,14027,21-10-2020 15:41:19.620565,Típica,La Olla de Barro,65000,5300,70300
14027,14028,21-10-2020 15:41:19.765542,Desayunos · Típica,Rojo Gourmet,45800,4700,50500
14028,14029,21-10-2020 15:41:20.159982,Hamburguesas · Alitas,Beer,12500,6600,19100
14029,14030,21-10-2020 15:41:20.505116,Postres · Desayunos,Gelateria Da Favola,13600,6500,20100
14030,14031,21-10-2020 15:41:20.749528,Postres · Desayunos,Amelie Helados,9000,6400,15400
14031,14032,21-10-2020 15:41:20.894485,Postres · Desayunos,Café Quindio,13600,5700,19300
14032,14033,21-10-2020 15:41:21.039229,Pollo · Sánduches,Pollos Century,23000,3000,26000
14033,14034,21-10-2020 15:41:21.435323,Café · Helados,Sofia heladería y café,10700,5800,16500
14034,14035,21-10-2020 15:41:21.630391,Desayunos · Típica,90 Calentados,7500,3700,11200
14035,14036,21-10-2020 15:41:21.875398,Desayunos · Sánduches,Danilo Colombia,39700,3300,43000
14036,14037,21-10-2020 15:41:22.069376,Sánduches · China,Peru Mix,18900,5900,24800
14037,14038,21-10-2020 15:41:22.364387,Postres · Desayunos,Buñuelos nacho,53400,6600,60000
14038,14039,21-10-2020 15:41:22.758903,Desayunos · Café,Frambas,13000,3400,16400
14039,14040,21-10-2020 15:41:23.153824,Típica,Cabrito Santandereano,10700,6600,17300
14040,14041,21-10-2020 15:41:23.347648,Desayunos · Panadería,Juliana Restaurante,13600,6100,19700
14041,14042,21-10-2020 15:41:23.643924,Desayunos · Panadería,Choclofee,53400,4700,58100
14042,14043,21-10-2020 15:41:23.887772,Desayunos · Típica,Rojo Gourmet,35000,4700,39700
14043,14044,21-10-2020 15:41:24.032395,Desayunos,Don Leo,24300,6000,30300
14044,14045,21-10-2020 15:41:24.276557,Desayunos · Típica,Peninsula Calentados y Parrilla,10700,3400,14100
14045,14046,21-10-2020 15:41:24.471568,Pizza,pizza andante,24300,4200,28500
14046,14047,21-10-2020 15:41:24.615588,Desayunos · Típica,Alce,48750,4900,53650
14047,14048,21-10-2020 15:41:24.960696,Saludable · Desayunos,Copacabana Açai Bowls,13600,3000,16600
14048,14049,21-10-2020 15:41:25.355055,Pollo,Heart & Cooking,70000,5000,75000
14049,14050,21-10-2020 15:41:25.700165,Italiana,F*cking Good Pizza,31800,4200,36000
14050,14051,21-10-2020 15:41:26.044705,Desayunos,Bagel Shop,53900,3200,57100
14051,14052,21-10-2020 15:41:26.440208,Internacional,La Esquina con Sabor Parrilla,7500,3000,10500
14052,14053,21-10-2020 15:41:26.834892,Desayunos · Comida Rápida,Chocolatto,45800,3400,49200
14053,14054,21-10-2020 15:41:26.979822,Saludable · Parrilla,The Angels Grill and Drinks,53400,6200,59600
14054,14055,21-10-2020 15:41:27.224117,Saludable · Desayunos,Raices Bienestar Gourmet,35000,6600,41600
14055,14056,21-10-2020 15:41:27.619317,Desayunos,Archies Desayunos,15000,3100,18100
14056,14057,21-10-2020 15:41:28.013608,Peruana,Uma Cantina Peruana,23000,3200,26200
14057,14058,21-10-2020 15:41:28.409204,Desayunos,Jacinta Arepas de Huevo,7500,4000,11500
14058,14059,21-10-2020 15:41:28.603248,Parrilla,Coquitas,23000,5600,28600
14059,14060,21-10-2020 15:41:28.999518,Parrilla,Campocina,15600,4600,20200
14060,14061,21-10-2020 15:41:29.343562,Saludable,MIMA,13600,3700,17300
14061,14062,21-10-2020 15:41:29.638776,Desayunos · Panadería,Santa Juana Food Bar,34500,5900,40400
14062,14063,21-10-2020 15:41:29.983368,Mexicana,Cantina La 15,23000,4300,27300
14063,14064,21-10-2020 15:41:30.128112,Desayunos · Comida Rápida,La Veneca,45800,6300,52100
14064,14065,21-10-2020 15:41:30.472412,Típica,Cabrito Santandereano,10700,6600,17300
14065,14066,21-10-2020 15:41:30.817651,Parrilla,Parrilla Pimentón,12500,3400,15900
14066,14067,21-10-2020 15:41:30.961496,Peruana · Internacional,La Chifería,24200,6600,30800
14067,14068,21-10-2020 15:41:31.257221,Desayunos,Fratelli - Desayunos,12500,4600,17100
14068,14069,21-10-2020 15:41:31.401443,Postres · Desayunos,BagBog Bagels,27800,6400,34200
14069,14070,21-10-2020 15:41:31.747724,Desayunos · Parrilla,Mi Patria,24300,4600,28900
14070,14071,21-10-2020 15:41:31.941724,Desayunos · Empanadas,Empanadas Doraditas.com,7500,3000,10500
14071,14072,21-10-2020 15:41:32.287189,Pollo,Señor Fantástico,70000,4700,74700
14072,14073,21-10-2020 15:41:32.581561,Panadería,Boul,23000,3100,26100
14073,14074,21-10-2020 15:41:32.976680,Desayunos · Parrilla,Mi Patria,27800,4600,32400
14074,14075,21-10-2020 15:41:33.171002,Pollo · Desayunos,Caserito Gourmet,35000,6700,41700
14075,14076,21-10-2020 15:41:33.316014,Sushi · Asiática,Tu Sushi,18900,6400,25300
14076,14077,21-10-2020 15:41:33.460568,Mexicana,Cantina La 15,37900,4300,42200
14077,14078,21-10-2020 15:41:33.655455,Desayunos · Sánduches,Danilo Colombia,17800,3300,21100
14078,14079,21-10-2020 15:41:33.849290,Desayunos · Sánduches,Garnish,7500,5200,12700
14079,14080,21-10-2020 15:41:34.245204,Alta Cocina · Italiana,Trattoria de la Plaza,39700,6000,45700
14080,14081,21-10-2020 15:41:34.389300,Desayunos · Panadería,Santa Juana Food Bar,65000,5900,70900
14081,14082,21-10-2020 15:41:34.684766,Pollo · Desayunos,Abasto,15000,3600,18600
14082,14083,21-10-2020 15:41:34.979029,Típica · Parrilla,Mi Ranchito Parrilla,15000,4400,19400
14083,14084,21-10-2020 15:41:35.324795,Pizza,18 Scalini,35000,4300,39300
14084,14085,21-10-2020 15:41:35.619632,Parrilla,Rústico Picadería,29500,3800,33300
14085,14086,21-10-2020 15:41:35.965694,Parrilla,Antojo a Domicilio,31800,5000,36800
14086,14087,21-10-2020 15:41:36.360130,Saludable,Amor Propio saludable,34500,4000,38500
14087,14088,21-10-2020 15:41:36.510855,Pollo · Saludable,Gratina,45800,4200,50000
14088,14089,21-10-2020 15:41:36.806744,Helados,Buon Gelato,65000,4400,69400
14089,14090,21-10-2020 15:41:36.951664,China,China Food Col,53900,3600,57500
14090,14091,21-10-2020 15:41:37.246675,Pollo · Saludable,Yerbabuena,24200,3900,28100
14091,14092,21-10-2020 15:41:37.441876,Parrilla,Arepaisa de Medellín,27800,5600,33400
14092,14093,21-10-2020 15:41:37.736121,Saludable · Desayunos,Fresh Co,24200,5600,29800
14093,14094,21-10-2020 15:41:37.881017,Parrilla,Restaurante Bar Mi Ranchito,35000,5200,40200
14094,14095,21-10-2020 15:41:38.275544,Crepes,San Crepes,15600,4900,20500
14095,14096,21-10-2020 15:41:38.670626,Desayunos · Internacional,Camilia,7500,3900,11400
14096,14097,21-10-2020 15:41:38.914504,Hamburguesas · Panadería,NYC Burgers,13600,6200,19800
14097,14098,21-10-2020 15:41:39.310973,Desayunos · Café,El Gualilo,34500,6200,40700
14098,14099,21-10-2020 15:41:39.555140,Pizza,pizza andante,37900,4200,42100
14099,14100,21-10-2020 15:41:39.950642,Mexicana,La leyenda mexican kitchen,53400,3200,56600
14100,14101,21-10-2020 15:41:40.246067,Saludable · Desayunos,Maracuyá,31800,6700,38500
14101,14102,21-10-2020 15:41:40.441711,Desayunos · Panadería,Juliana Restaurante,27800,6100,33900
14102,14103,21-10-2020 15:41:40.636652,Típica · Pescados y Mariscos,Arroces Mrg,15000,4300,19300
14103,14104,21-10-2020 15:41:40.981856,Desayunos · Café,Norma's Ice Cream Café,31800,6300,38100
14104,14105,21-10-2020 15:41:41.225926,Desayunos · Panadería,Juliana Restaurante,18900,6100,25000
14105,14106,21-10-2020 15:41:41.520844,Típica · Parrilla,Parrilla Farandula Gourmet,39700,5100,44800
14106,14107,21-10-2020 15:41:41.864825,Café · Helados,Sofia heladería y café,11870,5800,17670
14107,14108,21-10-2020 15:41:42.059470,Sushi,Umi,15600,5600,21200
14108,14109,21-10-2020 15:41:42.203549,Típica,Sabrosito,11870,4000,15870
14109,14110,21-10-2020 15:41:42.548701,Crepes,San Crepes,39700,4900,44600
14110,14111,21-10-2020 15:41:42.943139,Pollo · Saludable,Yerbabuena,48750,3900,52650
14111,14112,21-10-2020 15:41:43.188421,Desayunos · Panadería,Le Pain Quotidien,7500,3900,11400
14112,14113,21-10-2020 15:41:43.583450,Postres,Beiked,13600,4000,17600
14113,14114,21-10-2020 15:41:43.778463,Desayunos · Típica,Papadió - Colombianas,13000,5700,18700
14114,14115,21-10-2020 15:41:44.022514,Postres · Desayunos,Maria Luisa - Postres,24200,4300,28500
14115,14116,21-10-2020 15:41:44.368279,Postres · Desayunos,Restaurante Cornelia,10700,5500,16200
14116,14117,21-10-2020 15:41:44.512186,Sushi · Desayunos,Maki Roll,65000,4300,69300
14117,14118,21-10-2020 15:41:44.807166,Desayunos,Bagel Shop,45800,3200,49000
14118,14119,21-10-2020 15:41:44.951121,Desayunos,El Fogón Castellano,34500,3200,37700
14119,14120,21-10-2020 15:41:45.095792,Desayunos · Panadería,Ficchi Panadería,12500,3100,15600
14120,14121,21-10-2020 15:41:45.289788,Saludable,Puro Verde,23000,5700,28700
14121,14122,21-10-2020 15:41:45.435466,Pescados y Mariscos,La Gran Cazuela,17800,3200,21000
14122,14123,21-10-2020 15:41:45.579746,Desayunos · Jugos y Batidos,Frutiwow,10700,4100,14800
14123,14124,21-10-2020 15:41:45.825110,Típica,Salsig,10700,5600,16300
14124,14125,21-10-2020 15:41:46.019293,Postres · Desayunos,Amelie Helados,48750,6400,55150
14125,14126,21-10-2020 15:41:46.415186,Desayunos · Café,Matchacha,13000,5900,18900
14126,14127,21-10-2020 15:41:46.659586,Mexicana,Cantina La 15,45800,4300,50100
14127,14128,21-10-2020 15:41:47.054899,Desayunos · Café,Moramia,35000,4700,39700
14128,14129,21-10-2020 15:41:47.349282,Pescados y Mariscos,Pescadero Héroes del Mar,23000,6600,29600
14129,14130,21-10-2020 15:41:47.544435,Desayunos,Butter,12500,6700,19200
14130,14131,21-10-2020 15:41:47.788808,Italiana,F*cking Good Pizza,53400,4200,57600
14131,14132,21-10-2020 15:41:47.933925,Desayunos · Café,Matchacha,24200,5900,30100
14132,14133,21-10-2020 15:41:48.328533,Parrilla,Coquitas,10700,5600,16300
14133,14134,21-10-2020 15:41:48.673642,Desayunos · Típica,Casa Vieja,48750,6000,54750
14134,14135,21-10-2020 15:41:49.068097,Saludable · Parrilla,The Angels Grill and Drinks,7500,6200,13700
14135,14136,21-10-2020 15:41:49.313400,Típica · Parrilla,La Parilla de David,24200,3100,27300
14136,14137,21-10-2020 15:41:49.709322,Postres · Desayunos,Restaurante Cornelia,17800,5500,23300
14137,14138,21-10-2020 15:41:50.104315,Desayunos,Sunny Breakfast Brunch,48750,4300,53050
14138,14139,21-10-2020 15:41:50.249288,Desayunos · Café,Frambas,35000,3400,38400
14139,14140,21-10-2020 15:41:50.494987,Desayunos · Panadería,Juliana Restaurante,13000,6100,19100
14140,14141,21-10-2020 15:41:50.839801,China,China Food Col,18900,3600,22500
14141,14142,21-10-2020 15:41:51.185739,Desayunos · Sánduches,Garnish,13000,5200,18200
14142,14143,21-10-2020 15:41:51.530609,Jugos y Batidos,Pomponio,23000,3600,26600
14143,14144,21-10-2020 15:41:51.726744,Saludable · Desayunos,Agua Dulce,35000,3700,38700
14144,14145,21-10-2020 15:41:52.021694,Desayunos · Café,Norma's Ice Cream Café,29500,6300,35800
14145,14146,21-10-2020 15:41:52.317853,Saludable · Desayunos,Copacabana Açai Bowls,24300,3000,27300
14146,14147,21-10-2020 15:41:52.512476,Internacional,La Esquina con Sabor Parrilla,48750,3000,51750
14147,14148,21-10-2020 15:41:52.758525,Típica,Baondish,13600,5800,19400
14148,14149,21-10-2020 15:41:53.003524,Desayunos · Típica,Calentao Express,17800,6000,23800
14149,14150,21-10-2020 15:41:53.349440,Saludable · Desayunos,Libre de Culpa,39700,4000,43700
14150,14151,21-10-2020 15:41:53.494264,Hamburguesas,Gofi Burger,10700,5100,15800
14151,14152,21-10-2020 15:41:53.840442,Sánduches · Pescados y Mariscos,Pacific Comida de Mar,11870,4000,15870
14152,14153,21-10-2020 15:41:54.185790,Saludable,Ventura Soup y Salad,70000,3800,73800
14153,14154,21-10-2020 15:41:54.581920,Postres · Desayunos,Protein Bakes,9000,5900,14900
14154,14155,21-10-2020 15:41:54.727464,Saludable · Desayunos,Guadalupe - Fruteria,7500,5900,13400
14155,14156,21-10-2020 15:41:54.973476,Desayunos,Bagel Shop,18900,3200,22100
14156,14157,21-10-2020 15:41:55.368298,Pizza,18 Scalini,45800,4300,50100
14157,14158,21-10-2020 15:41:55.714083,Hamburguesas · Saludable,Restaurant Inn,27800,6100,33900
14158,14159,21-10-2020 15:41:56.009022,Parrilla,Arepaisa de Medellín,15600,5600,21200
14159,14160,21-10-2020 15:41:56.154765,Pollo · Desayunos,Workzone,11870,3100,14970
14160,14161,21-10-2020 15:41:56.449464,Parrilla,Antojo a Domicilio,35000,5000,40000
14161,14162,21-10-2020 15:41:56.645813,Parrilla,Rústico Picadería,35000,3800,38800
14162,14163,21-10-2020 15:41:56.890481,Parrilla,Rústico Picadería,13600,3800,17400
14163,14164,21-10-2020 15:41:57.286158,Desayunos · Café,vereda central calle 99,17800,5700,23500
14164,14165,21-10-2020 15:41:57.580687,Desayunos · Empanadas,Mis Delicias,35000,3200,38200
14165,14166,21-10-2020 15:41:57.826115,Pollo · Sánduches,Pollos Century,10700,3000,13700
14166,14167,21-10-2020 15:41:57.970807,Desayunos,El Fogón Castellano,18900,3200,22100
14167,14168,21-10-2020 15:41:58.266754,Desayunos · Árabe,Boniato Sabores Vivos,12500,5300,17800
14168,14169,21-10-2020 15:41:58.661809,Desayunos · Panadería,Le Pain Quotidien,13600,3900,17500
14169,14170,21-10-2020 15:41:58.857572,Postres · Desayunos,KOKOA & co.,53900,4700,58600
14170,14171,21-10-2020 15:41:59.102743,Postres · Helados,Mahé,7500,6000,13500
14171,14172,21-10-2020 15:41:59.449290,Postres · Desayunos,Aury Postres - Comidas & Picadas,53900,4700,58600
14172,14173,21-10-2020 15:41:59.845026,Pollo · China,China Tao,34500,3500,38000
14173,14174,21-10-2020 15:42:00.090778,Pollo · Desayunos,Candelina,70000,5300,75300
14174,14175,21-10-2020 15:42:00.385989,Mexicana,Cantina La 15,37900,4300,42200
14175,14176,21-10-2020 15:42:00.781849,Típica,Cazuelitas 93,15000,3900,18900
14176,14177,21-10-2020 15:42:01.026138,Italiana,F*cking Good Pizza,31800,4200,36000
14177,14178,21-10-2020 15:42:01.422310,Saludable · Desayunos,Agua Dulce,48750,3700,52450
14178,14179,21-10-2020 15:42:01.617106,Desayunos · Jugos y Batidos,Dont Be Hungry,27800,5600,33400
14179,14180,21-10-2020 15:42:01.762827,Postres · Desayunos,Restaurante Cornelia,24300,5500,29800
14180,14181,21-10-2020 15:42:01.907215,Crepes,La Chabatta,31800,5900,37700
14181,14182,21-10-2020 15:42:02.153441,Parrilla,Parrilla Pimentón,9000,3400,12400
14182,14183,21-10-2020 15:42:02.348021,Saludable · Jugos y Batidos,Berdes Drinks & Salads,35000,3500,38500
14183,14184,21-10-2020 15:42:02.494607,Pollo · Desayunos,Caserito Gourmet,23000,6700,29700
14184,14185,21-10-2020 15:42:02.842239,Internacional,Rio Sabores y Experiencias,13600,4100,17700
14185,14186,21-10-2020 15:42:03.087009,Postres · Desayunos,Vivalight Market.,70000,6500,76500
14186,14187,21-10-2020 15:42:03.232738,Postres · Desayunos,Amelie Helados,24300,6400,30700
14187,14188,21-10-2020 15:42:03.428558,Parrilla · Internacional,Taperia de la Plaza,35000,5700,40700
14188,14189,21-10-2020 15:42:03.773751,Típica,Cazuelitas 93,29500,3900,33400
14189,14190,21-10-2020 15:42:03.969871,Desayunos · Café,Norma's Ice Cream Café,70000,6300,76300
14190,14191,21-10-2020 15:42:04.164632,Pollo · Desayunos,Caserito Gourmet,13600,6700,20300
14191,14192,21-10-2020 15:42:04.509161,Mexicana,Mexicanachos,15000,3900,18900
14192,14193,21-10-2020 15:42:04.905461,Desayunos · Café,Moramia,35000,4700,39700
14193,14194,21-10-2020 15:42:05.300680,Peruana,Uma Cantina Peruana,13000,3200,16200
14194,14195,21-10-2020 15:42:05.597882,Parrilla,Carnes la Zarza,15600,4900,20500
14195,14196,21-10-2020 15:42:05.793172,Mexicana,Cantina La 15,53400,4300,57700
14196,14197,21-10-2020 15:42:06.189356,Desayunos,El Corral - Desayunos,34500,5000,39500
14197,14198,21-10-2020 15:42:06.333849,Postres · Desayunos,Restaurante Cornelia,34500,5500,40000
14198,14199,21-10-2020 15:42:06.680577,Pollo · Desayunos,Caserito Gourmet,31800,6700,38500
14199,14200,21-10-2020 15:42:07.026204,Pizza · Italiana,Piatto - Pizza,18900,6600,25500
14200,14201,21-10-2020 15:42:07.372159,Desayunos,Señor Desayuno,65000,6800,71800
14201,14202,21-10-2020 15:42:07.717050,Típica,Lo Nuestro,29500,3100,32600
14202,14203,21-10-2020 15:42:08.014145,Postres,Beiked,70000,4000,74000
14203,14204,21-10-2020 15:42:08.409809,Desayunos · Panadería,El Pan de Phillippe,37900,4600,42500
14204,14205,21-10-2020 15:42:08.606087,Desayunos · Pescados y Mariscos,Gypsy Bistro,34500,4500,39000
14205,14206,21-10-2020 15:42:08.850304,Desayunos · Típica,Peninsula Calentados y Parrilla,27800,3400,31200
14206,14207,21-10-2020 15:42:09.247711,Saludable · Desayunos,Agua Dulce,70000,3700,73700
14207,14208,21-10-2020 15:42:09.443215,Desayunos,Sr Buñuelo,18900,6400,25300
14208,14209,21-10-2020 15:42:09.789575,China,China Food Col,34500,3600,38100
14209,14210,21-10-2020 15:42:10.084512,Desayunos · Típica,La Parrilla Dorada Polo,10700,6600,17300
14210,14211,21-10-2020 15:42:10.381055,Desayunos · Panadería,Pasteleite,29500,5900,35400
14211,14212,21-10-2020 15:42:10.776079,Desayunos · Típica,Calentao Express,23000,6000,29000
14212,14213,21-10-2020 15:42:11.172079,Desayunos · Típica,Cochon,18900,3300,22200
14213,14214,21-10-2020 15:42:11.417065,Desayunos · Típica,Casa Vieja,13600,6000,19600
14214,14215,21-10-2020 15:42:11.614540,Saludable · Desayunos,Distrito Gourmet,29500,3700,33200
14215,14216,21-10-2020 15:42:11.959557,Desayunos · Jugos y Batidos,Dont Be Hungry,23000,5600,28600
14216,14217,21-10-2020 15:42:12.155520,Desayunos · Panadería,Artesanos,53400,4300,57700
14217,14218,21-10-2020 15:42:12.350271,Saludable · Desayunos,Bawana - Sandwich,53400,3400,56800
14218,14219,21-10-2020 15:42:12.747238,Parrilla,Arroces Maria Paula,65000,6800,71800
14219,14220,21-10-2020 15:42:13.142212,Pollo,Heart & Cooking,70000,5000,75000
14220,14221,21-10-2020 15:42:13.288196,Parrilla · Internacional,Taperia de la Plaza,45800,5700,51500
14221,14222,21-10-2020 15:42:13.682798,Desayunos · Típica,Rojo Gourmet,17800,4700,22500
14222,14223,21-10-2020 15:42:13.929587,Saludable · Desayunos,Básico y elemental,12500,5000,17500
14223,14224,21-10-2020 15:42:14.174674,Postres · Desayunos,Maltihelados,65000,6200,71200
14224,14225,21-10-2020 15:42:14.370191,Saludable · Típica,Sopas Mrg,13600,3100,16700
14225,14226,21-10-2020 15:42:14.764817,Típica,La Herencia,31800,5900,37700
14226,14227,21-10-2020 15:42:14.961525,Saludable · Desayunos,Malú,48750,3700,52450
14227,14228,21-10-2020 15:42:15.157179,Postres · Helados,Mahé,8900,6000,14900
14228,14229,21-10-2020 15:42:15.403017,Hamburguesas,Monchis - Hamburguesa,7500,4300,11800
14229,14230,21-10-2020 15:42:15.547780,Postres · Café,Loló Coffee & Snacks,70000,4600,74600
14230,14231,21-10-2020 15:42:15.694958,Desayunos,Sr Buñuelo,31800,6400,38200
14231,14232,21-10-2020 15:42:15.990471,Desayunos · Panadería,Choclofee,12500,4700,17200
14232,14233,21-10-2020 15:42:16.136099,Parrilla · Café,Gaira Café,9000,4400,13400
14233,14234,21-10-2020 15:42:16.281115,Hamburguesas · Alitas,Beer,31800,6600,38400
14234,14235,21-10-2020 15:42:16.628207,Pollo · Saludable,Yerbabuena,24200,3900,28100
14235,14236,21-10-2020 15:42:16.772855,Saludable · Típica,Sopas Mrg,8900,3100,12000
14236,14237,21-10-2020 15:42:16.918981,Pollo · Saludable,Tremenda Sal y Dulce,34500,6500,41000
14237,14238,21-10-2020 15:42:17.263846,Café · Helados,Sofia heladería y café,53900,5800,59700
14238,14239,21-10-2020 15:42:17.560778,Típica,Bendita S,31800,4600,36400
14239,14240,21-10-2020 15:42:17.805797,Parrilla,Parrilla Pimentón,39700,3400,43100
14240,14241,21-10-2020 15:42:18.201465,Saludable · Parrilla,The Angels Grill and Drinks,29500,6200,35700
14241,14242,21-10-2020 15:42:18.546201,Saludable,Ventura Soup y Salad,9000,3800,12800
14242,14243,21-10-2020 15:42:18.943263,Típica,La Olla de Barro,35000,5300,40300
14243,14244,21-10-2020 15:42:19.338530,Saludable · Desayunos,Básico y Elemental,11870,5900,17770
14244,14245,21-10-2020 15:42:19.684828,Parrilla,Antojo a Domicilio,15000,5000,20000
14245,14246,21-10-2020 15:42:19.979597,Típica,Cazuelitas 93,34500,3900,38400
14246,14247,21-10-2020 15:42:20.228273,Asiática,TeT,45800,5900,51700
14247,14248,21-10-2020 15:42:20.624506,Italiana,Bocatto Di Passo,15600,5000,20600
14248,14249,21-10-2020 15:42:20.821239,Postres · Desayunos,Cosmo Cookies,35000,5900,40900
14249,14250,21-10-2020 15:42:20.966870,Desayunos · Típica,Calentao Express,53900,6000,59900
14250,14251,21-10-2020 15:42:21.114893,Típica,La Cocina,37900,4600,42500
14251,14252,21-10-2020 15:42:21.461401,Desayunos · Parrilla,Mi Patria,24200,4600,28800
14252,14253,21-10-2020 15:42:21.757950,Postres · Desayunos,Aury Postres - Comidas & Picadas,13000,4700,17700
14253,14254,21-10-2020 15:42:22.152825,Saludable,Hanai - Bowls Saludables,35000,5900,40900
14254,14255,21-10-2020 15:42:22.450117,Sánduches · Pescados y Mariscos,Pacific Comida de Mar,48750,4000,52750
14255,14256,21-10-2020 15:42:22.645656,Desayunos · Panadería,Choclofee,13000,4700,17700
14256,14257,21-10-2020 15:42:22.791598,Saludable · Desayunos,Básico y elemental,65000,5000,70000
14257,14258,21-10-2020 15:42:23.186602,Poke,Poke Go,34500,4600,39100
14258,14259,21-10-2020 15:42:23.333347,Típica,Bendita S,29500,4600,34100
14259,14260,21-10-2020 15:42:23.678749,Saludable · Desayunos,Guadalupe - Fruteria,17800,5900,23700
14260,14261,21-10-2020 15:42:24.024978,Desayunos · Panadería,Santa Juana Food Bar,31800,5900,37700
14261,14262,21-10-2020 15:42:24.319542,Postres · Café,Loló Coffee & Snacks,7500,4600,12100
14262,14263,21-10-2020 15:42:24.666723,Postres · Desayunos,Maltihelados,23000,6200,29200
14263,14264,21-10-2020 15:42:24.962288,Postres · Desayunos,Maltihelados,31800,6200,38000
14264,14265,21-10-2020 15:42:25.108548,Típica,La Cocina,7500,4600,12100
14265,14266,21-10-2020 15:42:25.304270,Asiática,TeT,7500,5900,13400
14266,14267,21-10-2020 15:42:25.551476,Desayunos · Panadería,Premium Break Bakery,8900,3700,12600
14267,14268,21-10-2020 15:42:25.696673,Parrilla · Café,Figaro Café/ Restaurante Argentino,27800,5800,33600
14268,14269,21-10-2020 15:42:25.892557,Postres · Desayunos,Maria Luisa - Postres,29500,4300,33800
14269,14270,21-10-2020 15:42:26.187361,Típica,Baondish,70000,5800,75800
14270,14271,21-10-2020 15:42:26.484742,Típica,Sopitas y Más,27800,4200,32000
14271,14272,21-10-2020 15:42:26.679740,Saludable · Típica,Sopas Mrg,39700,3100,42800
14272,14273,21-10-2020 15:42:27.025976,Desayunos,El Fogón Castellano,8900,3200,12100
14273,14274,21-10-2020 15:42:27.421815,Postres,Levelma,10700,6200,16900
14274,14275,21-10-2020 15:42:27.769202,Desayunos · Café,Frambas,45800,3400,49200
14275,14276,21-10-2020 15:42:27.913917,Saludable · Desayunos,Bawana - Sandwich,24300,3400,27700
14276,14277,21-10-2020 15:42:28.210646,Desayunos,Butter,7500,6700,14200
14277,14278,21-10-2020 15:42:28.455772,Típica · Pescados y Mariscos,La Vitualla,53900,6300,60200
14278,14279,21-10-2020 15:42:28.753117,Desayunos · Sánduches,Danilo Colombia,8900,3300,12200
14279,14280,21-10-2020 15:42:28.998214,Parrilla,Campocina,8900,4600,13500
14280,14281,21-10-2020 15:42:29.394824,Típica · Parrilla,Toya,35000,4200,39200
14281,14282,21-10-2020 15:42:29.789738,Crepes,La Chabatta,39700,5900,45600
14282,14283,21-10-2020 15:42:30.036804,Sushi,Kim Pop,13000,5400,18400
14283,14284,21-10-2020 15:42:30.383893,Típica,Sopitas y Más,35000,4200,39200
14284,14285,21-10-2020 15:42:30.630527,Desayunos · Café,Matchacha,10700,5900,16600
14285,14286,21-10-2020 15:42:30.875580,Sushi,Kim Pop,31800,5400,37200
14286,14287,21-10-2020 15:42:31.023333,Desayunos · Árabe,Boniato Sabores Vivos,70000,5300,75300
14287,14288,21-10-2020 15:42:31.369453,Típica,Baondish,48750,5800,54550
14288,14289,21-10-2020 15:42:31.715887,Postres,La Galeta,35000,3000,38000
14289,14290,21-10-2020 15:42:32.110855,Desayunos · Típica,Criollomania,15000,5200,20200
14290,14291,21-10-2020 15:42:32.307963,Desayunos · Helados,San Giorgio Gelateria,7500,3100,10600
14291,14292,21-10-2020 15:42:32.653738,Desayunos · Panadería,Artesanos,10700,4300,15000
14292,14293,21-10-2020 15:42:32.899594,Saludable · Desayunos,Bawana - Sandwich,18900,3400,22300
14293,14294,21-10-2020 15:42:33.194631,Desayunos · Típica,La Parrilla Dorada Polo,9000,6600,15600
14294,14295,21-10-2020 15:42:33.542311,Pizza,Pizza Andante,12500,6300,18800
14295,14296,21-10-2020 15:42:33.887848,Desayunos,El Corral - Desayunos,45800,5000,50800
14296,14297,21-10-2020 15:42:34.134145,Saludable · Desayunos,Copacabana Açai Bowls,48750,3000,51750
14297,14298,21-10-2020 15:42:34.328676,Sushi,Kim Pop,27800,5400,33200
14298,14299,21-10-2020 15:42:34.625868,Postres · Desayunos,Restaurante Cornelia,11870,5500,17370
14299,14300,21-10-2020 15:42:34.971788,Desayunos · Mexicana,La Mera Mera - Mexicana,13600,3100,16700
14300,14301,21-10-2020 15:42:35.318374,Desayunos · Panadería,Pasteleite,8900,5900,14800
14301,14302,21-10-2020 15:42:35.564754,Parrilla,Carnes la Zarza,37900,4900,42800
14302,14303,21-10-2020 15:42:35.963157,Helados,Orso To Go,23000,6800,29800
14303,14304,21-10-2020 15:42:36.158784,Desayunos,El Fogón Castellano,17800,3200,21000
14304,14305,21-10-2020 15:42:36.455970,Parrilla,Restaurante Bar Mi Ranchito,24200,5200,29400
14305,14306,21-10-2020 15:42:36.750891,Desayunos · Típica,Papadió - Colombianas,70000,5700,75700
14306,14307,21-10-2020 15:42:36.897434,Pizza,pizza andante,9000,4200,13200
14307,14308,21-10-2020 15:42:37.042544,Desayunos,El Fogón Castellano,45800,3200,49000
14308,14309,21-10-2020 15:42:37.389328,Hamburguesas · Panadería,NYC Burgers,35000,6200,41200
14309,14310,21-10-2020 15:42:37.734587,Desayunos · Panadería,Premium Break Bakery,9000,3700,12700
14310,14311,21-10-2020 15:42:37.981996,Perros Calientes,Dog Shop - Rapida,70000,4900,74900
14311,14312,21-10-2020 15:42:38.377476,Desayunos · Típica,D'Porco - Lechona,27800,6300,34100
14312,14313,21-10-2020 15:42:38.773571,Saludable · Desayunos,Raices Bienestar Gourmet,53400,6600,60000
14313,14314,21-10-2020 15:42:39.168360,Típica,Bendita S,7500,4600,12100
14314,14315,21-10-2020 15:42:39.315605,Pescados y Mariscos,Pescadero Héroes del Mar,45800,6600,52400
14315,14316,21-10-2020 15:42:39.460610,Saludable,A2manos,23000,4200,27200
14316,14317,21-10-2020 15:42:39.806739,Postres,Levelma,9000,6200,15200
14317,14318,21-10-2020 15:42:40.001614,Postres,Toledo Pastelería,45800,6800,52600
14318,14319,21-10-2020 15:42:40.148920,Desayunos,La Frijolada Desayunos,53400,4400,57800
14319,14320,21-10-2020 15:42:40.494537,Saludable · Desayunos,Bawana - Sandwich,23000,3400,26400
14320,14321,21-10-2020 15:42:40.891692,Panadería,Boul,53900,3100,57000
14321,14322,21-10-2020 15:42:41.286542,Mexicana,La leyenda mexican kitchen,13000,3200,16200
14322,14323,21-10-2020 15:42:41.583547,Desayunos · Típica,Criollomania,10700,5200,15900
14323,14324,21-10-2020 15:42:41.778688,Desayunos · Típica,Desayunadero de la 42,39700,5900,45600
14324,14325,21-10-2020 15:42:41.974701,Saludable · Desayunos,Malú,29500,3700,33200
14325,14326,21-10-2020 15:42:42.269869,Pizza · Italiana,Pisapore - Pizza,31800,6600,38400
14326,14327,21-10-2020 15:42:42.667164,Desayunos,Don Leo,53900,6000,59900
14327,14328,21-10-2020 15:42:42.962482,Peruana,Uma Cantina Peruana,18900,3200,22100
14328,14329,21-10-2020 15:42:43.259415,Alta Cocina · Postres,La Pinta,34500,4500,39000
14329,14330,21-10-2020 15:42:43.504147,Saludable · Desayunos,Fresh Co,24300,5600,29900
14330,14331,21-10-2020 15:42:43.801399,Hamburguesas,Gofi Burger,8900,5100,14000
14331,14332,21-10-2020 15:42:44.047603,Postres · Panadería,RIGHT AWAY FOODS,34500,6600,41100
14332,14333,21-10-2020 15:42:44.344148,Pollo · Desayunos,Piaf,34500,6500,41000
14333,14334,21-10-2020 15:42:44.538675,Sushi,Canoa To Go,7500,5900,13400
14334,14335,21-10-2020 15:42:44.735624,Hamburguesas · Panadería,NYC Burgers,34500,6200,40700
14335,14336,21-10-2020 15:42:44.880604,Desayunos · Jugos y Batidos,Dont Be Hungry,23000,5600,28600
14336,14337,21-10-2020 15:42:45.126637,Típica,La Herencia,7500,5900,13400
14337,14338,21-10-2020 15:42:45.471913,Desayunos,Fratelli - Desayunos,53900,4600,58500
14338,14339,21-10-2020 15:42:45.669481,Típica,Sopitas y Más,10700,4200,14900
14339,14340,21-10-2020 15:42:45.916246,Pescados y Mariscos,La Gran Cazuela,48750,3200,51950
14340,14341,21-10-2020 15:42:46.062569,Postres · Café,Celestino Café,31800,5900,37700
14341,14342,21-10-2020 15:42:46.207581,Desayunos,Bagel Shop,11870,3200,15070
14342,14343,21-10-2020 15:42:46.504950,Desayunos · Parrilla,Mi Patria,10700,4600,15300
14343,14344,21-10-2020 15:42:46.900575,Desayunos · Típica,Alce,13600,4900,18500
14344,14345,21-10-2020 15:42:47.096619,Sushi · Asiática,Arigato,34500,5300,39800
14345,14346,21-10-2020 15:42:47.291501,Postres · Desayunos,Protein Bakes,15000,5900,20900
14346,14347,21-10-2020 15:42:47.638930,Comida Rápida · Perros Calientes,Similoa - Comida Rapida,53400,3700,57100
14347,14348,21-10-2020 15:42:47.984592,Típica,La Olla de Barro,11870,5300,17170
14348,14349,21-10-2020 15:42:48.181056,Desayunos · Pescados y Mariscos,Gypsy Bistro,12500,4500,17000
14349,14350,21-10-2020 15:42:48.526183,Desayunos,Sr Buñuelo,12500,6400,18900
14350,14351,21-10-2020 15:42:48.773904,Saludable,Puro Verde,24200,5700,29900
14351,14352,21-10-2020 15:42:49.119782,Pollo,Señor Fantástico,7500,4700,12200
14352,14353,21-10-2020 15:42:49.266228,Postres · Desayunos,Aury Postres - Comidas & Picadas,29500,4700,34200
14353,14354,21-10-2020 15:42:49.661492,Desayunos · Sánduches,Garnish,17800,5200,23000
14354,14355,21-10-2020 15:42:49.808795,Desayunos · Café,Libertario Coffee Roasters,48750,4600,53350
14355,14356,21-10-2020 15:42:50.004007,Pollo · Sánduches,Pollos Century,9000,3000,12000
14356,14357,21-10-2020 15:42:50.300635,Saludable · Típica,Saludable Mrg,11870,5800,17670
14357,14358,21-10-2020 15:42:50.645987,Desayunos · Típica,Peninsula Calentados y Parrilla,24200,3400,27600
14358,14359,21-10-2020 15:42:51.043235,Desayunos · Típica,Desayunadero de la 42,53400,5900,59300
14359,14360,21-10-2020 15:42:51.338797,Pollo · Desayunos,Caserito Gourmet,45800,6700,52500
14360,14361,21-10-2020 15:42:51.535336,Saludable · Desayunos,Básico y Elemental,15600,5900,21500
14361,14362,21-10-2020 15:42:51.730866,Desayunos · Italiana,Rceta By Rausch,29500,3600,33100
14362,14363,21-10-2020 15:42:52.028152,Desayunos · Jugos y Batidos,Dont Be Hungry,70000,5600,75600
14363,14364,21-10-2020 15:42:52.223702,Desayunos · Café,El Gualilo,65000,6200,71200
14364,14365,21-10-2020 15:42:52.620426,Hamburguesas,Monchis - Hamburguesa,15600,4300,19900
14365,14366,21-10-2020 15:42:52.865293,Pollo · Saludable,Yerbabuena,45800,3900,49700
14366,14367,21-10-2020 15:42:53.112290,Pollo,Oliva Va,23000,5600,28600
14367,14368,21-10-2020 15:42:53.308063,Pollo · Saludable,Tremenda Sal y Dulce,13600,6500,20100
14368,14369,21-10-2020 15:42:53.604521,Desayunos · Jugos y Batidos,Kuriwaji,23000,6300,29300
14369,14370,21-10-2020 15:42:53.799275,Típica,Juan Chorizo,24200,3900,28100
14370,14371,21-10-2020 15:42:54.046255,Peruana · Internacional,La Chifería,34500,6600,41100
14371,14372,21-10-2020 15:42:54.191590,Comida Rápida · Perros Calientes,Similoa - Comida Rapida,39700,3700,43400
14372,14373,21-10-2020 15:42:54.337983,Desayunos · Panadería,El Pan de Phillippe,34500,4600,39100
14373,14374,21-10-2020 15:42:54.733274,Postres · Desayunos,Café Quindio,8900,5700,14600
14374,14375,21-10-2020 15:42:54.980615,Postres · Saludable,Ana Rebana,53900,6300,60200
14375,14376,21-10-2020 15:42:55.226227,Desayunos,Butter,10700,6700,17400
14376,14377,21-10-2020 15:42:55.523380,Postres · Desayunos,Aury Postres - Comidas & Picadas,53400,4700,58100
14377,14378,21-10-2020 15:42:55.769627,Helados,Orso To Go,9000,6800,15800
14378,14379,21-10-2020 15:42:55.917553,Típica · Parrilla,Mi Ranchito Parrilla,48750,4400,53150
14379,14380,21-10-2020 15:42:56.314003,Alta Cocina · Parrilla,Criterión,12500,6000,18500
14380,14381,21-10-2020 15:42:56.711289,Típica · Pescados y Mariscos,Arroces Mrg,70000,4300,74300
14381,14382,21-10-2020 15:42:56.856429,Desayunos · Café,Matchacha,8900,5900,14800
14382,14383,21-10-2020 15:42:57.004390,Peruana · Internacional,La Chifería,65000,6600,71600
14383,14384,21-10-2020 15:42:57.199848,Desayunos · Jugos y Batidos,Dont Be Hungry,23000,5600,28600
14384,14385,21-10-2020 15:42:57.397008,Saludable,Ventura Soup y Salad,45800,3800,49600
14385,14386,21-10-2020 15:42:57.792238,Desayunos · Comida Rápida,Chocolatto,24200,3400,27600
14386,14387,21-10-2020 15:42:58.140462,Desayunos · Panadería,Siena Café,17800,3700,21500
14387,14388,21-10-2020 15:42:58.286004,Desayunos · Café,El Gualilo,24300,6200,30500
14388,14389,21-10-2020 15:42:58.434130,Parrilla,Campocina,53400,4600,58000
14389,14390,21-10-2020 15:42:58.679837,Desayunos · Panadería,Artesanos,12500,4300,16800
14390,14391,21-10-2020 15:42:58.927855,Desayunos · Comida Rápida,Chocolatto,53900,3400,57300
14391,14392,21-10-2020 15:42:59.123632,Desayunos · Empanadas,Empanadas Doraditas.com,17800,3000,20800
14392,14393,21-10-2020 15:42:59.270849,Mexicana,Hidalgo Taquería,23000,4900,27900
14393,14394,21-10-2020 15:42:59.466281,Típica · Parrilla,La Parilla de David,53400,3100,56500
14394,14395,21-10-2020 15:42:59.613842,Típica,Baondish,35000,5800,40800
14395,14396,21-10-2020 15:42:59.809589,Postres · Desayunos,Maltihelado,7500,4500,12000
14396,14397,21-10-2020 15:43:00.005922,Alta Cocina · Italiana,Trattoria de la Plaza,70000,6000,76000
14397,14398,21-10-2020 15:43:00.200914,Desayunos · Sánduches,Frutos del Bosque,24200,3500,27700
14398,14399,21-10-2020 15:43:00.398803,Desayunos · Parrilla,Mi Patria,15000,4600,19600
14399,14400,21-10-2020 15:43:00.744654,Desayunos,Señor Desayuno,70000,6800,76800
14400,14401,21-10-2020 15:43:00.991232,Hamburguesas · Alitas,Beer,31800,6600,38400
14401,14402,21-10-2020 15:43:01.337943,Desayunos · Parrilla,Mi Patria,7500,4600,12100
14402,14403,21-10-2020 15:43:01.735811,Típica · Parrilla,El Santandereano,27800,5200,33000
14403,14404,21-10-2020 15:43:01.881524,Desayunos · Típica,Alce,11870,4900,16770
14404,14405,21-10-2020 15:43:02.278261,Desayunos · Árabe,Boniato Sabores Vivos,17800,5300,23100
14405,14406,21-10-2020 15:43:02.573604,Desayunos · Café,vereda central calle 99,31800,5700,37500
14406,14407,21-10-2020 15:43:02.971271,Saludable · Desayunos,Distrito Gourmet,29500,3700,33200
14407,14408,21-10-2020 15:43:03.267334,Pollo · Pescados y Mariscos,Bang Bang Rice,53900,3400,57300
14408,14409,21-10-2020 15:43:03.464038,Pollo · Desayunos,Abasto,65000,3600,68600
14409,14410,21-10-2020 15:43:03.659135,Típica,La Herencia,29500,5900,35400
14410,14411,21-10-2020 15:43:03.856199,Saludable,Ventura Soup y Salad,65000,3800,68800
14411,14412,21-10-2020 15:43:04.151821,Postres · Desayunos,KOKOA & co.,10700,4700,15400
14412,14413,21-10-2020 15:43:04.498396,Parrilla,Campocina,35000,4600,39600
14413,14414,21-10-2020 15:43:04.743839,Pizza,18 Scalini,23000,4300,27300
14414,14415,21-10-2020 15:43:04.891460,Desayunos,Desayunos en Bogotá,45800,3400,49200
14415,14416,21-10-2020 15:43:05.287511,Pizza · Parrilla,Urban Lunch,31800,4000,35800
14416,14417,21-10-2020 15:43:05.533820,Saludable,Hanai - Bowls Saludables,24300,5900,30200
14417,14418,21-10-2020 15:43:05.828925,Pollo · Saludable,Tremenda Sal y Dulce,12500,6500,19000
14418,14419,21-10-2020 15:43:06.026258,Desayunos · Panadería,Santa Juana Food Bar,53400,5900,59300
14419,14420,21-10-2020 15:43:06.271827,Desayunos,Bagel Shop,9000,3200,12200
14420,14421,21-10-2020 15:43:06.419891,Desayunos · Panadería,Decofruta,45800,4700,50500
14421,14422,21-10-2020 15:43:06.715110,Desayunos,Archies Desayunos,45800,3100,48900
14422,14423,21-10-2020 15:43:06.962512,Sushi · Asiática,Arigato,70000,5300,75300
14423,14424,21-10-2020 15:43:07.258611,Típica · Parrilla,La Parilla de David,48750,3100,51850
14424,14425,21-10-2020 15:43:07.455548,Postres · Desayunos,Gelateria Da Favola,65000,6500,71500
14425,14426,21-10-2020 15:43:07.700606,Desayunos · Pescados y Mariscos,Gypsy Bistro,27800,4500,32300
14426,14427,21-10-2020 15:43:07.948654,China,China Food Col,13600,3600,17200
14427,14428,21-10-2020 15:43:08.245219,Desayunos · Café,Frambas,48750,3400,52150
14428,14429,21-10-2020 15:43:08.541745,Desayunos · Típica,Casa Vieja,39700,6000,45700
14429,14430,21-10-2020 15:43:08.736906,Italiana,Bocatto Di Passo,17800,5000,22800
14430,14431,21-10-2020 15:43:08.984662,Postres · Desayunos,Vivalight Market.,13600,6500,20100
14431,14432,21-10-2020 15:43:09.330950,Alta Cocina · Italiana,Trattoria de la Plaza,9000,6000,15000
14432,14433,21-10-2020 15:43:09.627487,Postres · Café,Celestino Café,53400,5900,59300
14433,14434,21-10-2020 15:43:09.922614,Parrilla,Rústico Picadería,11870,3800,15670
14434,14435,21-10-2020 15:43:10.170101,Parrilla,Arroces Maria Paula,37900,6800,44700
14435,14436,21-10-2020 15:43:10.365860,Pollo · Saludable,Tremenda Sal y Dulce,24300,6500,30800
14436,14437,21-10-2020 15:43:10.712506,Desayunos · Jugos y Batidos,Frutiwow,13600,4100,17700
14437,14438,21-10-2020 15:43:11.107925,Hamburguesas · Alitas,Beer,39700,6600,46300
14438,14439,21-10-2020 15:43:11.305697,Hamburguesas · Panadería,NYC Burgers,29500,6200,35700
14439,14440,21-10-2020 15:43:11.502339,Desayunos,Cafetería el Kippe,10700,3200,13900
14440,14441,21-10-2020 15:43:11.699398,Desayunos,Fratelli - Desayunos,12500,4600,17100
14441,14442,21-10-2020 15:43:12.094942,Sushi,Sushi Reel,10700,4700,15400
14442,14443,21-10-2020 15:43:12.492926,Asiática,Thai Station,13000,6000,19000
14443,14444,21-10-2020 15:43:12.688459,Postres · Desayunos,KOKOA & co.,53900,4700,58600
14444,14445,21-10-2020 15:43:12.934838,Típica,El Mondongo y Mucho Mas,53900,5600,59500
14445,14446,21-10-2020 15:43:13.180058,Postres · Desayunos,La Folie - Postres,39700,3300,43000
14446,14447,21-10-2020 15:43:13.428006,Desayunos · Panadería,Pasteleite,9000,5900,14900
14447,14448,21-10-2020 15:43:13.573898,Saludable · Jugos y Batidos,Berdes Drinks & Salads,11870,3500,15370
14448,14449,21-10-2020 15:43:13.971303,Desayunos · Panadería,El Pan de Phillippe,53900,4600,58500
14449,14450,21-10-2020 15:43:14.166906,Hamburguesas,Bendito Cordero,12500,5800,18300
14450,14451,21-10-2020 15:43:14.565093,Típica,Lo Nuestro,9000,3100,12100
14451,14452,21-10-2020 15:43:14.761044,Postres · Desayunos,Cosmo Cookies,70000,5900,75900
14452,14453,21-10-2020 15:43:15.057756,Desayunos · Panadería,Pasteleite,29500,5900,35400
14453,14454,21-10-2020 15:43:15.353321,Postres · Desayunos,Buñuelos nacho,10700,6600,17300
14454,14455,21-10-2020 15:43:15.550513,Parrilla,Carnes la Zarza,27800,4900,32700
14455,14456,21-10-2020 15:43:15.746103,Postres,La Tertulia,9000,3400,12400
14456,14457,21-10-2020 15:43:16.092595,Saludable,The Good Rice Bowls,31800,3500,35300
14457,14458,21-10-2020 15:43:16.437689,Postres · Desayunos,Maltihelado,9000,4500,13500
14458,14459,21-10-2020 15:43:16.736502,Parrilla,El Tambor,70000,6800,76800
14459,14460,21-10-2020 15:43:16.983852,Típica,Baondish,53400,5800,59200
14460,14461,21-10-2020 15:43:17.180397,Mexicana,Hidalgo Taquería,10700,4900,15600
14461,14462,21-10-2020 15:43:17.426699,Jugos y Batidos,Pomponio,24300,3600,27900
14462,14463,21-10-2020 15:43:17.571565,Desayunos · Típica,Alce,9000,4900,13900
14463,14464,21-10-2020 15:43:17.919557,Postres · Helados,Mahé,10700,6000,16700
14464,14465,21-10-2020 15:43:18.216348,Pollo,Heart & Cooking,27800,5000,32800
14465,14466,21-10-2020 15:43:18.513906,Helados,Orso To Go,70000,6800,76800
14466,14467,21-10-2020 15:43:18.810570,Típica,Sabores De Mi Tierra,18900,5400,24300
14467,14468,21-10-2020 15:43:19.158109,Desayunos · Pescados y Mariscos,Luzí­a - Mediterranea,17800,5700,23500
14468,14469,21-10-2020 15:43:19.454817,Parrilla,Arroces Maria Paula,53400,6800,60200
14469,14470,21-10-2020 15:43:19.602589,Postres · Desayunos,Maltihelados,11870,6200,18070
14470,14471,21-10-2020 15:43:19.898701,Sushi · Asiática,Arigato,7500,5300,12800
14471,14472,21-10-2020 15:43:20.146304,Pizza · Italiana,Pisapore - Pizza,29500,6600,36100
14472,14473,21-10-2020 15:43:20.542867,Típica,Salsig,17800,5600,23400
14473,14474,21-10-2020 15:43:20.840239,Pollo · Pescados y Mariscos,Bang Bang Rice,15600,3400,19000
14474,14475,21-10-2020 15:43:21.136531,Pollo,Señor Fantástico,11870,4700,16570
14475,14476,21-10-2020 15:43:21.284525,Postres · Desayunos,Restaurante Cornelia,24300,5500,29800
14476,14477,21-10-2020 15:43:21.480929,Desayunos · Pescados y Mariscos,Luzí­a - Mediterranea,10700,5700,16400
14477,14478,21-10-2020 15:43:21.879760,Desayunos · Sánduches,Frutos del Bosque,23000,3500,26500
14478,14479,21-10-2020 15:43:22.176971,Pollo · Desayunos,Piaf,15600,6500,22100
14479,14480,21-10-2020 15:43:22.425817,Desayunos · Típica,Parrilla Farandula Típico,31800,5900,37700
14480,14481,21-10-2020 15:43:22.822405,Pizza,18 Scalini,23000,4300,27300
14481,14482,21-10-2020 15:43:23.220559,Saludable · Típica,Sopas Mrg,31800,3100,34900
14482,14483,21-10-2020 15:43:23.417670,Desayunos,Sunny Breakfast Brunch,34500,4300,38800
14483,14484,21-10-2020 15:43:23.665549,Hamburguesas,Monchis - Hamburguesa,12500,4300,16800
14484,14485,21-10-2020 15:43:24.062863,Típica · Parrilla,Toya,70000,4200,74200
14485,14486,21-10-2020 15:43:24.360512,Pizza,18 Scalini,27800,4300,32100
14486,14487,21-10-2020 15:43:24.757505,Parrilla,Coquitas,23000,5600,28600
14487,14488,21-10-2020 15:43:25.055136,Desayunos · Panadería,Siena Café,10700,3700,14400
14488,14489,21-10-2020 15:43:25.251437,Café · Helados,Sofia heladería y café,15600,5800,21400
14489,14490,21-10-2020 15:43:25.548711,Postres · Desayunos,BagBog Bagels,65000,6400,71400
14490,14491,21-10-2020 15:43:25.694889,Café · Helados,Sofia heladería y café,27800,5800,33600
14491,14492,21-10-2020 15:43:25.992799,Sushi,Umi,65000,5600,70600
14492,14493,21-10-2020 15:43:26.389522,Típica · Parrilla,Typykos,24300,6000,30300
14493,14494,21-10-2020 15:43:26.637229,Sushi,Umi,7500,5600,13100
14494,14495,21-10-2020 15:43:26.934493,Alta Cocina · Postres,La Pinta,8900,4500,13400
14495,14496,21-10-2020 15:43:27.081786,Postres · Saludable,Ana Rebana,15000,6300,21300
14496,14497,21-10-2020 15:43:27.478396,Desayunos,Jacinta Arepas de Huevo,65000,4000,69000
14497,14498,21-10-2020 15:43:27.675946,Postres · Desayunos,Maltihelado,29500,4500,34000
14498,14499,21-10-2020 15:43:27.922315,Desayunos · Típica,Fogón Sangileño,31800,5000,36800
14499,14500,21-10-2020 15:43:28.320216,Sushi,Umi,53400,5600,59000
14500,14501,21-10-2020 15:43:28.617634,Desayunos · Panadería,Santa Juana Food Bar,65000,5900,70900
14501,14502,21-10-2020 15:43:28.965779,Saludable · Desayunos,Maracuyá,45800,6700,52500
14502,14503,21-10-2020 15:43:29.312459,Hamburguesas,Gofi Burger,53400,5100,58500
14503,14504,21-10-2020 15:43:29.710261,Desayunos,Cafetería el Kippe,24200,3200,27400
14504,14505,21-10-2020 15:43:30.006612,Postres,Levelma,23000,6200,29200
14505,14506,21-10-2020 15:43:30.154656,Postres,La Tertulia,11870,3400,15270
14506,14507,21-10-2020 15:43:30.301572,Parrilla,El Tambor,29500,6800,36300
14507,14508,21-10-2020 15:43:30.499108,Típica · Parrilla,Parrilla Farandula Gourmet,8900,5100,14000
14508,14509,21-10-2020 15:43:30.795682,Saludable · Parrilla,The Angels Grill and Drinks,24200,6200,30400
14509,14510,21-10-2020 15:43:30.943446,Desayunos · Típica,Alce,35000,4900,39900
14510,14511,21-10-2020 15:43:31.139822,Desayunos · Panadería,Siena Café,37900,3700,41600
14511,14512,21-10-2020 15:43:31.487682,Postres,La Galeta,13000,3000,16000
14512,14513,21-10-2020 15:43:31.734445,Pescados y Mariscos,Fish Place - Del Mar,27800,5400,33200
14513,14514,21-10-2020 15:43:31.881753,Desayunos · Típica,Parrilla Farandula Típico,8900,5900,14800
14514,14515,21-10-2020 15:43:32.079161,Desayunos · Café,vereda central calle 99,53400,5700,59100
14515,14516,21-10-2020 15:43:32.477243,Pizza,Pizza Andante,27800,6300,34100
14516,14517,21-10-2020 15:43:32.774053,Postres · Desayunos,Sweet Tale,15000,5800,20800
14517,14518,21-10-2020 15:43:33.021625,Desayunos · Panadería,Le Pain Quotidien,31800,3900,35700
14518,14519,21-10-2020 15:43:33.167907,Postres,Levelma,7500,6200,13700
14519,14520,21-10-2020 15:43:33.565956,Desayunos · Helados,San Giorgio Gelateria,24200,3100,27300
14520,14521,21-10-2020 15:43:33.862388,Pollo,Heart & Cooking,8900,5000,13900
14521,14522,21-10-2020 15:43:34.210309,Pollo · Pescados y Mariscos,Bang Bang Rice,70000,3400,73400
14522,14523,21-10-2020 15:43:34.407057,Desayunos · Panadería,El Pan de Phillippe,15600,4600,20200
14523,14524,21-10-2020 15:43:34.604724,Saludable · Desayunos,Bawana - Sandwich,48750,3400,52150
14524,14525,21-10-2020 15:43:34.901458,Desayunos · Panadería,Artesanos,45800,4300,50100
14525,14526,21-10-2020 15:43:35.299255,Hamburguesas · Desayunos,El Inglés Gastro Pub,35000,6600,41600
14526,14527,21-10-2020 15:43:35.645926,Desayunos · Típica,Desayunadero de la 42,53400,5900,59300
14527,14528,21-10-2020 15:43:35.993474,Típica,Carbón & Mondongos,7500,6400,13900
14528,14529,21-10-2020 15:43:36.390264,Típica,Sabrosito,23000,4000,27000
14529,14530,21-10-2020 15:43:36.687802,Postres · Café,Loló Coffee & Snacks,7500,4600,12100
14530,14531,21-10-2020 15:43:36.985216,Desayunos · Helados,San Giorgio Gelateria,13600,3100,16700
14531,14532,21-10-2020 15:43:37.334169,Helados,Buon Gelato,31800,4400,36200
14532,14533,21-10-2020 15:43:37.480992,Típica,El Mondongo y Mucho Mas,24200,5600,29800
14533,14534,21-10-2020 15:43:37.678532,Saludable,Puro Verde,53400,5700,59100
14534,14535,21-10-2020 15:43:37.824805,Postres · Desayunos,BagBog Bagels,34500,6400,40900
14535,14536,21-10-2020 15:43:38.222725,Típica,Sopitas y Más,53400,4200,57600
14536,14537,21-10-2020 15:43:38.470295,Pizza · Parrilla,Urban Lunch,48750,4000,52750
14537,14538,21-10-2020 15:43:38.768381,Alta Cocina · Parrilla,Criterión,24300,6000,30300
14538,14539,21-10-2020 15:43:38.964872,Desayunos,Fratelli - Desayunos,39700,4600,44300
14539,14540,21-10-2020 15:43:39.162613,Saludable,Hanai - Bowls Saludables,53400,5900,59300
14540,14541,21-10-2020 15:43:39.559811,Sushi,Sushi Reel,34500,4700,39200
14541,14542,21-10-2020 15:43:39.907570,Pollo,Señor Fantástico,11870,4700,16570
14542,14543,21-10-2020 15:43:40.204502,Desayunos · Típica,Cochon,31800,3300,35100
14543,14544,21-10-2020 15:43:40.403059,Desayunos,Butter,11870,6700,18570
14544,14545,21-10-2020 15:43:40.649718,Desayunos,Fratelli - Desayunos,45800,4600,50400
14545,14546,21-10-2020 15:43:41.047480,Alta Cocina · Italiana,Trattoria de la Plaza,13000,6000,19000
14546,14547,21-10-2020 15:43:41.194267,Saludable · Desayunos,Raices Bienestar Gourmet,23000,6600,29600
14547,14548,21-10-2020 15:43:41.391755,Típica · Parrilla,El Portal de la Antigua,31800,5600,37400
14548,14549,21-10-2020 15:43:41.638864,Peruana,Uma Cantina Peruana,39700,3200,42900
14549,14550,21-10-2020 15:43:41.836940,Postres · Desayunos,Maltihelado,27800,4500,32300
14550,14551,21-10-2020 15:43:42.183897,Saludable · Desayunos,Bawana - Sandwich,45800,3400,49200
14551,14552,21-10-2020 15:43:42.482902,Saludable · Parrilla,Box,48750,3700,52450
14552,14553,21-10-2020 15:43:42.829919,Desayunos · Café,Matchacha,8900,5900,14800
14553,14554,21-10-2020 15:43:43.027338,Postres · Saludable,Ana Rebana,35000,6300,41300
14554,14555,21-10-2020 15:43:43.274044,Pollo,Señor Fantástico,9000,4700,13700
14555,14556,21-10-2020 15:43:43.521800,Sánduches · China,Peru Mix,15600,5900,21500
14556,14557,21-10-2020 15:43:43.718591,Pizza,Pastas Laurentina,70000,4800,74800
14557,14558,21-10-2020 15:43:44.066134,Desayunos · Pescados y Mariscos,Luzí­a - Mediterranea,11870,5700,17570
14558,14559,21-10-2020 15:43:44.212526,Pescados y Mariscos,La Gran Cazuela,7500,3200,10700
14559,14560,21-10-2020 15:43:44.360145,Típica,Bendita S,9000,4600,13600
14560,14561,21-10-2020 15:43:44.559205,Pollo · Desayunos,Workzone,10700,3100,13800
14561,14562,21-10-2020 15:43:44.856780,Sushi · Desayunos,Maki Roll,24300,4300,28600
14562,14563,21-10-2020 15:43:45.103667,Pizza,18 Scalini,12500,4300,16800
14563,14564,21-10-2020 15:43:45.501755,Típica,El Mondongo y Mucho Mas,13600,5600,19200
14564,14565,21-10-2020 15:43:45.749894,Saludable · Desayunos,Bon Eat - Saludable,29500,4800,34300
14565,14566,21-10-2020 15:43:46.148579,Parrilla,Restaurante Bar Mi Ranchito,31800,5200,37000
14566,14567,21-10-2020 15:43:46.446276,Pollo,Heart & Cooking,18900,5000,23900
14567,14568,21-10-2020 15:43:46.694352,Desayunos · Típica,Casa Vieja,48750,6000,54750
14568,14569,21-10-2020 15:43:46.890977,Saludable · Desayunos,Distrito Gourmet,37900,3700,41600
14569,14570,21-10-2020 15:43:47.189067,Hamburguesas,Burger Society,15600,4100,19700
14570,14571,21-10-2020 15:43:47.587292,Desayunos,Jacinta Arepas de Huevo,11870,4000,15870
14571,14572,21-10-2020 15:43:47.935420,Desayunos · Panadería,Ficchi Panadería,29500,3100,32600
14572,14573,21-10-2020 15:43:48.182801,Saludable,Amor Propio saludable,35000,4000,39000
14573,14574,21-10-2020 15:43:48.330921,Desayunos · Típica,La Parrilla Dorada Polo,7500,6600,14100
14574,14575,21-10-2020 15:43:48.677904,Pescados y Mariscos,Fish Place - Del Mar,23000,5400,28400
14575,14576,21-10-2020 15:43:48.825638,Parrilla,Restaurante Bar Mi Ranchito,31800,5200,37000
14576,14577,21-10-2020 15:43:49.072313,Desayunos · Café,Frambas,17800,3400,21200
14577,14578,21-10-2020 15:43:49.220921,Pollo,Señor Fantástico,15600,4700,20300
14578,14579,21-10-2020 15:43:49.468507,Pollo · Saludable,Tremenda Sal y Dulce,65000,6500,71500
14579,14580,21-10-2020 15:43:49.616855,Desayunos,Señor Desayuno,15000,6800,21800
14580,14581,21-10-2020 15:43:49.814319,Saludable · Desayunos,Guadalupe - Fruteria,11870,5900,17770
14581,14582,21-10-2020 15:43:50.012663,Comida Rápida,Fiesta Digital Andrés,35000,3100,38100
14582,14583,21-10-2020 15:43:50.160066,Saludable,Hanai - Bowls Saludables,18900,5900,24800
14583,14584,21-10-2020 15:43:50.508207,Mexicana,Hidalgo Taquería,13000,4900,17900
14584,14585,21-10-2020 15:43:50.805507,Postres,La Galeta,7500,3000,10500
14585,14586,21-10-2020 15:43:51.153982,Desayunos · Panadería,Ficchi Panadería,65000,3100,68100
14586,14587,21-10-2020 15:43:51.501066,Típica · Pescados y Mariscos,Arroces Mrg,35000,4300,39300
14587,14588,21-10-2020 15:43:51.849317,Saludable · Desayunos,Básico y elemental,24200,5000,29200
14588,14589,21-10-2020 15:43:51.995894,Hamburguesas · Alitas,Beer,24300,6600,30900
14589,14590,21-10-2020 15:43:52.293990,Saludable,Hanai - Bowls Saludables,13600,5900,19500
14590,14591,21-10-2020 15:43:52.642976,Típica,Sopitas y Más,45800,4200,50000
14591,14592,21-10-2020 15:43:53.041356,Desayunos · Sánduches,Garnish,12500,5200,17700
14592,14593,21-10-2020 15:43:53.288963,Postres · Desayunos,Aury Postres - Comidas & Picadas,13000,4700,17700
14593,14594,21-10-2020 15:43:53.587343,Mexicana,Cantina La 15,15000,4300,19300
14594,14595,21-10-2020 15:43:53.734547,Típica,Sopitas y Más,7500,4200,11700
14595,14596,21-10-2020 15:43:54.132978,Hamburguesas,Bendito Cordero,53900,5800,59700
14596,14597,21-10-2020 15:43:54.330613,Saludable,Amor Propio saludable,37900,4000,41900
14597,14598,21-10-2020 15:43:54.578906,Café · Helados,Sofia heladería y café,31800,5800,37600
14598,14599,21-10-2020 15:43:54.976304,Típica,Baondish,31800,5800,37600
14599,14600,21-10-2020 15:43:55.275607,Desayunos · Típica,D'Porco - Lechona,35000,6300,41300
14600,14601,21-10-2020 15:43:55.672933,Saludable,MIMA,53400,3700,57100
14601,14602,21-10-2020 15:43:55.821154,Hamburguesas,Monchis - Hamburguesa,13600,4300,17900
14602,14603,21-10-2020 15:43:56.218619,Saludable · Desayunos,Distrito Gourmet,12500,3700,16200
14603,14604,21-10-2020 15:43:56.566463,Desayunos · Panadería,Choclofee,48750,4700,53450
14604,14605,21-10-2020 15:43:56.813363,Postres · Café,Loló Coffee & Snacks,27800,4600,32400
14605,14606,21-10-2020 15:43:57.011057,Hamburguesas · Alitas,Beer,29500,6600,36100
14606,14607,21-10-2020 15:43:57.157694,Desayunos,El Fogón Castellano,17800,3200,21000
14607,14608,21-10-2020 15:43:57.305789,Postres · Desayunos,Buñuelos nacho,35000,6600,41600
14608,14609,21-10-2020 15:43:57.602928,Pizza,18 Scalini,35000,4300,39300
14609,14610,21-10-2020 15:43:57.751586,Saludable,Ventura Soup y Salad,35000,3800,38800
14610,14611,21-10-2020 15:43:58.098729,Postres · Desayunos,Vivalight Market.,8900,6500,15400
14611,14612,21-10-2020 15:43:58.496999,Desayunos · Parrilla,Mi Patria,24300,4600,28900
14612,14613,21-10-2020 15:43:58.894283,Pollo,Heart & Cooking,24200,5000,29200
14613,14614,21-10-2020 15:43:59.041981,Hamburguesas · Desayunos,El Inglés Gastro Pub,24300,6600,30900
14614,14615,21-10-2020 15:43:59.239199,Desayunos · Pescados y Mariscos,Luzí­a - Mediterranea,12500,5700,18200
14615,14616,21-10-2020 15:43:59.487098,Postres,Beiked,29500,4000,33500
14616,14617,21-10-2020 15:43:59.733978,Saludable · Desayunos,Malú,37900,3700,41600
14617,14618,21-10-2020 15:43:59.881591,Desayunos · Comida Rápida,La Veneca,12500,6300,18800
14618,14619,21-10-2020 15:44:00.129317,Desayunos · Panadería,Artesanos,12500,4300,16800
14619,14620,21-10-2020 15:44:00.527280,Parrilla,Campocina,48750,4600,53350
14620,14621,21-10-2020 15:44:00.673950,Pollo · Típica,Auyama,11870,3900,15770
14621,14622,21-10-2020 15:44:00.921597,Desayunos · Café,Frambas,9000,3400,12400
14622,14623,21-10-2020 15:44:01.319256,Desayunos · Típica,Casa Vieja,9000,6000,15000
14623,14624,21-10-2020 15:44:01.667621,Italiana,F*cking Good Pizza,53900,4200,58100
14624,14625,21-10-2020 15:44:02.014637,Desayunos · Jugos y Batidos,Dont Be Hungry,70000,5600,75600
14625,14626,21-10-2020 15:44:02.413041,Saludable · Desayunos,Básico y Elemental,18900,5900,24800
14626,14627,21-10-2020 15:44:02.559911,Postres · Helados,Mahé,23000,6000,29000
14627,14628,21-10-2020 15:44:02.809345,Pollo · Desayunos,Candelina,70000,5300,75300
14628,14629,21-10-2020 15:44:03.156510,Internacional,La Esquina con Sabor Parrilla,10700,3000,13700
14629,14630,21-10-2020 15:44:03.505163,Café · Helados,Sofia heladería y café,12500,5800,18300
14630,14631,21-10-2020 15:44:03.902286,Helados,Orso To Go,27800,6800,34600
14631,14632,21-10-2020 15:44:04.100583,Postres · Desayunos,Maltihelado,8900,4500,13400
14632,14633,21-10-2020 15:44:04.397904,Típica,La Herencia,23000,5900,28900
14633,14634,21-10-2020 15:44:04.646151,Desayunos · Típica,Criollomania,15600,5200,20800
14634,14635,21-10-2020 15:44:05.043140,Crepes,La Chabatta,45800,5900,51700
14635,14636,21-10-2020 15:44:05.241417,Típica,La Herencia,53400,5900,59300
14636,14637,21-10-2020 15:44:05.438471,Postres · Desayunos,Sharmus,37900,6100,44000
14637,14638,21-10-2020 15:44:05.786942,Desayunos · Típica,D´Porco,35000,3900,38900
14638,14639,21-10-2020 15:44:05.934428,Desayunos,Sr Buñuelo,35000,6400,41400
14639,14640,21-10-2020 15:44:06.332703,Desayunos · Panadería,Le Pain Quotidien,24200,3900,28100
14640,14641,21-10-2020 15:44:06.730474,Parrilla · Internacional,Taperia de la Plaza,65000,5700,70700
14641,14642,21-10-2020 15:44:07.078432,Pollo · Desayunos,Abasto,39700,3600,43300
14642,14643,21-10-2020 15:44:07.476104,Saludable · Parrilla,Box,13000,3700,16700
14643,14644,21-10-2020 15:44:07.825049,Postres · Saludable,Ana Rebana,11870,6300,18170
14644,14645,21-10-2020 15:44:08.171908,Postres,La Galeta,12500,3000,15500
14645,14646,21-10-2020 15:44:08.520478,Mexicana,La leyenda mexican kitchen,45800,3200,49000
14646,14647,21-10-2020 15:44:08.767874,Parrilla,Antojo a Domicilio,39700,5000,44700
14647,14648,21-10-2020 15:44:09.115998,Saludable · Desayunos,La Estampilla,23000,6000,29000
14648,14649,21-10-2020 15:44:09.513549,Saludable · Desayunos,La Estampilla,23000,6000,29000
14649,14650,21-10-2020 15:44:09.912139,Desayunos · Jugos y Batidos,Frutiwow,8900,4100,13000
14650,14651,21-10-2020 15:44:10.059158,Típica,El Cucharón - Tipica,27800,4400,32200
14651,14652,21-10-2020 15:44:10.457751,Postres,Toledo Pastelería,7500,6800,14300
14652,14653,21-10-2020 15:44:10.756363,Pizza · Italiana,Pisapore - Pizza,13000,6600,19600
14653,14654,21-10-2020 15:44:11.102751,Italiana,Bocatto Di Passo,18900,5000,23900
14654,14655,21-10-2020 15:44:11.498525,Desayunos,Bagel Shop,8900,3200,12100
14655,14656,21-10-2020 15:44:11.693791,Saludable · Parrilla,Box,15000,3700,18700
14656,14657,21-10-2020 15:44:11.939060,Desayunos · Sánduches,Frutos del Bosque,13600,3500,17100
14657,14658,21-10-2020 15:44:12.084182,Pollo,Oliva Va,24200,5600,29800
14658,14659,21-10-2020 15:44:12.279540,Típica,Sopitas y Más,8900,4200,13100
14659,14660,21-10-2020 15:44:12.575194,Desayunos · Panadería,Decofruta,48750,4700,53450
14660,14661,21-10-2020 15:44:12.871312,Parrilla · Café,Figaro Café/ Restaurante Argentino,27800,5800,33600
14661,14662,21-10-2020 15:44:13.117035,Saludable · Desayunos,Re.al Alimentos Reales,10700,4000,14700
14662,14663,21-10-2020 15:44:13.413082,Saludable · Desayunos,La Cesta,31800,4700,36500
14663,14664,21-10-2020 15:44:13.758438,Desayunos · Típica,Rojo Gourmet,27800,4700,32500
14664,14665,21-10-2020 15:44:14.103987,Desayunos · Café,Aromacafé el Placer de Compartir,17800,5000,22800
14665,14666,21-10-2020 15:44:14.400021,Típica · Parrilla,Typykos,12500,6000,18500
14666,14667,21-10-2020 15:44:14.695421,Pollo · Desayunos,Abasto,53400,3600,57000
14667,14668,21-10-2020 15:44:15.090847,Desayunos · Panadería,Choclofee,70000,4700,74700
14668,14669,21-10-2020 15:44:15.336587,Desayunos · Típica,D´Porco,35000,3900,38900
14669,14670,21-10-2020 15:44:15.681926,Parrilla,Coquitas,48750,5600,54350
14670,14671,21-10-2020 15:44:15.827023,Típica,Bandejas Mrg,24200,3800,28000
14671,14672,21-10-2020 15:44:15.972006,Pollo · Sánduches,Pollos Century,15600,3000,18600
14672,14673,21-10-2020 15:44:16.285413,Sushi · Asiática,Tu Sushi,53900,6400,60300
14673,14674,21-10-2020 15:44:16.581151,Sushi · Asiática,Arigato,9000,5300,14300
14674,14675,21-10-2020 15:44:16.926649,Desayunos · Sánduches,Garnish,65000,5200,70200
14675,14676,21-10-2020 15:44:17.122384,Saludable · Desayunos,Fresh Co,53400,5600,59000
14676,14677,21-10-2020 15:44:17.528103,Mexicana,La leyenda mexican kitchen,45800,3200,49000
14677,14678,21-10-2020 15:44:17.673433,Postres · Panadería,RIGHT AWAY FOODS,7500,6600,14100
14678,14679,21-10-2020 15:44:17.920119,Desayunos · Helados,San Giorgio Gelateria,35000,3100,38100
14679,14680,21-10-2020 15:44:18.215608,Desayunos · Café,Frambas,37900,3400,41300
14680,14681,21-10-2020 15:44:18.561480,Pollo · Pescados y Mariscos,Bang Bang Rice,18900,3400,22300
14681,14682,21-10-2020 15:44:18.906805,Pescados y Mariscos,Pescadero Héroes del Mar,18900,6600,25500
14682,14683,21-10-2020 15:44:19.252316,Desayunos · Típica,D'Porco - Lechona,70000,6300,76300
14683,14684,21-10-2020 15:44:19.448066,Típica,Salsig,34500,5600,40100
14684,14685,21-10-2020 15:44:19.643493,Pescados y Mariscos,Pescadero Héroes del Mar,34500,6600,41100
14685,14686,21-10-2020 15:44:19.788754,Hamburguesas · Panadería,NYC Burgers,15600,6200,21800
14686,14687,21-10-2020 15:44:20.034331,Típica,Cabrito Santandereano,29500,6600,36100
14687,14688,21-10-2020 15:44:20.179546,Desayunos · Árabe,Boniato Sabores Vivos,35000,5300,40300
14688,14689,21-10-2020 15:44:20.524731,Postres · Desayunos,Amelie Helados,12500,6400,18900
14689,14690,21-10-2020 15:44:20.820139,Parrilla,Parrilla Pimentón,53900,3400,57300
14690,14691,21-10-2020 15:44:21.165895,Típica · Pescados y Mariscos,La Vitualla,17800,6300,24100
14691,14692,21-10-2020 15:44:21.412292,Sushi,Umi,48750,5600,54350
14692,14693,21-10-2020 15:44:21.808788,Parrilla,Coquitas,24300,5600,29900
14693,14694,21-10-2020 15:44:21.967817,Parrilla,Restaurante Bar Mi Ranchito,9000,5200,14200
14694,14695,21-10-2020 15:44:22.263451,Desayunos · Típica,La Frijolada,35000,4500,39500
14695,14696,21-10-2020 15:44:22.558867,Pizza,Pizza Andante,15600,6300,21900
14696,14697,21-10-2020 15:44:22.704144,Pescados y Mariscos,Fish Place - Del Mar,11870,5400,17270
14697,14698,21-10-2020 15:44:22.849383,Desayunos · Típica,90 Calentados,35000,3700,38700
14698,14699,21-10-2020 15:44:23.195056,Desayunos · Panadería,Premium Break Bakery,39700,3700,43400
14699,14700,21-10-2020 15:44:23.491531,Desayunos,Sunny Breakfast Brunch,9000,4300,13300
14700,14701,21-10-2020 15:44:23.837061,Desayunos · Típica,Casa Vieja,48750,6000,54750
14701,14702,21-10-2020 15:44:23.982590,Desayunos,Cafetería el Kippe,35000,3200,38200
14702,14703,21-10-2020 15:44:24.128438,Hamburguesas,Gofi Burger,29500,5100,34600
14703,14704,21-10-2020 15:44:24.524029,Pollo · Pescados y Mariscos,Bang Bang Rice,45800,3400,49200
14704,14705,21-10-2020 15:44:24.769707,Desayunos · Café,Moramia,45800,4700,50500
14705,14706,21-10-2020 15:44:25.115421,Saludable · Desayunos,Distrito Gourmet,35000,3700,38700
14706,14707,21-10-2020 15:44:25.360610,Pollo · Típica,Auyama,35000,3900,38900
14707,14708,21-10-2020 15:44:25.706170,Típica · Parrilla,Toya,23000,4200,27200
14708,14709,21-10-2020 15:44:25.952134,Postres,Beiked,23000,4000,27000
14709,14710,21-10-2020 15:44:26.147161,Postres · Desayunos,Maltihelados,8900,6200,15100
14710,14711,21-10-2020 15:44:26.542750,Hamburguesas · Desayunos,El Inglés Gastro Pub,35000,6600,41600
14711,14712,21-10-2020 15:44:26.887843,Típica,Cabrito Santandereano,15600,6600,22200
14712,14713,21-10-2020 15:44:27.098409,Desayunos · Panadería,Santa Juana Food Bar,18900,5900,24800
14713,14714,21-10-2020 15:44:27.344023,Pizza · Italiana,Piatto - Pizza,29500,6600,36100
14714,14715,21-10-2020 15:44:27.489464,Típica · Parrilla,Toya,53900,4200,58100
14715,14716,21-10-2020 15:44:27.684679,Desayunos · Panadería,Premium Break Bakery,15600,3700,19300
14716,14717,21-10-2020 15:44:27.930203,Desayunos,Señor Desayuno,15600,6800,22400
14717,14718,21-10-2020 15:44:28.075109,Saludable,A2manos,9000,4200,13200
14718,14719,21-10-2020 15:44:28.321390,Postres · Desayunos,Vivalight Market.,48750,6500,55250
14719,14720,21-10-2020 15:44:28.466395,Hamburguesas · Alitas,Beer,24300,6600,30900
14720,14721,21-10-2020 15:44:28.661679,Peruana,Uma Cantina Peruana,10700,3200,13900
14721,14722,21-10-2020 15:44:28.856661,Saludable,The Good Rice Bowls,31800,3500,35300
14722,14723,21-10-2020 15:44:29.152116,Parrilla · Café,Figaro Café/ Restaurante Argentino,7500,5800,13300
14723,14724,21-10-2020 15:44:29.397794,Desayunos · Típica,Peninsula Calentados y Parrilla,35000,3400,38400
14724,14725,21-10-2020 15:44:29.593495,Saludable,Hanai - Bowls Saludables,18900,5900,24800
14725,14726,21-10-2020 15:44:29.938809,Típica,Lo Nuestro,15600,3100,18700
14726,14727,21-10-2020 15:44:30.234632,Sushi,Kim Pop,17800,5400,23200
14727,14728,21-10-2020 15:44:30.379952,Pizza · Italiana,Pisapore - Pizza,12500,6600,19100
14728,14729,21-10-2020 15:44:30.725878,Hamburguesas,Gofi Burger,37900,5100,43000
14729,14730,21-10-2020 15:44:31.071645,Típica,Salsig,13000,5600,18600
14730,14731,21-10-2020 15:44:31.317069,Parrilla,Coquitas,45800,5600,51400
14731,14732,21-10-2020 15:44:31.562872,Típica,Bandejas Mrg,23000,3800,26800
14732,14733,21-10-2020 15:44:31.958422,Postres · Desayunos,Buñuelos nacho,70000,6600,76600
14733,14734,21-10-2020 15:44:32.353817,Hamburguesas · Pescados y Mariscos,El Velero,15000,6500,21500
14734,14735,21-10-2020 15:44:32.649674,Mexicana,Mexicanachos,8900,3900,12800
14735,14736,21-10-2020 15:44:32.894774,Sushi,Canoa To Go,35000,5900,40900
14736,14737,21-10-2020 15:44:33.140419,Desayunos · Típica,D´Porco,12500,3900,16400
14737,14738,21-10-2020 15:44:33.386976,Típica,Sabrosito,13000,4000,17000
14738,14739,21-10-2020 15:44:33.533243,Pollo · Típica,Auyama,17800,3900,21700
14739,14740,21-10-2020 15:44:33.928862,Alta Cocina · Parrilla,Criterión,12500,6000,18500
14740,14741,21-10-2020 15:44:34.275374,Desayunos · Típica,Cochon,45800,3300,49100
14741,14742,21-10-2020 15:44:34.621459,Desayunos · Típica,La Frijolada,9000,4500,13500
14742,14743,21-10-2020 15:44:34.767029,Típica · Pescados y Mariscos,Arroces Mrg,24200,4300,28500
14743,14744,21-10-2020 15:44:35.012559,Postres · Saludable,Ana Rebana,35000,6300,41300
14744,14745,21-10-2020 15:44:35.308073,Pizza,pizza andante,53900,4200,58100
14745,14746,21-10-2020 15:44:35.703517,Mexicana,Hidalgo Taquería,48750,4900,53650
14746,14747,21-10-2020 15:44:35.999150,Desayunos · Típica,Papadió - Colombianas,15600,5700,21300
14747,14748,21-10-2020 15:44:36.394735,Desayunos,Butter,27800,6700,34500
14748,14749,21-10-2020 15:44:36.540258,Pollo · Saludable,Tremenda Sal y Dulce,53900,6500,60400
14749,14750,21-10-2020 15:44:36.735899,Desayunos · Panadería,Limarys,11870,6500,18370
14750,14751,21-10-2020 15:44:36.931435,Saludable · Parrilla,Box,13600,3700,17300
14751,14752,21-10-2020 15:44:37.278358,Perros Calientes,Dog Shop - Rapida,13600,4900,18500
14752,14753,21-10-2020 15:44:37.524706,Desayunos · Mexicana,La Mera Mera - Mexicana,15000,3100,18100
14753,14754,21-10-2020 15:44:37.920345,Sushi · Asiática,Arigato,27800,5300,33100
14754,14755,21-10-2020 15:44:38.216203,Saludable · Desayunos,Bawana - Sandwich,39700,3400,43100
14755,14756,21-10-2020 15:44:38.413064,Desayunos · Típica,Papadió - Colombianas,39700,5700,45400
14756,14757,21-10-2020 15:44:38.608847,Sushi,Umi,17800,5600,23400
14757,14758,21-10-2020 15:44:38.754544,Pizza,Pastas Laurentina,48750,4800,53550
14758,14759,21-10-2020 15:44:39.000058,Desayunos · Café,vereda central calle 99,35000,5700,40700
14759,14760,21-10-2020 15:44:39.346235,Hamburguesas · Pescados y Mariscos,El Velero,7500,6500,14000
14760,14761,21-10-2020 15:44:39.642047,Típica · Parrilla,Mi Ranchito Parrilla,13000,4400,17400
14761,14762,21-10-2020 15:44:39.988219,Típica · Parrilla,Toya,34500,4200,38700
14762,14763,21-10-2020 15:44:40.384063,Típica,La Cocina,7500,4600,12100
14763,14764,21-10-2020 15:44:40.630150,Pollo · Saludable,Tremenda Sal y Dulce,23000,6500,29500
14764,14765,21-10-2020 15:44:41.026037,Parrilla,Parrilla Pimentón,10700,3400,14100
14765,14766,21-10-2020 15:44:41.271805,Saludable · Parrilla,Box,65000,3700,68700
14766,14767,21-10-2020 15:44:41.618096,Pollo · Sánduches,Pollos Century,24300,3000,27300
14767,14768,21-10-2020 15:44:41.763970,Desayunos,Don Leo,70000,6000,76000
14768,14769,21-10-2020 15:44:42.159827,Perros Calientes,Dog Shop - Rapida,70000,4900,74900
14769,14770,21-10-2020 15:44:42.355108,Peruana · Internacional,La Chifería,34500,6600,41100
14770,14771,21-10-2020 15:44:42.700775,Desayunos · Panadería,Ficchi Panadería,37900,3100,41000
14771,14772,21-10-2020 15:44:42.896112,Alta Cocina · Postres,La Pinta,23000,4500,27500
14772,14773,21-10-2020 15:44:43.041368,Poke,Poke Go,35000,4600,39600
14773,14774,21-10-2020 15:44:43.337316,Hamburguesas · Panadería,NYC Burgers,65000,6200,71200
14774,14775,21-10-2020 15:44:43.584242,Mexicana,Cantina La 15,35000,4300,39300
14775,14776,21-10-2020 15:44:43.833571,Típica · Parrilla,La Ternera Parrilla,37900,5200,43100
14776,14777,21-10-2020 15:44:44.133490,Desayunos · Empanadas,Empanadas Doraditas.com,10700,3000,13700
14777,14778,21-10-2020 15:44:44.379419,Saludable,Amor Propio saludable,29500,4000,33500
14778,14779,21-10-2020 15:44:44.725165,Parrilla,Restaurante Bar Mi Ranchito,34500,5200,39700
14779,14780,21-10-2020 15:44:44.920699,Postres · Desayunos,Sharmus,23000,6100,29100
14780,14781,21-10-2020 15:44:45.116310,Parrilla,OAK Ahumado y Brebajes,18900,6000,24900
14781,14782,21-10-2020 15:44:45.512696,Desayunos · Panadería,Ficchi Panadería,13600,3100,16700
14782,14783,21-10-2020 15:44:45.858826,Típica,Cabrito Santandereano,15000,6600,21600
14783,14784,21-10-2020 15:44:46.255641,Desayunos · Típica,La Parrilla Dorada Polo,45800,6600,52400
14784,14785,21-10-2020 15:44:46.552117,Desayunos · Empanadas,Mis Delicias,15000,3200,18200
14785,14786,21-10-2020 15:44:46.698355,Saludable · Típica,Saludable Mrg,31800,5800,37600
14786,14787,21-10-2020 15:44:46.994337,Postres · Desayunos,Gelateria Da Favola,9000,6500,15500
14787,14788,21-10-2020 15:44:47.390117,Asiática,Thai Station,35000,6000,41000
14788,14789,21-10-2020 15:44:47.585664,Típica · Parrilla,La Ternera Parrilla,39700,5200,44900
14789,14790,21-10-2020 15:44:47.831128,Típica · Parrilla,Mi Ranchito Parrilla,24200,4400,28600
14790,14791,21-10-2020 15:44:48.226948,Desayunos · Comida Rápida,Chocolatto,37900,3400,41300
14791,14792,21-10-2020 15:44:48.422837,Típica,Bendita S,70000,4600,74600
14792,14793,21-10-2020 15:44:48.568270,Internacional,Rio Sabores y Experiencias,53900,4100,58000
14793,14794,21-10-2020 15:44:48.814935,Sushi,Umi,35000,5600,40600
14794,14795,21-10-2020 15:44:49.060346,Desayunos,Don Leo,7500,6000,13500
14795,14796,21-10-2020 15:44:49.456298,Desayunos · Panadería,El Pan de Phillippe,53900,4600,58500
14796,14797,21-10-2020 15:44:49.601891,Saludable,MIMA,37900,3700,41600
14797,14798,21-10-2020 15:44:49.847844,Saludable · Jugos y Batidos,Berdes Drinks & Salads,18900,3500,22400
14798,14799,21-10-2020 15:44:50.143608,Sushi,Kim Pop,17800,5400,23200
14799,14800,21-10-2020 15:44:50.339350,Asiática,TeT,23000,5900,28900
14800,14801,21-10-2020 15:44:50.585348,Desayunos · Empanadas,Mis Delicias,35000,3200,38200
14801,14802,21-10-2020 15:44:50.930949,Saludable · Típica,Saludable Mrg,15000,5800,20800
14802,14803,21-10-2020 15:44:51.177173,Desayunos,Cafetería el Kippe,27800,3200,31000
14803,14804,21-10-2020 15:44:51.322819,Postres · Desayunos,Aury Postres - Comidas & Picadas,13000,4700,17700
14804,14805,21-10-2020 15:44:51.618372,Parrilla,Campocina,9000,4600,13600
14805,14806,21-10-2020 15:44:51.914190,Desayunos · Panadería,Artesanos,10700,4300,15000
14806,14807,21-10-2020 15:44:52.109739,Pizza · Parrilla,Urban Lunch,34500,4000,38500
14807,14808,21-10-2020 15:44:52.305175,Desayunos,Señor Desayuno,35000,6800,41800
14808,14809,21-10-2020 15:44:52.551002,Saludable · Desayunos,Guadalupe - Fruteria,15600,5900,21500
14809,14810,21-10-2020 15:44:52.846703,Desayunos · Panadería,Artesanos,15000,4300,19300
14810,14811,21-10-2020 15:44:53.192318,Parrilla,Carnes la Zarza,34500,4900,39400
14811,14812,21-10-2020 15:44:53.538579,Postres · Café,Celestino Café,17800,5900,23700
14812,14813,21-10-2020 15:44:53.935135,Desayunos · Panadería,Ficchi Panadería,34500,3100,37600
14813,14814,21-10-2020 15:44:54.130744,Saludable · Desayunos,Básico y Elemental,15600,5900,21500
14814,14815,21-10-2020 15:44:54.526860,Parrilla,OAK Ahumado y Brebajes,29500,6000,35500
14815,14816,21-10-2020 15:44:54.722697,Desayunos · Pescados y Mariscos,Gypsy Bistro,39700,4500,44200
14816,14817,21-10-2020 15:44:55.068629,Típica,Bandejas Mrg,9000,3800,12800
14817,14818,21-10-2020 15:44:55.214229,Sánduches,Submarin,48750,3800,52550
14818,14819,21-10-2020 15:44:55.559835,Sushi · Asiática,Arigato,53900,5300,59200
14819,14820,21-10-2020 15:44:55.755757,Postres,La Galeta,48750,3000,51750
14820,14821,21-10-2020 15:44:56.151683,Postres · Helados,Mahé,35000,6000,41000
14821,14822,21-10-2020 15:44:56.297373,Saludable · Desayunos,Re.al Alimentos Reales,35000,4000,39000
14822,14823,21-10-2020 15:44:56.643446,Desayunos · Internacional,Camilia,31800,3900,35700
14823,14824,21-10-2020 15:44:56.839183,Desayunos · Jugos y Batidos,Frutiwow,23000,4100,27100
14824,14825,21-10-2020 15:44:57.084666,Desayunos,Desayunos en Bogotá,15000,3400,18400
14825,14826,21-10-2020 15:44:57.280431,Parrilla,Parrilla Pimentón,15600,3400,19000
14826,14827,21-10-2020 15:44:57.676381,Sushi,Umi,23000,5600,28600
14827,14828,21-10-2020 15:44:57.822675,Sushi,Umi,45800,5600,51400
14828,14829,21-10-2020 15:44:58.168217,Desayunos · Italiana,Rceta By Rausch,35000,3600,38600
14829,14830,21-10-2020 15:44:58.313779,Postres,Levelma,7500,6200,13700
14830,14831,21-10-2020 15:44:58.660019,Saludable · Desayunos,Guadalupe - Fruteria,12500,5900,18400
14831,14832,21-10-2020 15:44:58.956598,Postres,La Galeta,37900,3000,40900
14832,14833,21-10-2020 15:44:59.352170,Peruana,Masivo,35000,5800,40800
14833,14834,21-10-2020 15:44:59.648346,Típica,La Herencia,31800,5900,37700
14834,14835,21-10-2020 15:44:59.943732,Típica · Parrilla,Toya,18900,4200,23100
14835,14836,21-10-2020 15:45:00.290076,Desayunos,El Fogón Castellano,13000,3200,16200
14836,14837,21-10-2020 15:45:00.436375,Peruana,Uma Cantina Peruana,45800,3200,49000
14837,14838,21-10-2020 15:45:00.833487,Poke,Poke Go,53900,4600,58500
14838,14839,21-10-2020 15:45:01.080088,Desayunos · Típica,Casa Vieja,23000,6000,29000
14839,14840,21-10-2020 15:45:01.227366,Saludable · Jugos y Batidos,Berdes Drinks & Salads,53400,3500,56900
14840,14841,21-10-2020 15:45:01.474236,Típica,La Cocina,12500,4600,17100
14841,14842,21-10-2020 15:45:01.621171,Hamburguesas,Burger Society,53900,4100,58000
14842,14843,21-10-2020 15:45:01.868281,Helados,Buon Gelato,27800,4400,32200
14843,14844,21-10-2020 15:45:02.064810,Típica,El Cucharón - Tipica,11870,4400,16270
14844,14845,21-10-2020 15:45:02.461419,Panadería,Boul,35000,3100,38100
14845,14846,21-10-2020 15:45:02.858136,Hamburguesas · Desayunos,El Inglés Gastro Pub,23000,6600,29600
14846,14847,21-10-2020 15:45:03.004842,Desayunos,Señor Desayuno,11870,6800,18670
14847,14848,21-10-2020 15:45:03.150759,Desayunos,Cafetería el Kippe,29500,3200,32700
14848,14849,21-10-2020 15:45:03.347514,Parrilla,Arroces Maria Paula,27800,6800,34600
14849,14850,21-10-2020 15:45:03.743705,Desayunos · Típica,D'Porco - Lechona,8900,6300,15200
14850,14851,21-10-2020 15:45:03.991018,Saludable · Desayunos,Libre de Culpa,12500,4000,16500
14851,14852,21-10-2020 15:45:04.237701,Desayunos · Pescados y Mariscos,Gypsy Bistro,13600,4500,18100
14852,14853,21-10-2020 15:45:04.384421,Típica,La Cocina,70000,4600,74600
14853,14854,21-10-2020 15:45:04.730694,Pollo · Saludable,Tremenda Sal y Dulce,24200,6500,30700
14854,14855,21-10-2020 15:45:04.977427,Parrilla,OAK Ahumado y Brebajes,31800,6000,37800
14855,14856,21-10-2020 15:45:05.223338,Postres,La Tertulia,53900,3400,57300
14856,14857,21-10-2020 15:45:05.421105,Desayunos · Café,El Gualilo,23000,6200,29200
14857,14858,21-10-2020 15:45:05.566675,Sushi,Canoa To Go,70000,5900,75900
14858,14859,21-10-2020 15:45:05.813299,Sushi · Asiática,Arigato,27800,5300,33100
14859,14860,21-10-2020 15:45:05.958881,Desayunos · Típica,Cochon,53900,3300,57200
14860,14861,21-10-2020 15:45:06.204835,Desayunos · Típica,90 Calentados,10700,3700,14400
14861,14862,21-10-2020 15:45:06.600783,Postres · Desayunos,Sharmus,24300,6100,30400
14862,14863,21-10-2020 15:45:06.997178,Saludable · Típica,Saludable Mrg,31800,5800,37600
14863,14864,21-10-2020 15:45:07.293755,Peruana,Masivo,15600,5800,21400
14864,14865,21-10-2020 15:45:07.440065,Saludable,MIMA,9000,3700,12700
14865,14866,21-10-2020 15:45:07.686384,Postres · Desayunos,Maltihelados,13000,6200,19200
14866,14867,21-10-2020 15:45:07.832489,Italiana,Bocatto Di Passo,23000,5000,28000
14867,14868,21-10-2020 15:45:08.228873,Sushi · Asiática,Arigato,65000,5300,70300
14868,14869,21-10-2020 15:45:08.374815,Sánduches · China,Peru Mix,13000,5900,18900
14869,14870,21-10-2020 15:45:08.621551,Sushi · Desayunos,Maki Roll,53900,4300,58200
14870,14871,21-10-2020 15:45:08.781525,Postres · Café,Loló Coffee & Snacks,29500,4600,34100
14871,14872,21-10-2020 15:45:09.128661,Hamburguesas · Pescados y Mariscos,El Velero,13000,6500,19500
14872,14873,21-10-2020 15:45:09.424943,Alta Cocina · Postres,La Pinta,70000,4500,74500
14873,14874,21-10-2020 15:45:09.670970,Típica · Parrilla,La Ternera Parrilla,29500,5200,34700
14874,14875,21-10-2020 15:45:09.817357,Desayunos,Señor Desayuno,23000,6800,29800
14875,14876,21-10-2020 15:45:10.113715,Hamburguesas · Pescados y Mariscos,El Velero,23000,6500,29500
14876,14877,21-10-2020 15:45:10.509894,Alta Cocina · Parrilla,Criterión,45800,6000,51800
14877,14878,21-10-2020 15:45:10.706005,Desayunos · Café,Frambas,24200,3400,27600
14878,14879,21-10-2020 15:45:11.051735,Saludable · Desayunos,Guadalupe - Fruteria,45800,5900,51700
14879,14880,21-10-2020 15:45:11.210754,Parrilla,Arroces Maria Paula,53900,6800,60700
14880,14881,21-10-2020 15:45:11.456664,Alta Cocina · Italiana,Trattoria de la Plaza,23000,6000,29000
14881,14882,21-10-2020 15:45:11.853318,Mexicana,La leyenda mexican kitchen,18900,3200,22100
14882,14883,21-10-2020 15:45:11.998803,Parrilla,Beraca Parrilla Bbq,9000,5600,14600
14883,14884,21-10-2020 15:45:12.245582,Desayunos · Café,Libertario Coffee Roasters,15000,4600,19600
14884,14885,21-10-2020 15:45:12.491258,Desayunos · Típica,Alce,48750,4900,53650
14885,14886,21-10-2020 15:45:12.688450,Desayunos · Comida Rápida,Chocolatto,8900,3400,12300
14886,14887,21-10-2020 15:45:13.084419,Hamburguesas · Desayunos,El Inglés Gastro Pub,15600,6600,22200
14887,14888,21-10-2020 15:45:13.494347,Saludable · Desayunos,Guadalupe - Fruteria,29500,5900,35400
14888,14889,21-10-2020 15:45:13.891533,Pizza · Italiana,Pisapore - Pizza,31800,6600,38400
14889,14890,21-10-2020 15:45:14.054358,Desayunos · Típica,Parrilla Farandula Típico,27800,5900,33700
14890,14891,21-10-2020 15:45:14.452204,Desayunos · Panadería,Artesanos,35000,4300,39300
14891,14892,21-10-2020 15:45:14.884741,Postres · Desayunos,Jacques Pastelería,8900,5900,14800
14892,14893,21-10-2020 15:45:15.281352,Postres,La Galeta,31800,3000,34800
14893,14894,21-10-2020 15:45:15.427964,Postres · Helados,Mahé,70000,6000,76000
14894,14895,21-10-2020 15:45:15.674231,Desayunos · Típica,Casa Vieja,7500,6000,13500
14895,14896,21-10-2020 15:45:15.920218,Postres,La Galeta,23000,3000,26000
14896,14897,21-10-2020 15:45:16.066159,Helados,Orso To Go,35000,6800,41800
14897,14898,21-10-2020 15:45:16.211856,Saludable,The Good Rice Bowls,48750,3500,52250
14898,14899,21-10-2020 15:45:16.458445,Italiana,F*cking Good Pizza,39700,4200,43900
14899,14900,21-10-2020 15:45:16.704852,Desayunos · Típica,Criollomania,29500,5200,34700
14900,14901,21-10-2020 15:45:16.900657,Saludable · Desayunos,Básico y Elemental,23000,5900,28900
14901,14902,21-10-2020 15:45:17.210534,Postres,La Tertulia,7500,3400,10900
14902,14903,21-10-2020 15:45:17.373403,Saludable · Desayunos,La Cesta,24300,4700,29000
14903,14904,21-10-2020 15:45:17.633198,Crepes,La Chabatta,35000,5900,40900
14904,14905,21-10-2020 15:45:17.829523,Típica,La Cocina,9000,4600,13600
14905,14906,21-10-2020 15:45:17.975549,Parrilla,Arepaisa de Medellín,48750,5600,54350
14906,14907,21-10-2020 15:45:18.171610,Internacional,Rio Sabores y Experiencias,17800,4100,21900
14907,14908,21-10-2020 15:45:18.317730,Desayunos,Cafetería el Kippe,11870,3200,15070
14908,14909,21-10-2020 15:45:18.563361,Desayunos,El Corral - Desayunos,10700,5000,15700
14909,14910,21-10-2020 15:45:18.709460,Desayunos · Sánduches,Garnish,24200,5200,29400
14910,14911,21-10-2020 15:45:19.021766,Desayunos · Internacional,Camilia,9000,3900,12900
14911,14912,21-10-2020 15:45:19.218228,Desayunos · Jugos y Batidos,Dont Be Hungry,53900,5600,59500
14912,14913,21-10-2020 15:45:19.363770,Desayunos · Típica,Alce,24200,4900,29100
14913,14914,21-10-2020 15:45:19.560913,Postres,La Tertulia,10700,3400,14100
14914,14915,21-10-2020 15:45:19.756824,Postres · Desayunos,Café Quindio,24200,5700,29900
14915,14916,21-10-2020 15:45:20.153043,Desayunos,Butter,23000,6700,29700
14916,14917,21-10-2020 15:45:20.348703,Típica,Juan Chorizo,24300,3900,28200
14917,14918,21-10-2020 15:45:20.544495,Desayunos · Jugos y Batidos,Dont Be Hungry,12500,5600,18100
14918,14919,21-10-2020 15:45:20.890246,Saludable,MIMA,11870,3700,15570
14919,14920,21-10-2020 15:45:21.236661,Desayunos,Fratelli - Desayunos,23000,4600,27600
14920,14921,21-10-2020 15:45:21.532574,Jugos y Batidos,Pomponio,17800,3600,21400
14921,14922,21-10-2020 15:45:21.928472,Postres,La Galeta,45800,3000,48800
14922,14923,21-10-2020 15:45:22.274690,Postres · Desayunos,Protein Bakes,45800,5900,51700
14923,14924,21-10-2020 15:45:22.421412,Perros Calientes,Dog Shop - Rapida,45800,4900,50700
14924,14925,21-10-2020 15:45:22.668218,Parrilla,Campocina,37900,4600,42500
14925,14926,21-10-2020 15:45:22.815218,Desayunos · Café,Frambas,27800,3400,31200
14926,14927,21-10-2020 15:45:23.011806,Parrilla,Carnes la Zarza,17800,4900,22700
14927,14928,21-10-2020 15:45:23.257926,Peruana,Uma Cantina Peruana,9000,3200,12200
14928,14929,21-10-2020 15:45:23.603768,Típica · Parrilla,El Santandereano,53400,5200,58600
14929,14930,21-10-2020 15:45:23.999828,Internacional,La Esquina con Sabor Parrilla,24200,3000,27200
14930,14931,21-10-2020 15:45:24.396220,Mexicana,Mexicanachos,34500,3900,38400
14931,14932,21-10-2020 15:45:24.643946,Pizza · Italiana,Piatto - Pizza,34500,6600,41100
14932,14933,21-10-2020 15:45:24.890357,Saludable · Desayunos,Re.al Alimentos Reales,70000,4000,74000
14933,14934,21-10-2020 15:45:25.036438,Saludable · Desayunos,Agua Dulce,53400,3700,57100
14934,14935,21-10-2020 15:45:25.282758,Pizza,pizza andante,9000,4200,13200
14935,14936,21-10-2020 15:45:25.478913,Jugos y Batidos,Pomponio,31800,3600,35400
14936,14937,21-10-2020 15:45:25.874927,Crepes,San Crepes,70000,4900,74900
14937,14938,21-10-2020 15:45:26.271558,Sushi · Asiática,Arigato,53400,5300,58700
14938,14939,21-10-2020 15:45:26.617644,Saludable,MIMA,12500,3700,16200
14939,14940,21-10-2020 15:45:27.013595,Típica,Lo Nuestro,27800,3100,30900
14940,14941,21-10-2020 15:45:27.410164,Típica · Parrilla,El Santandereano,24300,5200,29500
14941,14942,21-10-2020 15:45:27.556365,Saludable · Desayunos,Básico y elemental,48750,5000,53750
14942,14943,21-10-2020 15:45:27.752433,Saludable · Típica,Saludable Mrg,45800,5800,51600
14943,14944,21-10-2020 15:45:28.048621,Postres · Desayunos,Aury Postres - Comidas & Picadas,29500,4700,34200
14944,14945,21-10-2020 15:45:28.445465,Comida Rápida,Fiesta Digital Andrés,27800,3100,30900
14945,14946,21-10-2020 15:45:28.791484,Pollo · Desayunos,Caserito Gourmet,31800,6700,38500
14946,14947,21-10-2020 15:45:29.187206,Mexicana,Hidalgo Taquería,29500,4900,34400
14947,14948,21-10-2020 15:45:29.433578,Desayunos · Internacional,Camilia,53900,3900,57800
14948,14949,21-10-2020 15:45:29.830905,Desayunos · Café,Moramia,11870,4700,16570
14949,14950,21-10-2020 15:45:30.027155,Típica · Parrilla,Parrilla Farandula Gourmet,34500,5100,39600
14950,14951,21-10-2020 15:45:30.373616,Desayunos,Sunny Breakfast Brunch,13600,4300,17900
14951,14952,21-10-2020 15:45:30.519532,Parrilla,Coquitas,27800,5600,33400
14952,14953,21-10-2020 15:45:30.715894,Desayunos,Don Leo,7500,6000,13500
14953,14954,21-10-2020 15:45:31.012019,Postres · Desayunos,Jacques Pastelería,53400,5900,59300
14954,14955,21-10-2020 15:45:31.358480,Pizza,18 Scalini,17800,4300,22100
14955,14956,21-10-2020 15:45:31.604508,Postres,La Galeta,24200,3000,27200
14956,14957,21-10-2020 15:45:31.900601,Desayunos,Jacinta Arepas de Huevo,35000,4000,39000
14957,14958,21-10-2020 15:45:32.196963,Desayunos · Típica,La Parrilla Dorada Polo,27800,6600,34400
14958,14959,21-10-2020 15:45:32.593668,Mexicana,La leyenda mexican kitchen,70000,3200,73200
14959,14960,21-10-2020 15:45:32.790097,Pollo · Desayunos,Caserito Gourmet,35000,6700,41700
14960,14961,21-10-2020 15:45:33.035816,Crepes,San Crepes,24200,4900,29100
14961,14962,21-10-2020 15:45:33.382020,Parrilla,Campocina,27800,4600,32400
14962,14963,21-10-2020 15:45:33.528136,Postres · Desayunos,KOKOA & co.,45800,4700,50500
14963,14964,21-10-2020 15:45:33.774345,Alta Cocina · Postres,La Pinta,13000,4500,17500
14964,14965,21-10-2020 15:45:33.919996,Típica,Sabrosito,23000,4000,27000
14965,14966,21-10-2020 15:45:34.116206,Postres · Desayunos,KOKOA & co.,37900,4700,42600
14966,14967,21-10-2020 15:45:34.412704,Peruana · Internacional,La Chifería,8900,6600,15500
14967,14968,21-10-2020 15:45:34.709045,Saludable · Desayunos,Re.al Alimentos Reales,23000,4000,27000
14968,14969,21-10-2020 15:45:35.106404,Típica,Carbón & Mondongos,18900,6400,25300
14969,14970,21-10-2020 15:45:35.253422,Saludable · Desayunos,Malú,29500,3700,33200
14970,14971,21-10-2020 15:45:35.399784,Saludable · Jugos y Batidos,Berdes Drinks & Salads,23000,3500,26500
14971,14972,21-10-2020 15:45:35.695696,Hamburguesas,Bendito Cordero,10700,5800,16500
14972,14973,21-10-2020 15:45:36.092367,Postres,Toledo Pastelería,18900,6800,25700
14973,14974,21-10-2020 15:45:36.288734,Desayunos · Panadería,Artesanos,23000,4300,27300
14974,14975,21-10-2020 15:45:36.534724,Desayunos · Helados,San Giorgio Gelateria,7500,3100,10600
14975,14976,21-10-2020 15:45:36.680567,Pollo,Chicken House,13000,4200,17200
14976,14977,21-10-2020 15:45:36.876644,Pollo · Saludable,Tremenda Sal y Dulce,13600,6500,20100
14977,14978,21-10-2020 15:45:37.022855,Desayunos · Típica,D´Porco,37900,3900,41800
14978,14979,21-10-2020 15:45:37.269398,Poke,Poke Go,31800,4600,36400
14979,14980,21-10-2020 15:45:37.665790,Postres,La Tertulia,8900,3400,12300
14980,14981,21-10-2020 15:45:38.012326,Pollo · Desayunos,Abasto,29500,3600,33100
14981,14982,21-10-2020 15:45:38.409378,Desayunos · Comida Rápida,Chocolatto,29500,3400,32900
14982,14983,21-10-2020 15:45:38.705308,Parrilla · Internacional,Taperia de la Plaza,15600,5700,21300
14983,14984,21-10-2020 15:45:38.851522,Postres · Desayunos,Cosmo Cookies,8900,5900,14800
14984,14985,21-10-2020 15:45:39.147726,Postres · Desayunos,Café Quindio,8900,5700,14600
14985,14986,21-10-2020 15:45:39.294265,Pollo,Chicken House,37900,4200,42100
14986,14987,21-10-2020 15:45:39.590584,Desayunos · Helados,San Giorgio Gelateria,24300,3100,27400
14987,14988,21-10-2020 15:45:39.787136,Postres · Desayunos,Aury Postres - Comidas & Picadas,8900,4700,13600
14988,14989,21-10-2020 15:45:40.184202,Desayunos · Panadería,Premium Break Bakery,34500,3700,38200
14989,14990,21-10-2020 15:45:40.380071,Postres · Desayunos,Maltihelado,45800,4500,50300
14990,14991,21-10-2020 15:45:40.726561,Típica · Pescados y Mariscos,Arroces Mrg,13600,4300,17900
14991,14992,21-10-2020 15:45:41.123242,Saludable,Amor Propio saludable,65000,4000,69000
14992,14993,21-10-2020 15:45:41.519208,Parrilla,Arroces Maria Paula,13000,6800,19800
14993,14994,21-10-2020 15:45:41.765601,Postres · Desayunos,Maria Luisa - Postres,27800,4300,32100
14994,14995,21-10-2020 15:45:42.061603,Desayunos · Panadería,El Pan de Phillippe,27800,4600,32400
14995,14996,21-10-2020 15:45:42.357648,Desayunos,Bagel Shop,24200,3200,27400
14996,14997,21-10-2020 15:45:42.553635,Típica,Sabores De Mi Tierra,8900,5400,14300
14997,14998,21-10-2020 15:45:42.850016,Desayunos · Pescados y Mariscos,Gypsy Bistro,23000,4500,27500
14998,14999,21-10-2020 15:45:43.246620,Parrilla · Café,Gaira Café,53900,4400,58300
14999,15000,21-10-2020 15:45:43.593306,Sánduches · Pescados y Mariscos,Pacific Comida de Mar,24300,4000,28300
15000,15001,21-10-2020 15:45:43.939779,Sushi · Asiática,Tu Sushi,27800,6400,34200
15001,15002,21-10-2020 15:45:44.136268,Sushi · Asiática,Tu Sushi,15600,6400,22000
15002,15003,21-10-2020 15:45:44.282610,Saludable · Desayunos,Fresh Co,7500,5600,13100
15003,15004,21-10-2020 15:45:44.578560,Típica,La Olla de Barro,15000,5300,20300
15004,15005,21-10-2020 15:45:44.724357,Típica,Lo Nuestro,13000,3100,16100
15005,15006,21-10-2020 15:45:45.120824,Pescados y Mariscos,Pescadero Héroes del Mar,27800,6600,34400
15006,15007,21-10-2020 15:45:45.518098,Desayunos · Panadería,Choclofee,39700,4700,44400
15007,15008,21-10-2020 15:45:45.814211,Típica,Carbón & Mondongos,45800,6400,52200
15008,15009,21-10-2020 15:45:45.960191,Típica,Baondish,65000,5800,70800
15009,15010,21-10-2020 15:45:46.356583,Helados,Orso To Go,11870,6800,18670
15010,15011,21-10-2020 15:45:46.502370,Desayunos · Árabe,Boniato Sabores Vivos,65000,5300,70300
15011,15012,21-10-2020 15:45:46.748409,Postres,La Galeta,23000,3000,26000
15012,15013,21-10-2020 15:45:46.994747,Postres · Desayunos,Vivalight Market.,9000,6500,15500
15013,15014,21-10-2020 15:45:47.190815,Pollo · Desayunos,Caserito Gourmet,10700,6700,17400
15014,15015,21-10-2020 15:45:47.486736,Desayunos · Panadería,Choclofee,27800,4700,32500
15015,15016,21-10-2020 15:45:47.633059,Desayunos · Empanadas,Mis Delicias,15000,3200,18200
15016,15017,21-10-2020 15:45:47.979770,Saludable · Desayunos,La Cesta,24200,4700,28900
15017,15018,21-10-2020 15:45:48.225878,Postres · Desayunos,Sharmus,10700,6100,16800
15018,15019,21-10-2020 15:45:48.571841,Pollo · Pescados y Mariscos,Bang Bang Rice,13000,3400,16400
15019,15020,21-10-2020 15:45:48.868509,Desayunos,Cafetería el Kippe,12500,3200,15700
15020,15021,21-10-2020 15:45:49.265009,Pollo · Saludable,Gratina,31800,4200,36000
15021,15022,21-10-2020 15:45:49.461823,Postres,Beiked,23000,4000,27000
15022,15023,21-10-2020 15:45:49.608380,Desayunos · Café,Matchacha,15600,5900,21500
15023,15024,21-10-2020 15:45:49.754856,Sushi · Asiática,Tu Sushi,10700,6400,17100
15024,15025,21-10-2020 15:45:50.001241,Postres · Café,Celestino Café,8900,5900,14800
15025,15026,21-10-2020 15:45:50.347331,Desayunos,Butter,65000,6700,71700
15026,15027,21-10-2020 15:45:50.744749,Sushi,Umi,53900,5600,59500
15027,15028,21-10-2020 15:45:51.041571,Desayunos · Panadería,Limarys,15000,6500,21500
15028,15029,21-10-2020 15:45:51.438100,Pizza,Pizza Andante,24200,6300,30500
15029,15030,21-10-2020 15:45:51.834557,Desayunos · Pescados y Mariscos,Gypsy Bistro,15600,4500,20100
15030,15031,21-10-2020 15:45:52.180610,Saludable,The Good Rice Bowls,13600,3500,17100
15031,15032,21-10-2020 15:45:52.377322,Alta Cocina · Parrilla,Criterión,12500,6000,18500
15032,15033,21-10-2020 15:45:52.673480,Típica · Parrilla,El Portal de la Antigua,45800,5600,51400
15033,15034,21-10-2020 15:45:52.919583,Café · Helados,Sofia heladería y café,10700,5800,16500
15034,15035,21-10-2020 15:45:53.115564,Pollo · Sánduches,Pollos Century,13600,3000,16600
15035,15036,21-10-2020 15:45:53.462431,Postres · Desayunos,Sweet Tale,39700,5800,45500
15036,15037,21-10-2020 15:45:53.658483,Pollo,Heart & Cooking,48750,5000,53750
15037,15038,21-10-2020 15:45:53.954644,Desayunos · Típica,La Parrilla Dorada Polo,24200,6600,30800
15038,15039,21-10-2020 15:45:54.350838,Típica · Parrilla,El Santandereano,23000,5200,28200
15039,15040,21-10-2020 15:45:54.747177,Alta Cocina · Parrilla,Criterión,13600,6000,19600
15040,15041,21-10-2020 15:45:54.893330,Desayunos · Comida Rápida,La Veneca,12500,6300,18800
15041,15042,21-10-2020 15:45:55.289598,Desayunos · Panadería,Decofruta,8900,4700,13600
15042,15043,21-10-2020 15:45:55.685651,Desayunos · Panadería,Le Pain Quotidien,7500,3900,11400
15043,15044,21-10-2020 15:45:55.932739,Desayunos · Típica,D´Porco,8900,3900,12800
15044,15045,21-10-2020 15:45:56.279022,Desayunos · Típica,Calentao Express,23000,6000,29000
15045,15046,21-10-2020 15:45:56.626848,Desayunos · Típica,Criollomania,15600,5200,20800
15046,15047,21-10-2020 15:45:56.822841,Sushi,Canoa To Go,35000,5900,40900
15047,15048,21-10-2020 15:45:57.119081,Postres · Helados,Mahé,35000,6000,41000
15048,15049,21-10-2020 15:45:57.515336,Desayunos · Típica,Parrilla Farandula Típico,27800,5900,33700
15049,15050,21-10-2020 15:45:57.661731,Sushi,Canoa To Go,13000,5900,18900
15050,15051,21-10-2020 15:45:57.807890,Pollo · Saludable,Gratina,53900,4200,58100
15051,15052,21-10-2020 15:45:58.004293,Desayunos · Café,Frambas,35000,3400,38400
15052,15053,21-10-2020 15:45:58.350584,Crepes,San Crepes,15600,4900,20500
15053,15054,21-10-2020 15:45:58.596777,Saludable · Desayunos,Agua Dulce,23000,3700,26700
15054,15055,21-10-2020 15:45:58.892682,Pizza · Italiana,Piatto - Pizza,13600,6600,20200
15055,15056,21-10-2020 15:45:59.038603,Saludable · Desayunos,Copacabana Açai Bowls,45800,3000,48800
15056,15057,21-10-2020 15:45:59.285106,Panadería,Boul,23000,3100,26100
15057,15058,21-10-2020 15:45:59.581822,Postres · Desayunos,KOKOA & co.,17800,4700,22500
15058,15059,21-10-2020 15:45:59.778469,Postres · Desayunos,Maria Luisa - Postres,23000,4300,27300
15059,15060,21-10-2020 15:45:59.974634,Desayunos · Pescados y Mariscos,Luzí­a - Mediterranea,53400,5700,59100
15060,15061,21-10-2020 15:46:00.371063,Pescados y Mariscos,La Gran Cazuela,23000,3200,26200
15061,15062,21-10-2020 15:46:00.667251,Desayunos,Sunny Breakfast Brunch,34500,4300,38800
15062,15063,21-10-2020 15:46:00.813365,Pollo,Señor Fantástico,45800,4700,50500
15063,15064,21-10-2020 15:46:00.960036,Perros Calientes,Dog Shop - Rapida,27800,4900,32700
15064,15065,21-10-2020 15:46:01.357008,Pollo · Desayunos,Workzone,15000,3100,18100
15065,15066,21-10-2020 15:46:01.503607,Postres · Desayunos,BagBog Bagels,34500,6400,40900
15066,15067,21-10-2020 15:46:01.699825,Sushi,Umi,45800,5600,51400
15067,15068,21-10-2020 15:46:02.046817,Pollo,Oliva Va,29500,5600,35100
15068,15069,21-10-2020 15:46:02.443364,Postres · Café,Loló Coffee & Snacks,18900,4600,23500
15069,15070,21-10-2020 15:46:02.590109,Desayunos · Panadería,Juliana Restaurante,29500,6100,35600
15070,15071,21-10-2020 15:46:02.736098,Desayunos · Panadería,Premium Break Bakery,29500,3700,33200
15071,15072,21-10-2020 15:46:03.032737,Peruana,Uma Cantina Peruana,35000,3200,38200
15072,15073,21-10-2020 15:46:03.229038,Parrilla,OAK Ahumado y Brebajes,11870,6000,17870
15073,15074,21-10-2020 15:46:03.375394,Parrilla,OAK Ahumado y Brebajes,23000,6000,29000
15074,15075,21-10-2020 15:46:03.671803,Desayunos,El Fogón Castellano,53400,3200,56600
15075,15076,21-10-2020 15:46:04.018538,Típica · Parrilla,Toya,65000,4200,69200
15076,15077,21-10-2020 15:46:04.364808,Postres · Desayunos,BagBog Bagels,18900,6400,25300
15077,15078,21-10-2020 15:46:04.710914,Saludable,The Good Rice Bowls,39700,3500,43200
15078,15079,21-10-2020 15:46:05.107809,Desayunos · Típica,Fogón Sangileño,13600,5000,18600
15079,15080,21-10-2020 15:46:05.454724,Desayunos · Panadería,Decofruta,27800,4700,32500
15080,15081,21-10-2020 15:46:05.851215,Pollo · Desayunos,Candelina,70000,5300,75300
15081,15082,21-10-2020 15:46:05.998356,Desayunos · Típica,Peninsula Calentados y Parrilla,29500,3400,32900
15082,15083,21-10-2020 15:46:06.294610,Pescados y Mariscos,Pescadero Héroes del Mar,48750,6600,55350
15083,15084,21-10-2020 15:46:06.441296,Desayunos · Panadería,Juliana Restaurante,31800,6100,37900
15084,15085,21-10-2020 15:46:06.587432,Pizza,Pastas Laurentina,11870,4800,16670
15085,15086,21-10-2020 15:46:06.933926,Crepes,San Crepes,23000,4900,27900
15086,15087,21-10-2020 15:46:07.180053,Parrilla,Rústico Picadería,65000,3800,68800
15087,15088,21-10-2020 15:46:07.526802,Postres,Beiked,9000,4000,13000
15088,15089,21-10-2020 15:46:07.723504,Típica,Sabrosito,17800,4000,21800
15089,15090,21-10-2020 15:46:08.019622,Hamburguesas · Panadería,NYC Burgers,15000,6200,21200
15090,15091,21-10-2020 15:46:08.265963,Típica,Cazuelitas 93,7500,3900,11400
15091,15092,21-10-2020 15:46:08.612353,Típica · Parrilla,Typykos,35000,6000,41000
15092,15093,21-10-2020 15:46:09.008998,Postres · Desayunos,Buñuelos nacho,39700,6600,46300
15093,15094,21-10-2020 15:46:09.255619,Postres · Desayunos,Buñuelos nacho,8900,6600,15500
15094,15095,21-10-2020 15:46:09.552437,Postres · Desayunos,Aury Postres - Comidas & Picadas,23000,4700,27700
15095,15096,21-10-2020 15:46:09.898776,Pollo · Saludable,Tremenda Sal y Dulce,53400,6500,59900
15096,15097,21-10-2020 15:46:10.044835,Desayunos · Helados,San Giorgio Gelateria,53900,3100,57000
15097,15098,21-10-2020 15:46:10.441354,Típica,Salsig,12500,5600,18100
15098,15099,21-10-2020 15:46:10.787998,Típica · Pescados y Mariscos,Arroces Mrg,34500,4300,38800
15099,15100,21-10-2020 15:46:11.135690,Típica · Parrilla,Toya,23000,4200,27200
15100,15101,21-10-2020 15:46:11.532650,Típica,Sabrosito,23000,4000,27000
15101,15102,21-10-2020 15:46:11.679023,Pizza,Pastas Laurentina,37900,4800,42700
15102,15103,21-10-2020 15:46:11.975596,Desayunos,Jacinta Arepas de Huevo,37900,4000,41900
15103,15104,21-10-2020 15:46:12.172001,Saludable,The Good Rice Bowls,31800,3500,35300
15104,15105,21-10-2020 15:46:12.418587,Alta Cocina · Italiana,Trattoria de la Plaza,15600,6000,21600
15105,15106,21-10-2020 15:46:12.715271,Desayunos · Típica,Rojo Gourmet,53400,4700,58100
15106,15107,21-10-2020 15:46:13.111744,Parrilla,Arroces Maria Paula,23000,6800,29800
15107,15108,21-10-2020 15:46:13.408682,Alta Cocina · Italiana,Trattoria de la Plaza,23000,6000,29000
15108,15109,21-10-2020 15:46:13.555628,Desayunos,Sr Buñuelo,65000,6400,71400
15109,15110,21-10-2020 15:46:13.802282,Desayunos · Panadería,Le Pain Quotidien,35000,3900,38900
15110,15111,21-10-2020 15:46:14.098256,Peruana · Internacional,La Chifería,10700,6600,17300
15111,15112,21-10-2020 15:46:14.494905,Sánduches · China,Peru Mix,23000,5900,28900
15112,15113,21-10-2020 15:46:14.741380,Postres · Desayunos,Gelateria Da Favola,53400,6500,59900
15113,15114,21-10-2020 15:46:15.087756,Desayunos · Típica,Calentao Express,29500,6000,35500
15114,15115,21-10-2020 15:46:15.234374,Típica,Cabrito Santandereano,48750,6600,55350
15115,15116,21-10-2020 15:46:15.631216,Desayunos · Típica,Cochon,29500,3300,32800
15116,15117,21-10-2020 15:46:15.827484,Desayunos,El Fogón Castellano,65000,3200,68200
15117,15118,21-10-2020 15:46:15.974063,Desayunos · Empanadas,Mis Delicias,17800,3200,21000
15118,15119,21-10-2020 15:46:16.120274,Hamburguesas,Gofi Burger,29500,5100,34600
15119,15120,21-10-2020 15:46:16.418242,Postres · Desayunos,Jacques Pastelería,35000,5900,40900
15120,15121,21-10-2020 15:46:16.615109,Desayunos,Archies Desayunos,11870,3100,14970
15121,15122,21-10-2020 15:46:17.011553,Desayunos · Panadería,Artesanos,9000,4300,13300
15122,15123,21-10-2020 15:46:17.158149,Desayunos · Típica,Casa Vieja,48750,6000,54750
15123,15124,21-10-2020 15:46:17.554776,Saludable · Desayunos,Copacabana Açai Bowls,45800,3000,48800
15124,15125,21-10-2020 15:46:17.751340,Sushi,Kim Pop,39700,5400,45100
15125,15126,21-10-2020 15:46:18.047849,Postres · Helados,Mahé,35000,6000,41000
15126,15127,21-10-2020 15:46:18.394779,Postres · Desayunos,KOKOA & co.,8900,4700,13600
15127,15128,21-10-2020 15:46:18.691162,Postres · Desayunos,Restaurante Cornelia,17800,5500,23300
15128,15129,21-10-2020 15:46:18.837778,Típica,Juan Chorizo,35000,3900,38900
15129,15130,21-10-2020 15:46:19.084555,Típica · Parrilla,Mi Ranchito Parrilla,9000,4400,13400
15130,15131,21-10-2020 15:46:19.281044,Desayunos · Típica,Casa Vieja,23000,6000,29000
15131,15132,21-10-2020 15:46:19.628119,Parrilla,Coquitas,15600,5600,21200
15132,15133,21-10-2020 15:46:19.975126,Desayunos · Italiana,Rceta By Rausch,34500,3600,38100
15133,15134,21-10-2020 15:46:20.171785,Panadería,Boul,11870,3100,14970
15134,15135,21-10-2020 15:46:20.568395,Sushi,Kim Pop,24200,5400,29600
15135,15136,21-10-2020 15:46:20.814536,Panadería,Boul,31800,3100,34900
15136,15137,21-10-2020 15:46:21.161507,Mexicana,Mexicanachos,53900,3900,57800
15137,15138,21-10-2020 15:46:21.459409,Sushi · Desayunos,Maki Roll,24200,4300,28500
15138,15139,21-10-2020 15:46:21.855861,Típica · Pescados y Mariscos,La Vitualla,29500,6300,35800
15139,15140,21-10-2020 15:46:22.103553,Postres · Saludable,Ana Rebana,53900,6300,60200
15140,15141,21-10-2020 15:46:22.301364,Desayunos,Archies Desayunos,45800,3100,48900
15141,15142,21-10-2020 15:46:22.698465,Típica,Cazuelitas 93,24300,3900,28200
15142,15143,21-10-2020 15:46:22.845013,Peruana,Uma Cantina Peruana,13000,3200,16200
15143,15144,21-10-2020 15:46:23.141694,Pollo · Desayunos,Piaf,39700,6500,46200
15144,15145,21-10-2020 15:46:23.489287,Desayunos · Parrilla,Mi Patria,70000,4600,74600
15145,15146,21-10-2020 15:46:23.885933,Desayunos · Panadería,Siena Café,35000,3700,38700
15146,15147,21-10-2020 15:46:24.282871,Mexicana,Mexicanachos,11870,3900,15770
15147,15148,21-10-2020 15:46:24.630042,Postres · Saludable,Ana Rebana,24300,6300,30600
15148,15149,21-10-2020 15:46:24.826955,Café · Helados,Sofia heladería y café,27800,5800,33600
15149,15150,21-10-2020 15:46:24.973839,Sushi,Kim Pop,35000,5400,40400
15150,15151,21-10-2020 15:46:25.370860,Desayunos,Cafetería el Kippe,37900,3200,41100
15151,15152,21-10-2020 15:46:25.517873,Postres · Desayunos,Restaurante Cornelia,13600,5500,19100
15152,15153,21-10-2020 15:46:25.665037,Típica,La Cocina,15600,4600,20200
15153,15154,21-10-2020 15:46:26.062073,Helados,Orso To Go,45800,6800,52600
15154,15155,21-10-2020 15:46:26.208751,Postres,Levelma,37900,6200,44100
15155,15156,21-10-2020 15:46:26.556672,Desayunos · Panadería,Choclofee,45800,4700,50500
15156,15157,21-10-2020 15:46:26.803489,Saludable · Desayunos,Bawana - Sandwich,37900,3400,41300
15157,15158,21-10-2020 15:46:26.949975,Postres · Desayunos,Aury Postres - Comidas & Picadas,31800,4700,36500
15158,15159,21-10-2020 15:46:27.096522,Desayunos · Italiana,Rceta By Rausch,23000,3600,26600
15159,15160,21-10-2020 15:46:27.493298,Pollo · Saludable,Tremenda Sal y Dulce,24200,6500,30700
15160,15161,21-10-2020 15:46:27.839813,Pizza,Pastas Laurentina,48750,4800,53550
15161,15162,21-10-2020 15:46:28.236766,Saludable · Parrilla,Box,12500,3700,16200
15162,15163,21-10-2020 15:46:28.634229,Típica,Lo Nuestro,29500,3100,32600
15163,15164,21-10-2020 15:46:28.880730,Desayunos · Panadería,Pasteleite,29500,5900,35400
15164,15165,21-10-2020 15:46:29.277620,Típica · Pescados y Mariscos,La Vitualla,15600,6300,21900
15165,15166,21-10-2020 15:46:29.524180,Postres · Helados,Mahé,15000,6000,21000
15166,15167,21-10-2020 15:46:29.670825,Desayunos · Helados,San Giorgio Gelateria,11870,3100,14970
15167,15168,21-10-2020 15:46:29.866766,Típica · Pescados y Mariscos,La Vitualla,31800,6300,38100
15168,15169,21-10-2020 15:46:30.113375,Saludable · Jugos y Batidos,Berdes Drinks & Salads,27800,3500,31300
15169,15170,21-10-2020 15:46:30.410649,Postres,Levelma,37900,6200,44100
15170,15171,21-10-2020 15:46:30.757780,Típica · Pescados y Mariscos,Arroces Mrg,15000,4300,19300
15171,15172,21-10-2020 15:46:30.904208,Parrilla,El Tambor,48750,6800,55550
15172,15173,21-10-2020 15:46:31.050572,Parrilla,Campocina,13000,4600,17600
15173,15174,21-10-2020 15:46:31.247129,Típica,La Herencia,65000,5900,70900
15174,15175,21-10-2020 15:46:31.594750,Saludable · Desayunos,Básico y elemental,48750,5000,53750
15175,15176,21-10-2020 15:46:31.891106,Alta Cocina · Postres,La Pinta,15000,4500,19500
15176,15177,21-10-2020 15:46:32.287820,Pizza,Pizza Andante,7500,6300,13800
15177,15178,21-10-2020 15:46:32.634800,Postres · Saludable,Ana Rebana,53400,6300,59700
15178,15179,21-10-2020 15:46:32.881178,Postres · Desayunos,Maltihelados,7500,6200,13700
15179,15180,21-10-2020 15:46:33.027656,Crepes,La Chabatta,35000,5900,40900
15180,15181,21-10-2020 15:46:33.324675,Postres · Desayunos,Amelie Helados,48750,6400,55150
15181,15182,21-10-2020 15:46:33.521405,Perros Calientes,Dog Shop - Rapida,65000,4900,69900
15182,15183,21-10-2020 15:46:33.867998,Sánduches · Pescados y Mariscos,Pacific Comida de Mar,53400,4000,57400
15183,15184,21-10-2020 15:46:34.164858,Saludable,Puro Verde,70000,5700,75700
15184,15185,21-10-2020 15:46:34.412134,Postres · Desayunos,Maria Luisa - Postres,37900,4300,42200
15185,15186,21-10-2020 15:46:34.808993,Postres · Desayunos,Buñuelos nacho,70000,6600,76600
15186,15187,21-10-2020 15:46:34.955245,Saludable · Desayunos,Básico y elemental,18900,5000,23900
15187,15188,21-10-2020 15:46:35.352632,Desayunos · Panadería,Limarys,15600,6500,22100
15188,15189,21-10-2020 15:46:35.699331,Saludable,Amor Propio saludable,70000,4000,74000
15189,15190,21-10-2020 15:46:36.068464,Pollo · Saludable,Yerbabuena,45800,3900,49700
15190,15191,21-10-2020 15:46:36.316633,Saludable · Desayunos,Bon Eat - Saludable,13600,4800,18400
15191,15192,21-10-2020 15:46:36.463513,Desayunos · Típica,La Frijolada,13600,4500,18100
15192,15193,21-10-2020 15:46:36.660926,Pollo,Chicken House,48750,4200,52950
15193,15194,21-10-2020 15:46:36.907521,Postres · Desayunos,Café Quindio,12500,5700,18200
15194,15195,21-10-2020 15:46:37.304527,Saludable · Típica,Sopas Mrg,31800,3100,34900
15195,15196,21-10-2020 15:46:37.601899,Mexicana,Mexicanachos,35000,3900,38900
15196,15197,21-10-2020 15:46:37.898703,Saludable · Parrilla,Box,13600,3700,17300
15197,15198,21-10-2020 15:46:38.145629,Postres · Desayunos,Maltihelados,24300,6200,30500
15198,15199,21-10-2020 15:46:38.442809,Pizza,pizza andante,23000,4200,27200
15199,15200,21-10-2020 15:46:38.789911,Postres · Panadería,RIGHT AWAY FOODS,13600,6600,20200
15200,15201,21-10-2020 15:46:39.186670,Desayunos · Típica,Fogón Sangileño,15600,5000,20600
15201,15202,21-10-2020 15:46:39.384132,Típica · Parrilla,Toya,9000,4200,13200
15202,15203,21-10-2020 15:46:39.581606,Típica · Parrilla,El Santandereano,23000,5200,28200
15203,15204,21-10-2020 15:46:39.878241,Desayunos,El Corral - Desayunos,34500,5000,39500
15204,15205,21-10-2020 15:46:40.125443,Parrilla · Internacional,Taperia de la Plaza,18900,5700,24600
15205,15206,21-10-2020 15:46:40.472784,Desayunos · Panadería,El Pan de Phillippe,8900,4600,13500
15206,15207,21-10-2020 15:46:40.869469,Típica,Sopitas y Más,23000,4200,27200
15207,15208,21-10-2020 15:46:41.166193,Pollo · Desayunos,Piaf,18900,6500,25400
15208,15209,21-10-2020 15:46:41.362772,Desayunos · Típica,La Frijolada,53400,4500,57900
15209,15210,21-10-2020 15:46:41.609763,Desayunos · Café,Matchacha,13600,5900,19500
15210,15211,21-10-2020 15:46:41.907761,Típica · Parrilla,Mi Ranchito Parrilla,11870,4400,16270
15211,15212,21-10-2020 15:46:42.254812,Desayunos · Panadería,Limarys,39700,6500,46200
15212,15213,21-10-2020 15:46:42.401553,Desayunos · Café,El Gualilo,29500,6200,35700
15213,15214,21-10-2020 15:46:42.798573,Sánduches,Submarin,45800,3800,49600
15214,15215,21-10-2020 15:46:43.095371,Desayunos · Típica,Rojo Gourmet,9000,4700,13700
15215,15216,21-10-2020 15:46:43.442304,Parrilla,OAK Ahumado y Brebajes,23000,6000,29000
15216,15217,21-10-2020 15:46:43.789241,Desayunos · Parrilla,Mi Patria,29500,4600,34100
15217,15218,21-10-2020 15:46:44.085887,Sushi · Desayunos,Maki Roll,24300,4300,28600
15218,15219,21-10-2020 15:46:44.282326,China,China Food Col,15000,3600,18600
15219,15220,21-10-2020 15:46:44.579084,Típica · Parrilla,La Ternera Parrilla,45800,5200,51000
15220,15221,21-10-2020 15:46:44.776189,Pollo,Chicken House,23000,4200,27200
15221,15222,21-10-2020 15:46:45.022852,Típica,Campo Victoria,37900,3000,40900
15222,15223,21-10-2020 15:46:45.319728,Pizza,Pastas Laurentina,65000,4800,69800
15223,15224,21-10-2020 15:46:45.616815,Desayunos,Don Leo,11870,6000,17870
15224,15225,21-10-2020 15:46:45.913510,Desayunos · Panadería,Decofruta,34500,4700,39200
15225,15226,21-10-2020 15:46:46.060485,Típica,Sopitas y Más,12500,4200,16700
15226,15227,21-10-2020 15:46:46.307806,Café · Helados,Sofia heladería y café,13600,5800,19400
15227,15228,21-10-2020 15:46:46.655287,Hamburguesas · Saludable,Restaurant Inn,39700,6100,45800
15228,15229,21-10-2020 15:46:46.902730,Desayunos · Panadería,Artesanos,13600,4300,17900
15229,15230,21-10-2020 15:46:47.250311,Café · Helados,Sofia heladería y café,65000,5800,70800
15230,15231,21-10-2020 15:46:47.597571,Peruana · Internacional,La Chifería,23000,6600,29600
15231,15232,21-10-2020 15:46:47.844777,Típica,Sabores De Mi Tierra,39700,5400,45100
15232,15233,21-10-2020 15:46:48.142143,Desayunos,Desayunos en Bogotá,15600,3400,19000
15233,15234,21-10-2020 15:46:48.439654,Desayunos · Panadería,Choclofee,35000,4700,39700
15234,15235,21-10-2020 15:46:48.736605,Saludable · Desayunos,Raices Bienestar Gourmet,13000,6600,19600
15235,15236,21-10-2020 15:46:49.083665,Pollo · Saludable,Tremenda Sal y Dulce,48750,6500,55250
15236,15237,21-10-2020 15:46:49.280576,Saludable · Desayunos,Malú,15600,3700,19300
15237,15238,21-10-2020 15:46:49.477354,Pescados y Mariscos,Fish Place - Del Mar,29500,5400,34900
15238,15239,21-10-2020 15:46:49.774137,Peruana,Masivo,29500,5800,35300
15239,15240,21-10-2020 15:46:49.920671,Postres · Desayunos,Vivalight Market.,18900,6500,25400
15240,15241,21-10-2020 15:46:50.317700,Desayunos · Panadería,Decofruta,35000,4700,39700
15241,15242,21-10-2020 15:46:50.664828,Desayunos · Panadería,Choclofee,9000,4700,13700
15242,15243,21-10-2020 15:46:51.011672,Pollo · Desayunos,Caserito Gourmet,11870,6700,18570
15243,15244,21-10-2020 15:46:51.158814,Postres · Desayunos,Café Quindio,24300,5700,30000
15244,15245,21-10-2020 15:46:51.505814,Italiana,Bocatto Di Passo,8900,5000,13900
15245,15246,21-10-2020 15:46:51.802703,Postres · Desayunos,La Folie - Postres,13600,3300,16900
15246,15247,21-10-2020 15:46:52.000739,Café · Helados,Sofia heladería y café,45800,5800,51600
15247,15248,21-10-2020 15:46:52.347863,Desayunos · Típica,Parrilla Farandula Típico,34500,5900,40400
15248,15249,21-10-2020 15:46:52.544579,Sánduches · China,Peru Mix,35000,5900,40900
15249,15250,21-10-2020 15:46:52.941340,Desayunos · Panadería,Juliana Restaurante,53900,6100,60000
15250,15251,21-10-2020 15:46:53.138676,Desayunos · Empanadas,Empanadas Doraditas.com,35000,3000,38000
15251,15252,21-10-2020 15:46:53.436392,Desayunos · Panadería,Artesanos,53400,4300,57700
15252,15253,21-10-2020 15:46:53.583538,Desayunos,Fratelli - Desayunos,23000,4600,27600
15253,15254,21-10-2020 15:46:53.780435,Pollo · Saludable,Tremenda Sal y Dulce,39700,6500,46200
15254,15255,21-10-2020 15:46:54.077281,Alta Cocina · Parrilla,Criterión,45800,6000,51800
15255,15256,21-10-2020 15:46:54.274218,Saludable · Desayunos,Re.al Alimentos Reales,15000,4000,19000
15256,15257,21-10-2020 15:46:54.520896,Parrilla,Rústico Picadería,23000,3800,26800
15257,15258,21-10-2020 15:46:54.867953,Postres · Desayunos,BagBog Bagels,18900,6400,25300
15258,15259,21-10-2020 15:46:55.215134,Postres · Desayunos,Cosmo Cookies,31800,5900,37700
15259,15260,21-10-2020 15:46:55.512154,Saludable · Desayunos,Bawana - Sandwich,7500,3400,10900
15260,15261,21-10-2020 15:46:55.859555,Saludable,Hanai - Bowls Saludables,48750,5900,54650
15261,15262,21-10-2020 15:46:56.256758,Típica,Campo Victoria,53400,3000,56400
15262,15263,21-10-2020 15:46:56.603926,Pollo · Desayunos,Caserito Gourmet,70000,6700,76700
15263,15264,21-10-2020 15:46:56.750849,Típica,Sabores De Mi Tierra,9000,5400,14400
15264,15265,21-10-2020 15:46:56.897519,Postres · Desayunos,Maltihelados,18900,6200,25100
15265,15266,21-10-2020 15:46:57.194828,Desayunos · Sánduches,Frutos del Bosque,24200,3500,27700
15266,15267,21-10-2020 15:46:57.591853,Pizza,18 Scalini,9000,4300,13300
15267,15268,21-10-2020 15:46:57.788636,Parrilla · Internacional,Taperia de la Plaza,24200,5700,29900
15268,15269,21-10-2020 15:46:58.135735,Sushi,Canoa To Go,29500,5900,35400
15269,15270,21-10-2020 15:46:58.332564,Desayunos · Típica,Papadió - Colombianas,23000,5700,28700
15270,15271,21-10-2020 15:46:58.479205,Postres · Desayunos,Buñuelos nacho,37900,6600,44500
15271,15272,21-10-2020 15:46:58.826594,Crepes,San Crepes,11870,4900,16770
15272,15273,21-10-2020 15:46:59.023293,Postres,La Galeta,12500,3000,15500
15273,15274,21-10-2020 15:46:59.370673,Comida Rápida,Fiesta Digital Andrés,10700,3100,13800
15274,15275,21-10-2020 15:46:59.667910,Hamburguesas · Pescados y Mariscos,El Velero,9000,6500,15500
15275,15276,21-10-2020 15:46:59.865368,Típica,El Mondongo y Mucho Mas,53400,5600,59000
15276,15277,21-10-2020 15:47:00.212414,Desayunos · Mexicana,La Mera Mera - Mexicana,53400,3100,56500
15277,15278,21-10-2020 15:47:00.359289,Desayunos,Archies Desayunos,11870,3100,14970
15278,15279,21-10-2020 15:47:00.506164,Postres · Desayunos,Cosmo Cookies,13600,5900,19500
15279,15280,21-10-2020 15:47:00.903308,Hamburguesas,Bendito Cordero,35000,5800,40800
15280,15281,21-10-2020 15:47:01.199860,Postres,Beiked,15600,4000,19600
15281,15282,21-10-2020 15:47:01.497278,Postres · Desayunos,Maltihelado,31800,4500,36300
15282,15283,21-10-2020 15:47:01.844306,Desayunos · Panadería,Le Pain Quotidien,13000,3900,16900
15283,15284,21-10-2020 15:47:01.991423,Desayunos · Pescados y Mariscos,Luzí­a - Mediterranea,7500,5700,13200
15284,15285,21-10-2020 15:47:02.239758,Sushi,Umi,29500,5600,35100
15285,15286,21-10-2020 15:47:02.386743,Pollo · Desayunos,Candelina,8900,5300,14200
15286,15287,21-10-2020 15:47:02.583739,Sánduches,Submarin,29500,3800,33300
15287,15288,21-10-2020 15:47:02.981096,Desayunos · Panadería,Choclofee,17800,4700,22500
15288,15289,21-10-2020 15:47:03.178012,Desayunos · Típica,Parrilla Farandula Típico,24300,5900,30200
15289,15290,21-10-2020 15:47:03.575644,Desayunos · Panadería,Choclofee,23000,4700,27700
15290,15291,21-10-2020 15:47:03.923156,Internacional,La Esquina con Sabor Parrilla,37900,3000,40900
15291,15292,21-10-2020 15:47:04.070123,Desayunos · Café,Matchacha,24200,5900,30100
15292,15293,21-10-2020 15:47:04.317019,Desayunos · Panadería,Artesanos,35000,4300,39300
15293,15294,21-10-2020 15:47:04.563915,Desayunos,El Corral - Desayunos,23000,5000,28000
15294,15295,21-10-2020 15:47:04.810903,Típica,Juan Chorizo,23000,3900,26900
15295,15296,21-10-2020 15:47:05.158881,Pollo · Pescados y Mariscos,Bang Bang Rice,53400,3400,56800
15296,15297,21-10-2020 15:47:05.455814,Postres · Desayunos,Gelateria Da Favola,37900,6500,44400
15297,15298,21-10-2020 15:47:05.853507,Postres · Desayunos,Café Quindio,18900,5700,24600
15298,15299,21-10-2020 15:47:06.200551,Hamburguesas,Burger Society,8900,4100,13000
15299,15300,21-10-2020 15:47:06.398265,Saludable,The Good Rice Bowls,53400,3500,56900
15300,15301,21-10-2020 15:47:06.795509,Desayunos · Sánduches,Frutos del Bosque,35000,3500,38500
15301,15302,21-10-2020 15:47:06.942972,Pollo · Típica,Auyama,35000,3900,38900
15302,15303,21-10-2020 15:47:07.341904,Pollo · Saludable,Yerbabuena,7500,3900,11400
15303,15304,21-10-2020 15:47:07.489890,Desayunos · Helados,San Giorgio Gelateria,65000,3100,68100
15304,15305,21-10-2020 15:47:07.687484,Alta Cocina · Parrilla,Criterión,9000,6000,15000
15305,15306,21-10-2020 15:47:08.035200,Pollo · Saludable,Tremenda Sal y Dulce,11870,6500,18370
15306,15307,21-10-2020 15:47:08.283037,Pizza · Italiana,Piatto - Pizza,35000,6600,41600
15307,15308,21-10-2020 15:47:08.531653,Parrilla,Beraca Parrilla Bbq,9000,5600,14600
15308,15309,21-10-2020 15:47:08.779642,Típica · Parrilla,El Portal de la Antigua,53400,5600,59000
15309,15310,21-10-2020 15:47:09.177655,Pollo · Desayunos,Abasto,10700,3600,14300
15310,15311,21-10-2020 15:47:09.575708,Mexicana,La leyenda mexican kitchen,8900,3200,12100
15311,15312,21-10-2020 15:47:09.873311,Postres · Desayunos,Jacques Pastelería,53900,5900,59800
15312,15313,21-10-2020 15:47:10.020507,Típica · Parrilla,Typykos,24200,6000,30200
15313,15314,21-10-2020 15:47:10.318457,Típica,Cazuelitas 93,12500,3900,16400
15314,15315,21-10-2020 15:47:10.615126,Postres,Levelma,31800,6200,38000
15315,15316,21-10-2020 15:47:10.962405,Desayunos · Italiana,Rceta By Rausch,13600,3600,17200
15316,15317,21-10-2020 15:47:11.259779,Saludable · Parrilla,Box,29500,3700,33200
15317,15318,21-10-2020 15:47:11.507219,Desayunos · Típica,Papadió - Colombianas,8900,5700,14600
15318,15319,21-10-2020 15:47:11.754465,Desayunos · Pescados y Mariscos,Gypsy Bistro,37900,4500,42400
15319,15320,21-10-2020 15:47:12.001235,Desayunos · Típica,Fogón Sangileño,10700,5000,15700
15320,15321,21-10-2020 15:47:12.349232,Desayunos · Panadería,Premium Break Bakery,48750,3700,52450
15321,15322,21-10-2020 15:47:12.746814,Desayunos,Jacinta Arepas de Huevo,10700,4000,14700
15322,15323,21-10-2020 15:47:13.043523,Postres · Desayunos,Amelie Helados,18900,6400,25300
15323,15324,21-10-2020 15:47:13.441032,Pollo · Saludable,Gratina,15600,4200,19800
15324,15325,21-10-2020 15:47:13.688141,Postres · Desayunos,Cosmo Cookies,24200,5900,30100
15325,15326,21-10-2020 15:47:14.035152,Parrilla,Campocina,18900,4600,23500
15326,15327,21-10-2020 15:47:14.432856,Desayunos · Sánduches,Frutos del Bosque,29500,3500,33000
15327,15328,21-10-2020 15:47:14.630088,Desayunos · Típica,Peninsula Calentados y Parrilla,45800,3400,49200
15328,15329,21-10-2020 15:47:14.977521,Desayunos · Panadería,Santa Juana Food Bar,45800,5900,51700
15329,15330,21-10-2020 15:47:15.374694,Desayunos,Butter,15600,6700,22300
15330,15331,21-10-2020 15:47:15.772159,Desayunos · Sánduches,Danilo Colombia,48750,3300,52050
15331,15332,21-10-2020 15:47:16.169391,Desayunos · Típica,Peninsula Calentados y Parrilla,23000,3400,26400
15332,15333,21-10-2020 15:47:16.416719,Alta Cocina · Postres,La Pinta,27800,4500,32300
15333,15334,21-10-2020 15:47:16.563657,Postres · Desayunos,Protein Bakes,18900,5900,24800
15334,15335,21-10-2020 15:47:16.760800,Desayunos · Típica,Calentao Express,27800,6000,33800
15335,15336,21-10-2020 15:47:16.908095,Saludable,The Good Rice Bowls,35000,3500,38500
15336,15337,21-10-2020 15:47:17.205210,Sushi · Desayunos,Maki Roll,45800,4300,50100
15337,15338,21-10-2020 15:47:17.352766,Típica,Sabrosito,13000,4000,17000
15338,15339,21-10-2020 15:47:17.549719,Desayunos,Sunny Breakfast Brunch,8900,4300,13200
15339,15340,21-10-2020 15:47:17.696662,Postres · Desayunos,Maria Luisa - Postres,15000,4300,19300
15340,15341,21-10-2020 15:47:17.843540,Desayunos · Panadería,Pasteleite,45800,5900,51700
15341,15342,21-10-2020 15:47:18.240753,Típica · Parrilla,La Ternera Parrilla,23000,5200,28200
15342,15343,21-10-2020 15:47:18.487760,Desayunos · Típica,Rojo Gourmet,27800,4700,32500
15343,15344,21-10-2020 15:47:18.785456,Postres · Café,Celestino Café,65000,5900,70900
15344,15345,21-10-2020 15:47:19.132672,Asiática,Thai Station,39700,6000,45700
15345,15346,21-10-2020 15:47:19.530041,Postres · Desayunos,Sharmus,7500,6100,13600
15346,15347,21-10-2020 15:47:19.827341,Pollo,Heart & Cooking,13000,5000,18000
15347,15348,21-10-2020 15:47:20.175142,Desayunos · Café,Matchacha,18900,5900,24800
15348,15349,21-10-2020 15:47:20.322408,Saludable,Puro Verde,18900,5700,24600
15349,15350,21-10-2020 15:47:20.720469,Postres · Desayunos,KOKOA & co.,29500,4700,34200
15350,15351,21-10-2020 15:47:20.968372,Típica · Parrilla,El Portal de la Antigua,39700,5600,45300
15351,15352,21-10-2020 15:47:21.166543,Parrilla,Carnes la Zarza,7500,4900,12400
15352,15353,21-10-2020 15:47:21.564724,Desayunos · Jugos y Batidos,Dont Be Hungry,31800,5600,37400
15353,15354,21-10-2020 15:47:21.712332,Postres · Desayunos,Restaurante Cornelia,65000,5500,70500
15354,15355,21-10-2020 15:47:21.910228,Desayunos · Internacional,Camilia,9000,3900,12900
15355,15356,21-10-2020 15:47:22.158217,Típica,Sopitas y Más,70000,4200,74200
15356,15357,21-10-2020 15:47:22.356360,Helados,Buon Gelato,15000,4400,19400
15357,15358,21-10-2020 15:47:22.654044,Café · Helados,Sofia heladería y café,17800,5800,23600
15358,15359,21-10-2020 15:47:22.801709,Desayunos · Café,Frambas,53900,3400,57300
15359,15360,21-10-2020 15:47:23.149497,Mexicana,Cantina La 15,27800,4300,32100
15360,15361,21-10-2020 15:47:23.548258,Saludable,Ventura Soup y Salad,35000,3800,38800
15361,15362,21-10-2020 15:47:23.746660,Saludable · Típica,Saludable Mrg,15600,5800,21400
15362,15363,21-10-2020 15:47:24.044291,Mexicana,Cantina La 15,35000,4300,39300
15363,15364,21-10-2020 15:47:24.292017,Desayunos · Típica,Parrilla Farandula Típico,35000,5900,40900
15364,15365,21-10-2020 15:47:24.639448,Típica · Parrilla,La Ternera Parrilla,39700,5200,44900
15365,15366,21-10-2020 15:47:25.037318,Desayunos · Café,Moramia,29500,4700,34200
15366,15367,21-10-2020 15:47:25.185459,Desayunos · Panadería,Choclofee,39700,4700,44400
15367,15368,21-10-2020 15:47:25.483108,Hamburguesas · Panadería,NYC Burgers,7500,6200,13700
15368,15369,21-10-2020 15:47:25.830517,Desayunos · Sánduches,Danilo Colombia,13000,3300,16300
15369,15370,21-10-2020 15:47:25.977660,Internacional,Rio Sabores y Experiencias,65000,4100,69100
15370,15371,21-10-2020 15:47:26.375070,Crepes,San Crepes,7500,4900,12400
15371,15372,21-10-2020 15:47:26.672201,Pollo · Saludable,Gratina,18900,4200,23100
15372,15373,21-10-2020 15:47:26.918980,Desayunos,Butter,35000,6700,41700
15373,15374,21-10-2020 15:47:27.166619,Desayunos · Café,Matchacha,35000,5900,40900
15374,15375,21-10-2020 15:47:27.313912,Asiática,Thai Station,23000,6000,29000
15375,15376,21-10-2020 15:47:27.713002,Parrilla,Parrilla Pimentón,65000,3400,68400
15376,15377,21-10-2020 15:47:28.060844,Alta Cocina · Postres,La Pinta,9000,4500,13500
15377,15378,21-10-2020 15:47:28.458480,Desayunos · Panadería,Decofruta,7500,4700,12200
15378,15379,21-10-2020 15:47:28.656025,Típica,La Cocina,13600,4600,18200
15379,15380,21-10-2020 15:47:28.903196,Pollo · Pescados y Mariscos,Bang Bang Rice,23000,3400,26400
15380,15381,21-10-2020 15:47:29.099749,Típica · Parrilla,Toya,13000,4200,17200
15381,15382,21-10-2020 15:47:29.347017,Desayunos,Jacinta Arepas de Huevo,35000,4000,39000
15382,15383,21-10-2020 15:47:29.744132,Desayunos · Panadería,Choclofee,15600,4700,20300
15383,15384,21-10-2020 15:47:29.991549,Hamburguesas · Panadería,NYC Burgers,37900,6200,44100
15384,15385,21-10-2020 15:47:30.288842,Desayunos · Típica,Parrilla Farandula Típico,23000,5900,28900
15385,15386,21-10-2020 15:47:30.536173,Postres · Desayunos,Buñuelos nacho,15600,6600,22200
15386,15387,21-10-2020 15:47:30.683581,Pizza,Pastas Laurentina,10700,4800,15500
15387,15388,21-10-2020 15:47:30.831450,Típica,Campo Victoria,7500,3000,10500
15388,15389,21-10-2020 15:47:31.178651,Típica,La Olla de Barro,23000,5300,28300
15389,15390,21-10-2020 15:47:31.475928,Asiática,TeT,15600,5900,21500
15390,15391,21-10-2020 15:47:31.723134,China,China Food Col,39700,3600,43300
15391,15392,21-10-2020 15:47:32.070650,Saludable · Desayunos,Libre de Culpa,17800,4000,21800
15392,15393,21-10-2020 15:47:32.267797,Poke,Poke Go,39700,4600,44300
15393,15394,21-10-2020 15:47:32.415381,Desayunos · Panadería,Juliana Restaurante,9000,6100,15100
15394,15395,21-10-2020 15:47:32.814320,Típica · Parrilla,Typykos,70000,6000,76000
15395,15396,21-10-2020 15:47:32.961664,Desayunos · Jugos y Batidos,Dont Be Hungry,24300,5600,29900
15396,15397,21-10-2020 15:47:33.159090,Típica,Cazuelitas 93,12500,3900,16400
15397,15398,21-10-2020 15:47:33.356293,Típica · Pescados y Mariscos,Arroces Mrg,11870,4300,16170
15398,15399,21-10-2020 15:47:33.553727,Parrilla,Arepaisa de Medellín,11870,5600,17470
15399,15400,21-10-2020 15:47:33.851797,Postres · Desayunos,Protein Bakes,29500,5900,35400
15400,15401,21-10-2020 15:47:34.150038,Asiática,TeT,29500,5900,35400
15401,15402,21-10-2020 15:47:34.448053,Típica · Parrilla,Typykos,39700,6000,45700
15402,15403,21-10-2020 15:47:34.745911,Saludable · Típica,Saludable Mrg,70000,5800,75800
15403,15404,21-10-2020 15:47:35.144168,Postres,Beiked,17800,4000,21800
15404,15405,21-10-2020 15:47:35.491903,Peruana,Uma Cantina Peruana,24200,3200,27400
15405,15406,21-10-2020 15:47:35.889431,Pollo,Oliva Va,23000,5600,28600
15406,15407,21-10-2020 15:47:36.087195,Saludable,Puro Verde,48750,5700,54450
15407,15408,21-10-2020 15:47:36.385032,Saludable · Típica,Sopas Mrg,65000,3100,68100
15408,15409,21-10-2020 15:47:36.782788,Pollo · Desayunos,Abasto,29500,3600,33100
15409,15410,21-10-2020 15:47:37.080225,Típica,Carbón & Mondongos,31800,6400,38200
15410,15411,21-10-2020 15:47:37.477835,Parrilla,Restaurante Bar Mi Ranchito,18900,5200,24100
15411,15412,21-10-2020 15:47:37.775604,Pollo · Desayunos,Candelina,65000,5300,70300
15412,15413,21-10-2020 15:47:37.924208,Desayunos · Café,Libertario Coffee Roasters,53900,4600,58500
15413,15414,21-10-2020 15:47:38.222321,Pizza,Pastas Laurentina,12500,4800,17300
15414,15415,21-10-2020 15:47:38.620274,Postres · Desayunos,Maria Luisa - Postres,27800,4300,32100
15415,15416,21-10-2020 15:47:38.967851,Hamburguesas,Gofi Burger,13600,5100,18700
15416,15417,21-10-2020 15:47:39.165795,Típica,Carbón & Mondongos,29500,6400,35900
15417,15418,21-10-2020 15:47:39.513106,Sánduches · China,Peru Mix,8900,5900,14800
15418,15419,21-10-2020 15:47:39.860270,Postres · Café,Celestino Café,53900,5900,59800
15419,15420,21-10-2020 15:47:40.207792,Pescados y Mariscos,Fish Place - Del Mar,31800,5400,37200
15420,15421,21-10-2020 15:47:40.555171,Postres,La Galeta,12500,3000,15500
15421,15422,21-10-2020 15:47:40.802357,Saludable · Desayunos,Copacabana Açai Bowls,7500,3000,10500
15422,15423,21-10-2020 15:47:40.999223,Saludable,Hanai - Bowls Saludables,23000,5900,28900
15423,15424,21-10-2020 15:47:41.246590,Saludable · Desayunos,Bawana - Sandwich,70000,3400,73400
15424,15425,21-10-2020 15:47:41.443898,Desayunos · Típica,La Frijolada,8900,4500,13400
15425,15426,21-10-2020 15:47:41.742686,Típica,Baondish,13000,5800,18800
15426,15427,21-10-2020 15:47:42.140246,Típica,Carbón & Mondongos,24300,6400,30700
15427,15428,21-10-2020 15:47:42.337532,Hamburguesas,Bendito Cordero,37900,5800,43700
15428,15429,21-10-2020 15:47:42.684980,Desayunos · Pescados y Mariscos,Gypsy Bistro,45800,4500,50300
15429,15430,21-10-2020 15:47:43.032319,Postres · Desayunos,Sweet Tale,34500,5800,40300
15430,15431,21-10-2020 15:47:43.379393,Desayunos,Butter,29500,6700,36200
15431,15432,21-10-2020 15:47:43.727093,Típica · Parrilla,Parrilla Farandula Gourmet,8900,5100,14000
15432,15433,21-10-2020 15:47:43.924357,Sushi · Asiática,Arigato,29500,5300,34800
15433,15434,21-10-2020 15:47:44.121604,Desayunos · Comida Rápida,Chocolatto,8900,3400,12300
15434,15435,21-10-2020 15:47:44.368657,Pizza,Pizza Andante,24300,6300,30600
15435,15436,21-10-2020 15:47:44.566987,Postres · Café,Loló Coffee & Snacks,70000,4600,74600
15436,15437,21-10-2020 15:47:44.714319,Pollo · Pescados y Mariscos,Bang Bang Rice,31800,3400,35200
15437,15438,21-10-2020 15:47:44.861548,Jugos y Batidos,Pomponio,53400,3600,57000
15438,15439,21-10-2020 15:47:45.209148,Típica · Pescados y Mariscos,La Vitualla,13000,6300,19300
15439,15440,21-10-2020 15:47:45.356669,Típica · Pescados y Mariscos,La Vitualla,70000,6300,76300
15440,15441,21-10-2020 15:47:45.553879,Pollo,Señor Fantástico,53400,4700,58100
15441,15442,21-10-2020 15:47:45.751632,Pescados y Mariscos,Pescadero Héroes del Mar,39700,6600,46300
15442,15443,21-10-2020 15:47:45.999279,Desayunos · Panadería,Limarys,27800,6500,34300
15443,15444,21-10-2020 15:47:46.247292,Pizza,18 Scalini,10700,4300,15000
15444,15445,21-10-2020 15:47:46.644915,Sánduches · China,Peru Mix,35000,5900,40900
15445,15446,21-10-2020 15:47:46.793198,Saludable · Desayunos,Copacabana Açai Bowls,13600,3000,16600
15446,15447,21-10-2020 15:47:47.191267,Parrilla,El Tambor,23000,6800,29800
15447,15448,21-10-2020 15:47:47.388417,Peruana · Internacional,La Chifería,9000,6600,15600
15448,15449,21-10-2020 15:47:47.736353,Desayunos · Típica,Parrilla Farandula Típico,8900,5900,14800
15449,15450,21-10-2020 15:47:47.984128,Saludable,Amor Propio saludable,35000,4000,39000
15450,15451,21-10-2020 15:47:48.331506,Postres · Desayunos,Jacques Pastelería,29500,5900,35400
15451,15452,21-10-2020 15:47:48.579147,Sánduches · Pescados y Mariscos,Pacific Comida de Mar,35000,4000,39000
15452,15453,21-10-2020 15:47:48.726518,Postres · Desayunos,Protein Bakes,31800,5900,37700
15453,15454,21-10-2020 15:47:49.074109,Típica · Parrilla,La Ternera Parrilla,29500,5200,34700
15454,15455,21-10-2020 15:47:49.471565,Postres · Desayunos,Jacques Pastelería,53400,5900,59300
15455,15456,21-10-2020 15:47:49.718958,Parrilla,Campocina,29500,4600,34100
15456,15457,21-10-2020 15:47:50.116500,Desayunos · Panadería,Choclofee,37900,4700,42600
15457,15458,21-10-2020 15:47:50.414229,Pizza · Italiana,Piatto - Pizza,23000,6600,29600
15458,15459,21-10-2020 15:47:50.661531,Pizza,18 Scalini,23000,4300,27300
15459,15460,21-10-2020 15:47:50.959136,Típica,El Mondongo y Mucho Mas,23000,5600,28600
15460,15461,21-10-2020 15:47:51.106333,Saludable · Desayunos,Maracuyá,12500,6700,19200
15461,15462,21-10-2020 15:47:51.353842,Desayunos · Panadería,Decofruta,23000,4700,27700
15462,15463,21-10-2020 15:47:51.601072,Desayunos · Panadería,El Pan de Phillippe,31800,4600,36400
15463,15464,21-10-2020 15:47:51.999348,Desayunos,Señor Desayuno,10700,6800,17500
15464,15465,21-10-2020 15:47:52.396864,Desayunos · Típica,La Frijolada,9000,4500,13500
15465,15466,21-10-2020 15:47:52.594011,Pizza,Pastas Laurentina,29500,4800,34300
15466,15467,21-10-2020 15:47:52.841317,Pollo,Oliva Va,9000,5600,14600
15467,15468,21-10-2020 15:47:53.088205,Sushi · Asiática,Arigato,8900,5300,14200
15468,15469,21-10-2020 15:47:53.385785,Desayunos · Panadería,El Pan de Phillippe,24300,4600,28900
15469,15470,21-10-2020 15:47:53.583213,Postres · Desayunos,La Folie - Postres,29500,3300,32800
15470,15471,21-10-2020 15:47:53.931114,Mexicana,Hidalgo Taquería,24300,4900,29200
15471,15472,21-10-2020 15:47:54.329156,Saludable · Desayunos,Fresh Co,53400,5600,59000
15472,15473,21-10-2020 15:47:54.526888,Saludable · Desayunos,Bawana - Sandwich,24300,3400,27700
15473,15474,21-10-2020 15:47:54.924563,Hamburguesas · Desayunos,El Inglés Gastro Pub,13000,6600,19600
15474,15475,21-10-2020 15:47:55.222544,Saludable · Desayunos,Básico y elemental,31800,5000,36800
15475,15476,21-10-2020 15:47:55.420408,Típica,Cabrito Santandereano,48750,6600,55350
15476,15477,21-10-2020 15:47:55.818049,Saludable · Desayunos,Guadalupe - Fruteria,39700,5900,45600
15477,15478,21-10-2020 15:47:56.115793,Desayunos · Panadería,Artesanos,53400,4300,57700
15478,15479,21-10-2020 15:47:56.263627,Hamburguesas · Desayunos,El Inglés Gastro Pub,53400,6600,60000
15479,15480,21-10-2020 15:47:56.411553,China,China Food Col,37900,3600,41500
15480,15481,21-10-2020 15:47:56.609836,Pescados y Mariscos,Fish Place - Del Mar,53900,5400,59300
15481,15482,21-10-2020 15:47:56.957461,Desayunos · Panadería,Siena Café,34500,3700,38200
15482,15483,21-10-2020 15:47:57.355254,Pollo,Señor Fantástico,53900,4700,58600
15483,15484,21-10-2020 15:47:57.652797,Saludable · Típica,Sopas Mrg,17800,3100,20900
15484,15485,21-10-2020 15:47:58.050246,Parrilla,Carnes la Zarza,24300,4900,29200
15485,15486,21-10-2020 15:47:58.397973,Saludable · Desayunos,La Cesta,31800,4700,36500
15486,15487,21-10-2020 15:47:58.695487,Desayunos · Café,Norma's Ice Cream Café,11870,6300,18170
15487,15488,21-10-2020 15:47:58.892445,Saludable,Puro Verde,53400,5700,59100
15488,15489,21-10-2020 15:47:59.140096,Postres · Desayunos,Jacques Pastelería,29500,5900,35400
15489,15490,21-10-2020 15:47:59.487922,Desayunos,Desayunos en Bogotá,65000,3400,68400
15490,15491,21-10-2020 15:47:59.735366,Pizza · Italiana,Piatto - Pizza,13000,6600,19600
15491,15492,21-10-2020 15:47:59.932937,Crepes,La Chabatta,24200,5900,30100
15492,15493,21-10-2020 15:48:00.129997,Alta Cocina · Italiana,Trattoria de la Plaza,35000,6000,41000
15493,15494,21-10-2020 15:48:00.527619,Saludable · Desayunos,Fresh Co,7500,5600,13100
15494,15495,21-10-2020 15:48:00.775264,Sushi · Desayunos,Maki Roll,18900,4300,23200
15495,15496,21-10-2020 15:48:01.123508,Pollo · China,China Tao,24200,3500,27700
15496,15497,21-10-2020 15:48:01.271198,Típica,El Mondongo y Mucho Mas,11870,5600,17470
15497,15498,21-10-2020 15:48:01.518785,Sushi · Asiática,Arigato,15000,5300,20300
15498,15499,21-10-2020 15:48:01.816486,Saludable,Puro Verde,12500,5700,18200
15499,15500,21-10-2020 15:48:02.064403,Pollo · Desayunos,Candelina,31800,5300,37100
15500,15501,21-10-2020 15:48:02.312357,Desayunos · Típica,La Parrilla Dorada Polo,13000,6600,19600
15501,15502,21-10-2020 15:48:02.561340,Saludable,The Good Rice Bowls,53900,3500,57400
15502,15503,21-10-2020 15:48:02.959688,Parrilla,Antojo a Domicilio,12500,5000,17500
15503,15504,21-10-2020 15:48:03.207714,Pollo · Desayunos,Caserito Gourmet,35000,6700,41700
15504,15505,21-10-2020 15:48:03.555781,Helados,Orso To Go,15000,6800,21800
15505,15506,21-10-2020 15:48:03.803778,Sushi,Sushi Reel,29500,4700,34200
15506,15507,21-10-2020 15:48:04.201748,Hamburguesas · Panadería,NYC Burgers,23000,6200,29200
15507,15508,21-10-2020 15:48:04.499550,Típica · Parrilla,El Portal de la Antigua,45800,5600,51400
15508,15509,21-10-2020 15:48:04.797634,Desayunos · Típica,Rojo Gourmet,8900,4700,13600
15509,15510,21-10-2020 15:48:05.145615,Desayunos · Café,vereda central calle 99,24300,5700,30000
15510,15511,21-10-2020 15:48:05.443263,Saludable · Desayunos,Libre de Culpa,31800,4000,35800
15511,15512,21-10-2020 15:48:05.641194,Desayunos,Fratelli - Desayunos,35000,4600,39600
15512,15513,21-10-2020 15:48:05.838644,Crepes,La Chabatta,15000,5900,20900
15513,15514,21-10-2020 15:48:06.136893,Desayunos · Típica,Casa Vieja,70000,6000,76000
15514,15515,21-10-2020 15:48:06.485208,Desayunos · Panadería,Juliana Restaurante,65000,6100,71100
15515,15516,21-10-2020 15:48:06.632925,Parrilla,El Tambor,13000,6800,19800
15516,15517,21-10-2020 15:48:06.881202,Sushi · Desayunos,Maki Roll,35000,4300,39300
15517,15518,21-10-2020 15:48:07.028879,Parrilla,Parrilla Pimentón,39700,3400,43100
15518,15519,21-10-2020 15:48:07.427272,Parrilla,Rústico Picadería,10700,3800,14500
15519,15520,21-10-2020 15:48:07.776331,Saludable · Desayunos,Raices Bienestar Gourmet,35000,6600,41600
15520,15521,21-10-2020 15:48:08.074341,Asiática,TeT,53900,5900,59800
15521,15522,21-10-2020 15:48:08.271841,Peruana,Masivo,11870,5800,17670
15522,15523,21-10-2020 15:48:08.469976,Pollo · Desayunos,Caserito Gourmet,65000,6700,71700
15523,15524,21-10-2020 15:48:08.618110,Saludable,Amor Propio saludable,34500,4000,38500
15524,15525,21-10-2020 15:48:08.765918,Sushi,Kim Pop,29500,5400,34900
15525,15526,21-10-2020 15:48:09.013619,Saludable · Desayunos,Copacabana Açai Bowls,34500,3000,37500
15526,15527,21-10-2020 15:48:09.211183,Sushi,Kim Pop,23000,5400,28400
15527,15528,21-10-2020 15:48:09.409161,Desayunos · Típica,Alce,37900,4900,42800
15528,15529,21-10-2020 15:48:09.806982,Desayunos · Típica,D'Porco - Lechona,10700,6300,17000
15529,15530,21-10-2020 15:48:09.954124,Desayunos · Café,Norma's Ice Cream Café,13600,6300,19900
15530,15531,21-10-2020 15:48:10.302246,Desayunos · Típica,Cochon,35000,3300,38300
15531,15532,21-10-2020 15:48:10.650348,Parrilla,OAK Ahumado y Brebajes,53400,6000,59400
15532,15533,21-10-2020 15:48:10.998185,Pollo,Chicken House,35000,4200,39200
15533,15534,21-10-2020 15:48:11.296829,Mexicana,La leyenda mexican kitchen,35000,3200,38200
15534,15535,21-10-2020 15:48:11.544452,Postres,Toledo Pastelería,8900,6800,15700
15535,15536,21-10-2020 15:48:11.841955,Pollo · Típica,Auyama,35000,3900,38900
15536,15537,21-10-2020 15:48:12.089428,Asiática,Thai Station,35000,6000,41000
15537,15538,21-10-2020 15:48:12.337411,Típica · Parrilla,La Ternera Parrilla,13600,5200,18800
15538,15539,21-10-2020 15:48:12.535167,Desayunos · Panadería,Premium Break Bakery,39700,3700,43400
15539,15540,21-10-2020 15:48:12.883902,Hamburguesas · Panadería,NYC Burgers,12500,6200,18700
15540,15541,21-10-2020 15:48:13.231744,Desayunos · Típica,Calentao Express,70000,6000,76000
15541,15542,21-10-2020 15:48:13.479639,Pollo · Saludable,Gratina,23000,4200,27200
15542,15543,21-10-2020 15:48:13.827281,Saludable · Desayunos,Fresh Co,7500,5600,13100
15543,15544,21-10-2020 15:48:13.975090,Saludable · Desayunos,Guadalupe - Fruteria,34500,5900,40400
15544,15545,21-10-2020 15:48:14.122930,Saludable · Desayunos,Re.al Alimentos Reales,12500,4000,16500
15545,15546,21-10-2020 15:48:14.370297,Hamburguesas · Saludable,Restaurant Inn,39700,6100,45800
15546,15547,21-10-2020 15:48:14.718291,Hamburguesas,Gofi Burger,24300,5100,29400
15547,15548,21-10-2020 15:48:15.116732,Pescados y Mariscos,La Gran Cazuela,7500,3200,10700
15548,15549,21-10-2020 15:48:15.464930,Típica,El Mondongo y Mucho Mas,18900,5600,24500
15549,15550,21-10-2020 15:48:15.713177,Parrilla,Antojo a Domicilio,48750,5000,53750
15550,15551,21-10-2020 15:48:15.910827,Sánduches,Submarin,35000,3800,38800
15551,15552,21-10-2020 15:48:16.259362,Parrilla,Restaurante Bar Mi Ranchito,18900,5200,24100
15552,15553,21-10-2020 15:48:16.607821,Sushi,Canoa To Go,48750,5900,54650
15553,15554,21-10-2020 15:48:16.755765,Típica · Pescados y Mariscos,La Vitualla,15600,6300,21900
15554,15555,21-10-2020 15:48:17.153532,Pizza · Italiana,Piatto - Pizza,8900,6600,15500
15555,15556,21-10-2020 15:48:17.351165,Postres · Desayunos,Maltihelados,35000,6200,41200
15556,15557,21-10-2020 15:48:17.698919,Desayunos · Típica,Calentao Express,10700,6000,16700
15557,15558,21-10-2020 15:48:17.846350,Saludable · Desayunos,Fresh Co,70000,5600,75600
15558,15559,21-10-2020 15:48:18.044626,Desayunos · Comida Rápida,Chocolatto,31800,3400,35200
15559,15560,21-10-2020 15:48:18.192407,Desayunos,Sunny Breakfast Brunch,8900,4300,13200
15560,15561,21-10-2020 15:48:18.440178,Pollo · Pescados y Mariscos,Bang Bang Rice,37900,3400,41300
15561,15562,21-10-2020 15:48:18.638285,Desayunos,Señor Desayuno,39700,6800,46500
15562,15563,21-10-2020 15:48:19.036023,Típica,Sabores De Mi Tierra,70000,5400,75400
15563,15564,21-10-2020 15:48:19.183642,Postres · Desayunos,Sweet Tale,65000,5800,70800
15564,15565,21-10-2020 15:48:19.531723,Desayunos · Panadería,Pasteleite,35000,5900,40900
15565,15566,21-10-2020 15:48:19.829462,Pizza,18 Scalini,15000,4300,19300
15566,15567,21-10-2020 15:48:19.977346,Postres · Desayunos,Gelateria Da Favola,10700,6500,17200
15567,15568,21-10-2020 15:48:20.174850,Sushi · Asiática,Tu Sushi,23000,6400,29400
15568,15569,21-10-2020 15:48:20.322668,Desayunos · Empanadas,Mis Delicias,70000,3200,73200
15569,15570,21-10-2020 15:48:20.720704,Parrilla,Parrilla Pimentón,13000,3400,16400
15570,15571,21-10-2020 15:48:21.018503,Saludable · Típica,Sopas Mrg,39700,3100,42800
15571,15572,21-10-2020 15:48:21.216215,Desayunos · Panadería,Premium Break Bakery,35000,3700,38700
15572,15573,21-10-2020 15:48:21.514381,Saludable,The Good Rice Bowls,27800,3500,31300
15573,15574,21-10-2020 15:48:21.762366,Parrilla,Beraca Parrilla Bbq,65000,5600,70600
15574,15575,21-10-2020 15:48:22.060301,Pollo · Saludable,Yerbabuena,11870,3900,15770
15575,15576,21-10-2020 15:48:22.308188,Desayunos,Don Leo,18900,6000,24900
15576,15577,21-10-2020 15:48:22.605944,Postres · Café,Loló Coffee & Snacks,53400,4600,58000
15577,15578,21-10-2020 15:48:22.954837,Saludable,MIMA,23000,3700,26700
15578,15579,21-10-2020 15:48:23.303983,Saludable · Desayunos,Básico y elemental,27800,5000,32800
15579,15580,21-10-2020 15:48:23.602695,China,China Food Col,31800,3600,35400
15580,15581,21-10-2020 15:48:23.801109,Desayunos · Panadería,El Pan de Phillippe,70000,4600,74600
15581,15582,21-10-2020 15:48:23.949495,Saludable · Desayunos,La Estampilla,18900,6000,24900
15582,15583,21-10-2020 15:48:24.196998,Saludable · Desayunos,Bon Eat - Saludable,35000,4800,39800
15583,15584,21-10-2020 15:48:24.344714,Hamburguesas,Burger Society,23000,4100,27100
15584,15585,21-10-2020 15:48:24.542257,Desayunos · Típica,Criollomania,39700,5200,44900
15585,15586,21-10-2020 15:48:24.789915,Pizza,pizza andante,65000,4200,69200
15586,15587,21-10-2020 15:48:24.937372,Desayunos · Pescados y Mariscos,Luzí­a - Mediterranea,24200,5700,29900
15587,15588,21-10-2020 15:48:25.285567,Desayunos · Jugos y Batidos,Frutiwow,18900,4100,23000
15588,15589,21-10-2020 15:48:25.633560,Hamburguesas,Burger Society,37900,4100,42000
15589,15590,21-10-2020 15:48:25.880931,Desayunos · Café,Libertario Coffee Roasters,8900,4600,13500
15590,15591,21-10-2020 15:48:26.028783,Desayunos,Sunny Breakfast Brunch,8900,4300,13200
15591,15592,21-10-2020 15:48:26.376828,Saludable · Jugos y Batidos,Berdes Drinks & Salads,24200,3500,27700
15592,15593,21-10-2020 15:48:26.574493,Típica · Parrilla,Parrilla Farandula Gourmet,53900,5100,59000
15593,15594,21-10-2020 15:48:26.821981,Alta Cocina · Italiana,Trattoria de la Plaza,35000,6000,41000
15594,15595,21-10-2020 15:48:27.169899,Desayunos · Típica,La Frijolada,48750,4500,53250
15595,15596,21-10-2020 15:48:27.368400,Desayunos · Jugos y Batidos,Dont Be Hungry,9000,5600,14600
15596,15597,21-10-2020 15:48:27.666332,Desayunos · Comida Rápida,La Veneca,35000,6300,41300
15597,15598,21-10-2020 15:48:27.964532,Pollo,Heart & Cooking,13600,5000,18600
15598,15599,21-10-2020 15:48:28.162474,Parrilla,OAK Ahumado y Brebajes,65000,6000,71000
15599,15600,21-10-2020 15:48:28.561024,Típica,Sabores De Mi Tierra,15000,5400,20400
15600,15601,21-10-2020 15:48:28.758980,Postres · Desayunos,Restaurante Cornelia,10700,5500,16200
15601,15602,21-10-2020 15:48:29.107108,Hamburguesas,Bendito Cordero,35000,5800,40800
15602,15603,21-10-2020 15:48:29.355382,Parrilla,Arroces Maria Paula,17800,6800,24600
15603,15604,21-10-2020 15:48:29.553413,Parrilla,Coquitas,48750,5600,54350
15604,15605,21-10-2020 15:48:29.951421,Típica,Cazuelitas 93,11870,3900,15770
15605,15606,21-10-2020 15:48:30.299658,Saludable · Parrilla,The Angels Grill and Drinks,13600,6200,19800
15606,15607,21-10-2020 15:48:30.697986,Desayunos · Típica,Parrilla Farandula Típico,15600,5900,21500
15607,15608,21-10-2020 15:48:30.846778,Hamburguesas · Alitas,Beer,9000,6600,15600
15608,15609,21-10-2020 15:48:31.094493,Mexicana,Cantina La 15,11870,4300,16170
15609,15610,21-10-2020 15:48:31.342261,Desayunos · Típica,Alce,27800,4900,32700
15610,15611,21-10-2020 15:48:31.740361,Desayunos,Jacinta Arepas de Huevo,12500,4000,16500
15611,15612,21-10-2020 15:48:31.938165,Típica,Sopitas y Más,29500,4200,33700
15612,15613,21-10-2020 15:48:32.336261,Desayunos · Pescados y Mariscos,Gypsy Bistro,70000,4500,74500
15613,15614,21-10-2020 15:48:32.584292,Postres · Desayunos,Amelie Helados,70000,6400,76400
15614,15615,21-10-2020 15:48:32.732167,Desayunos · Jugos y Batidos,Kuriwaji,9000,6300,15300
15615,15616,21-10-2020 15:48:32.980011,Postres · Desayunos,BagBog Bagels,35000,6400,41400
15616,15617,21-10-2020 15:48:33.128328,Crepes,La Chabatta,53400,5900,59300
15617,15618,21-10-2020 15:48:33.276293,Típica,Sabrosito,17800,4000,21800
15618,15619,21-10-2020 15:48:33.474705,Típica,Salsig,15600,5600,21200
15619,15620,21-10-2020 15:48:33.823491,Mexicana,La leyenda mexican kitchen,45800,3200,49000
15620,15621,21-10-2020 15:48:34.221804,Típica,Sopitas y Más,23000,4200,27200
15621,15622,21-10-2020 15:48:34.470143,Postres · Café,Celestino Café,23000,5900,28900
15622,15623,21-10-2020 15:48:34.618297,Saludable · Desayunos,Copacabana Açai Bowls,8900,3000,11900
15623,15624,21-10-2020 15:48:34.766164,Hamburguesas · Saludable,Restaurant Inn,24200,6100,30300
15624,15625,21-10-2020 15:48:35.064103,Postres · Panadería,RIGHT AWAY FOODS,7500,6600,14100
15625,15626,21-10-2020 15:48:35.361646,Pizza,pizza andante,13000,4200,17200
15626,15627,21-10-2020 15:48:35.559888,Postres · Desayunos,Restaurante Cornelia,13600,5500,19100
15627,15628,21-10-2020 15:48:35.707972,Desayunos · Pescados y Mariscos,Luzí­a - Mediterranea,13600,5700,19300
15628,15629,21-10-2020 15:48:36.055720,Pizza · Italiana,Piatto - Pizza,17800,6600,24400
15629,15630,21-10-2020 15:48:36.203516,Saludable,Puro Verde,70000,5700,75700
15630,15631,21-10-2020 15:48:36.501723,Pollo · China,China Tao,53900,3500,57400
15631,15632,21-10-2020 15:48:36.849686,Pollo · Desayunos,Abasto,39700,3600,43300
15632,15633,21-10-2020 15:48:37.047411,Desayunos · Internacional,Camilia,13600,3900,17500
15633,15634,21-10-2020 15:48:37.245837,Desayunos · Panadería,Limarys,35000,6500,41500
15634,15635,21-10-2020 15:48:37.543639,Típica · Parrilla,Typykos,15000,6000,21000
15635,15636,21-10-2020 15:48:37.691548,Hamburguesas · Desayunos,El Inglés Gastro Pub,13600,6600,20200
15636,15637,21-10-2020 15:48:38.089982,Postres · Desayunos,Gelateria Da Favola,13000,6500,19500
15637,15638,21-10-2020 15:48:38.488220,Desayunos · Típica,Desayunadero de la 42,15600,5900,21500
15638,15639,21-10-2020 15:48:38.837790,Saludable,A2manos,53400,4200,57600
15639,15640,21-10-2020 15:48:39.185604,Pollo · Saludable,Gratina,65000,4200,69200
15640,15641,21-10-2020 15:48:39.383818,Desayunos · Típica,Desayunadero de la 42,11870,5900,17770
15641,15642,21-10-2020 15:48:39.531969,Desayunos · Típica,90 Calentados,24300,3700,28000
15642,15643,21-10-2020 15:48:39.830219,Saludable,MIMA,37900,3700,41600
15643,15644,21-10-2020 15:48:40.228477,Pizza · Parrilla,Urban Lunch,39700,4000,43700
15644,15645,21-10-2020 15:48:40.426490,Postres · Café,Celestino Café,17800,5900,23700
15645,15646,21-10-2020 15:48:40.624952,Parrilla,Rústico Picadería,24300,3800,28100
15646,15647,21-10-2020 15:48:40.822832,Desayunos · Típica,D´Porco,37900,3900,41800
15647,15648,21-10-2020 15:48:41.020456,Desayunos · Típica,Calentao Express,27800,6000,33800
15648,15649,21-10-2020 15:48:41.218562,Desayunos · Panadería,Decofruta,34500,4700,39200
15649,15650,21-10-2020 15:48:41.417410,Típica · Parrilla,Typykos,70000,6000,76000
15650,15651,21-10-2020 15:48:41.665885,Pollo · Desayunos,Abasto,35000,3600,38600
15651,15652,21-10-2020 15:48:41.863663,Pollo · China,China Tao,10700,3500,14200
15652,15653,21-10-2020 15:48:42.112020,Típica · Parrilla,Typykos,13000,6000,19000
15653,15654,21-10-2020 15:48:42.460446,Postres,Toledo Pastelería,11870,6800,18670
15654,15655,21-10-2020 15:48:42.709033,Mexicana,Hidalgo Taquería,10700,4900,15600
15655,15656,21-10-2020 15:48:42.957515,Desayunos · Típica,Cochon,45800,3300,49100
15656,15657,21-10-2020 15:48:43.305839,Pollo · Pescados y Mariscos,Bang Bang Rice,11870,3400,15270
15657,15658,21-10-2020 15:48:43.503831,Típica · Parrilla,Typykos,23000,6000,29000
15658,15659,21-10-2020 15:48:43.802132,Hamburguesas,Gofi Burger,13600,5100,18700
15659,15660,21-10-2020 15:48:44.050168,Típica,La Olla de Barro,18900,5300,24200
15660,15661,21-10-2020 15:48:44.248094,Internacional,Rio Sabores y Experiencias,8900,4100,13000
15661,15662,21-10-2020 15:48:44.446280,Internacional,La Esquina con Sabor Parrilla,23000,3000,26000
15662,15663,21-10-2020 15:48:44.743875,Hamburguesas,Bendito Cordero,24300,5800,30100
15663,15664,21-10-2020 15:48:44.992104,Desayunos · Sánduches,Garnish,27800,5200,33000
15664,15665,21-10-2020 15:48:45.190244,Saludable · Desayunos,Básico y Elemental,24300,5900,30200
15665,15666,21-10-2020 15:48:45.488268,Desayunos · Panadería,Limarys,23000,6500,29500
15666,15667,21-10-2020 15:48:45.686222,Desayunos · Comida Rápida,Chocolatto,15600,3400,19000
15667,15668,21-10-2020 15:48:46.084405,Postres · Desayunos,Restaurante Cornelia,23000,5500,28500
15668,15669,21-10-2020 15:48:46.232343,Típica,Cabrito Santandereano,53400,6600,60000
15669,15670,21-10-2020 15:48:46.630878,Pescados y Mariscos,Pescadero Héroes del Mar,7500,6600,14100
15670,15671,21-10-2020 15:48:46.979156,Desayunos,Señor Desayuno,7500,6800,14300
15671,15672,21-10-2020 15:48:47.177375,Saludable · Parrilla,Box,65000,3700,68700
15672,15673,21-10-2020 15:48:47.374977,Pollo · Desayunos,Caserito Gourmet,37900,6700,44600
15673,15674,21-10-2020 15:48:47.723707,Desayunos,Cafetería el Kippe,13600,3200,16800
15674,15675,21-10-2020 15:48:48.022488,Desayunos · Típica,Criollomania,9000,5200,14200
15675,15676,21-10-2020 15:48:48.320836,Típica,Sabrosito,13600,4000,17600
15676,15677,21-10-2020 15:48:48.568421,Parrilla,Rústico Picadería,13000,3800,16800
15677,15678,21-10-2020 15:48:48.766854,Típica,Sopitas y Más,23000,4200,27200
15678,15679,21-10-2020 15:48:48.916292,Peruana · Internacional,La Chifería,11870,6600,18470
15679,15680,21-10-2020 15:48:49.065041,Postres · Desayunos,Cosmo Cookies,48750,5900,54650
15680,15681,21-10-2020 15:48:49.363209,Desayunos · Café,Moramia,31800,4700,36500
15681,15682,21-10-2020 15:48:49.661386,Postres,La Galeta,29500,3000,32500
15682,15683,21-10-2020 15:48:49.959668,Saludable · Típica,Sopas Mrg,23000,3100,26100
15683,15684,21-10-2020 15:48:50.257543,Desayunos · Panadería,Siena Café,35000,3700,38700
15684,15685,21-10-2020 15:48:50.405983,Saludable · Desayunos,Raices Bienestar Gourmet,48750,6600,55350
15685,15686,21-10-2020 15:48:50.654428,Panadería,Boul,7500,3100,10600
15686,15687,21-10-2020 15:48:51.052689,China,China Food Col,15000,3600,18600
15687,15688,21-10-2020 15:48:51.350920,Saludable,Puro Verde,24300,5700,30000
15688,15689,21-10-2020 15:48:51.549037,Desayunos · Panadería,Premium Break Bakery,9000,3700,12700
15689,15690,21-10-2020 15:48:51.846877,Saludable · Típica,Sopas Mrg,17800,3100,20900
15690,15691,21-10-2020 15:48:52.245502,Saludable · Típica,Saludable Mrg,34500,5800,40300
15691,15692,21-10-2020 15:48:52.393490,Saludable,Ventura Soup y Salad,13600,3800,17400
15692,15693,21-10-2020 15:48:52.541610,Desayunos · Café,Libertario Coffee Roasters,45800,4600,50400
15693,15694,21-10-2020 15:48:52.889581,Pollo · Desayunos,Piaf,39700,6500,46200
15694,15695,21-10-2020 15:48:53.137837,Desayunos · Panadería,Choclofee,45800,4700,50500
15695,15696,21-10-2020 15:48:53.436482,Pizza · Parrilla,Urban Lunch,29500,4000,33500
15696,15697,21-10-2020 15:48:53.684806,Internacional,La Esquina con Sabor Parrilla,23000,3000,26000
15697,15698,21-10-2020 15:48:53.832856,Típica,La Herencia,24200,5900,30100
15698,15699,21-10-2020 15:48:54.181992,Saludable · Desayunos,Bon Eat - Saludable,35000,4800,39800
15699,15700,21-10-2020 15:48:54.330386,Desayunos · Jugos y Batidos,Frutiwow,37900,4100,42000
15700,15701,21-10-2020 15:48:54.529001,Postres,La Tertulia,70000,3400,73400
15701,15702,21-10-2020 15:48:54.878480,Sushi,Canoa To Go,8900,5900,14800
15702,15703,21-10-2020 15:48:55.177034,Desayunos · Café,Libertario Coffee Roasters,35000,4600,39600
15703,15704,21-10-2020 15:48:55.525333,Saludable · Desayunos,Fresh Co,53900,5600,59500
15704,15705,21-10-2020 15:48:55.873369,Mexicana,Hidalgo Taquería,24300,4900,29200
15705,15706,21-10-2020 15:48:56.071664,Pollo,Heart & Cooking,35000,5000,40000
15706,15707,21-10-2020 15:48:56.270110,Pizza,Pizza Andante,9000,6300,15300
15707,15708,21-10-2020 15:48:56.469281,Típica,La Cocina,8900,4600,13500
15708,15709,21-10-2020 15:48:56.719117,Típica · Pescados y Mariscos,La Vitualla,53400,6300,59700
15709,15710,21-10-2020 15:48:56.917991,Desayunos · Café,Frambas,17800,3400,21200
15710,15711,21-10-2020 15:48:57.066519,Postres · Desayunos,Café Quindio,23000,5700,28700
15711,15712,21-10-2020 15:48:57.215916,Hamburguesas · Pescados y Mariscos,El Velero,53400,6500,59900
15712,15713,21-10-2020 15:48:57.415242,Típica,Salsig,23000,5600,28600
15713,15714,21-10-2020 15:48:57.563662,Desayunos · Café,El Gualilo,13000,6200,19200
15714,15715,21-10-2020 15:48:57.862338,Sánduches · China,Peru Mix,31800,5900,37700
15715,15716,21-10-2020 15:48:58.261711,Pollo · China,China Tao,24300,3500,27800
15716,15717,21-10-2020 15:48:58.410650,Crepes,San Crepes,31800,4900,36700
15717,15718,21-10-2020 15:48:58.559297,Desayunos · Típica,La Parrilla Dorada Polo,10700,6600,17300
15718,15719,21-10-2020 15:48:58.708463,Pollo · Desayunos,Caserito Gourmet,34500,6700,41200
15719,15720,21-10-2020 15:48:58.957505,Desayunos · Típica,90 Calentados,23000,3700,26700
15720,15721,21-10-2020 15:48:59.358370,Mexicana,La leyenda mexican kitchen,53900,3200,57100
15721,15722,21-10-2020 15:48:59.557403,Desayunos · Jugos y Batidos,Dont Be Hungry,48750,5600,54350
15722,15723,21-10-2020 15:48:59.856295,Desayunos · Café,Moramia,13000,4700,17700
15723,15724,21-10-2020 15:49:00.256677,Sushi,Canoa To Go,10700,5900,16600
15724,15725,21-10-2020 15:49:00.655934,Postres · Desayunos,Cosmo Cookies,24200,5900,30100
15725,15726,21-10-2020 15:49:00.804461,Desayunos · Café,El Gualilo,9000,6200,15200
15726,15727,21-10-2020 15:49:01.153309,Saludable · Desayunos,Re.al Alimentos Reales,53900,4000,57900
15727,15728,21-10-2020 15:49:01.552115,Pizza · Italiana,Pisapore - Pizza,48750,6600,55350
15728,15729,21-10-2020 15:49:01.701396,Postres · Desayunos,Café Quindio,23000,5700,28700
15729,15730,21-10-2020 15:49:02.049752,Saludable · Típica,Sopas Mrg,45800,3100,48900
15730,15731,21-10-2020 15:49:02.298757,Pollo,Chicken House,29500,4200,33700
15731,15732,21-10-2020 15:49:02.697214,Pollo · Saludable,Tremenda Sal y Dulce,24300,6500,30800
15732,15733,21-10-2020 15:49:02.945542,Pescados y Mariscos,La Gran Cazuela,11870,3200,15070
15733,15734,21-10-2020 15:49:03.344804,Parrilla,Rústico Picadería,13600,3800,17400
15734,15735,21-10-2020 15:49:03.593875,Postres · Desayunos,Sweet Tale,27800,5800,33600
15735,15736,21-10-2020 15:49:03.893023,Saludable · Desayunos,Copacabana Açai Bowls,17800,3000,20800
15736,15737,21-10-2020 15:49:04.242463,Alta Cocina · Parrilla,Criterión,13000,6000,19000
15737,15738,21-10-2020 15:49:04.442939,Italiana,F*cking Good Pizza,15600,4200,19800
15738,15739,21-10-2020 15:49:04.691231,Internacional,La Esquina con Sabor Parrilla,65000,3000,68000
15739,15740,21-10-2020 15:49:05.039965,Típica,Bandejas Mrg,18900,3800,22700
15740,15741,21-10-2020 15:49:05.239228,Típica,Bendita S,8900,4600,13500
15741,15742,21-10-2020 15:49:05.538456,Pizza · Italiana,Pisapore - Pizza,9000,6600,15600
15742,15743,21-10-2020 15:49:05.937301,Sushi,Kim Pop,45800,5400,51200
15743,15744,21-10-2020 15:49:06.136300,Saludable · Desayunos,Libre de Culpa,65000,4000,69000
15744,15745,21-10-2020 15:49:06.436234,Desayunos · Típica,Calentao Express,65000,6000,71000
15745,15746,21-10-2020 15:49:06.785735,Postres,La Tertulia,7500,3400,10900
15746,15747,21-10-2020 15:49:06.933902,Típica,Juan Chorizo,37900,3900,41800
15747,15748,21-10-2020 15:49:07.132213,Típica,Sabores De Mi Tierra,9000,5400,14400
15748,15749,21-10-2020 15:49:07.431159,Café · Helados,Sofia heladería y café,31800,5800,37600
15749,15750,21-10-2020 15:49:07.779669,Postres · Panadería,RIGHT AWAY FOODS,29500,6600,36100
15750,15751,21-10-2020 15:49:08.178438,Comida Rápida,Fiesta Digital Andrés,31800,3100,34900
15751,15752,21-10-2020 15:49:08.577581,Desayunos · Típica,Criollomania,11870,5200,17070
15752,15753,21-10-2020 15:49:08.725931,Postres · Desayunos,La Folie - Postres,23000,3300,26300
15753,15754,21-10-2020 15:49:09.024583,Típica,Lo Nuestro,27800,3100,30900
15754,15755,21-10-2020 15:49:09.322963,Típica · Pescados y Mariscos,Arroces Mrg,48750,4300,53050
15755,15756,21-10-2020 15:49:09.472057,Desayunos · Café,El Gualilo,27800,6200,34000
15756,15757,21-10-2020 15:49:09.870703,Hamburguesas,Burger Society,8900,4100,13000
15757,15758,21-10-2020 15:49:10.119002,Pizza,18 Scalini,23000,4300,27300
15758,15759,21-10-2020 15:49:10.317694,Típica,Salsig,13000,5600,18600
15759,15760,21-10-2020 15:49:10.666621,Desayunos · Pescados y Mariscos,Gypsy Bistro,45800,4500,50300
15760,15761,21-10-2020 15:49:10.864944,Desayunos · Típica,Criollomania,31800,5200,37000
15761,15762,21-10-2020 15:49:11.063334,Sushi,Umi,15000,5600,20600
15762,15763,21-10-2020 15:49:11.212450,Desayunos · Café,vereda central calle 99,7500,5700,13200
15763,15764,21-10-2020 15:49:11.612003,Saludable,Ventura Soup y Salad,13600,3800,17400
15764,15765,21-10-2020 15:49:11.860677,Parrilla,Arroces Maria Paula,13600,6800,20400
15765,15766,21-10-2020 15:49:12.059374,Postres · Desayunos,Gelateria Da Favola,29500,6500,36000
15766,15767,21-10-2020 15:49:12.258139,Hamburguesas · Saludable,Restaurant Inn,65000,6100,71100
15767,15768,21-10-2020 15:49:12.607033,Desayunos · Café,Norma's Ice Cream Café,53400,6300,59700
15768,15769,21-10-2020 15:49:12.905985,Típica · Parrilla,Parrilla Farandula Gourmet,8900,5100,14000
15769,15770,21-10-2020 15:49:13.054630,Sánduches,Submarin,45800,3800,49600
15770,15771,21-10-2020 15:49:13.452952,Desayunos · Típica,90 Calentados,23000,3700,26700
15771,15772,21-10-2020 15:49:13.601076,Desayunos · Panadería,Le Pain Quotidien,9000,3900,12900
15772,15773,21-10-2020 15:49:13.949356,Parrilla,Rústico Picadería,23000,3800,26800
15773,15774,21-10-2020 15:49:14.197661,Desayunos · Café,Frambas,17800,3400,21200
15774,15775,21-10-2020 15:49:14.345721,Postres · Desayunos,Maltihelados,23000,6200,29200
15775,15776,21-10-2020 15:49:14.544521,Saludable · Desayunos,Malú,18900,3700,22600
15776,15777,21-10-2020 15:49:14.943145,Hamburguesas · Saludable,Restaurant Inn,48750,6100,54850
15777,15778,21-10-2020 15:49:15.141511,Desayunos · Típica,Papadió - Colombianas,24200,5700,29900
15778,15779,21-10-2020 15:49:15.339726,Saludable · Desayunos,Libre de Culpa,24200,4000,28200
15779,15780,21-10-2020 15:49:15.638010,Mexicana,Hidalgo Taquería,7500,4900,12400
15780,15781,21-10-2020 15:49:15.836004,Parrilla,OAK Ahumado y Brebajes,10700,6000,16700
15781,15782,21-10-2020 15:49:16.234484,Típica · Pescados y Mariscos,La Vitualla,7500,6300,13800
15782,15783,21-10-2020 15:49:16.382597,Típica · Parrilla,El Portal de la Antigua,9000,5600,14600
15783,15784,21-10-2020 15:49:16.781164,Típica,La Cocina,53400,4600,58000
15784,15785,21-10-2020 15:49:16.929323,Pollo,Señor Fantástico,37900,4700,42600
15785,15786,21-10-2020 15:49:17.127791,Postres · Café,Loló Coffee & Snacks,24300,4600,28900
15786,15787,21-10-2020 15:49:17.376024,Saludable · Desayunos,Re.al Alimentos Reales,24300,4000,28300
15787,15788,21-10-2020 15:49:17.674309,Desayunos · Jugos y Batidos,Kuriwaji,7500,6300,13800
15788,15789,21-10-2020 15:49:17.922504,Saludable · Desayunos,Guadalupe - Fruteria,29500,5900,35400
15789,15790,21-10-2020 15:49:18.070984,Desayunos · Empanadas,Mis Delicias,9000,3200,12200
15790,15791,21-10-2020 15:49:18.269631,Parrilla,Arroces Maria Paula,35000,6800,41800
15791,15792,21-10-2020 15:49:18.418204,Parrilla,Arroces Maria Paula,9000,6800,15800
15792,15793,21-10-2020 15:49:18.766764,Sushi,Canoa To Go,23000,5900,28900
15793,15794,21-10-2020 15:49:18.914561,Desayunos · Panadería,Ficchi Panadería,39700,3100,42800
15794,15795,21-10-2020 15:49:19.062673,Típica,Salsig,65000,5600,70600
15795,15796,21-10-2020 15:49:19.211282,Postres · Helados,Mahé,9000,6000,15000
15796,15797,21-10-2020 15:49:19.560830,Postres · Desayunos,Maltihelados,18900,6200,25100
15797,15798,21-10-2020 15:49:19.959738,Desayunos · Panadería,Premium Break Bakery,15600,3700,19300
15798,15799,21-10-2020 15:49:20.309935,Pollo · Desayunos,Candelina,11870,5300,17170
15799,15800,21-10-2020 15:49:20.608681,Pollo · Desayunos,Piaf,48750,6500,55250
15800,15801,21-10-2020 15:49:20.957606,Desayunos · Comida Rápida,La Veneca,7500,6300,13800
15801,15802,21-10-2020 15:49:21.106435,Desayunos · Empanadas,Empanadas Doraditas.com,35000,3000,38000
15802,15803,21-10-2020 15:49:21.305258,Típica · Parrilla,Mi Ranchito Parrilla,53900,4400,58300
15803,15804,21-10-2020 15:49:21.553482,Desayunos · Café,Aromacafé el Placer de Compartir,35000,5000,40000
15804,15805,21-10-2020 15:49:21.851685,Hamburguesas,Burger Society,37900,4100,42000
15805,15806,21-10-2020 15:49:22.150416,Desayunos · Típica,Desayunadero de la 42,65000,5900,70900
15806,15807,21-10-2020 15:49:22.499151,Desayunos · Café,vereda central calle 99,35000,5700,40700
15807,15808,21-10-2020 15:49:22.797968,Saludable · Típica,Saludable Mrg,70000,5800,75800
15808,15809,21-10-2020 15:49:23.147016,Desayunos · Café,Libertario Coffee Roasters,8900,4600,13500
15809,15810,21-10-2020 15:49:23.495694,Desayunos,Desayunos en Bogotá,11870,3400,15270
15810,15811,21-10-2020 15:49:23.844228,Comida Rápida,Fiesta Digital Andrés,8900,3100,12000
15811,15812,21-10-2020 15:49:24.193873,Desayunos,Bagel Shop,15600,3200,18800
15812,15813,21-10-2020 15:49:24.443503,Parrilla,Arroces Maria Paula,15600,6800,22400
15813,15814,21-10-2020 15:49:24.694099,Desayunos,Bagel Shop,65000,3200,68200
15814,15815,21-10-2020 15:49:24.942683,Típica,La Olla de Barro,37900,5300,43200
15815,15816,21-10-2020 15:49:25.291381,Parrilla,Arroces Maria Paula,24200,6800,31000
15816,15817,21-10-2020 15:49:25.489700,Sushi · Asiática,Arigato,35000,5300,40300
15817,15818,21-10-2020 15:49:25.888111,Típica · Pescados y Mariscos,Arroces Mrg,17800,4300,22100
15818,15819,21-10-2020 15:49:26.035793,Desayunos · Típica,Rojo Gourmet,29500,4700,34200
15819,15820,21-10-2020 15:49:26.384241,Desayunos · Panadería,Le Pain Quotidien,7500,3900,11400
15820,15821,21-10-2020 15:49:26.632908,Italiana,F*cking Good Pizza,15000,4200,19200
15821,15822,21-10-2020 15:49:26.780864,Sushi,Sushi Reel,10700,4700,15400
15822,15823,21-10-2020 15:49:27.129370,Desayunos · Parrilla,Mi Patria,37900,4600,42500
15823,15824,21-10-2020 15:49:27.527918,Desayunos · Típica,Cochon,13000,3300,16300
15824,15825,21-10-2020 15:49:27.675926,Desayunos · Típica,Cochon,15000,3300,18300
15825,15826,21-10-2020 15:49:27.873975,Desayunos · Típica,Criollomania,34500,5200,39700
15826,15827,21-10-2020 15:49:28.122289,Saludable · Desayunos,Distrito Gourmet,9000,3700,12700
15827,15828,21-10-2020 15:49:28.270375,Parrilla,Carnes la Zarza,23000,4900,27900
15828,15829,21-10-2020 15:49:28.418773,Postres,La Galeta,24300,3000,27300
15829,15830,21-10-2020 15:49:28.817610,Postres,La Galeta,17800,3000,20800
15830,15831,21-10-2020 15:49:29.065959,Pollo · Sánduches,Pollos Century,35000,3000,38000
15831,15832,21-10-2020 15:49:29.364390,Pizza,Pastas Laurentina,39700,4800,44500
15832,15833,21-10-2020 15:49:29.512518,Desayunos,El Corral - Desayunos,15600,5000,20600
15833,15834,21-10-2020 15:49:29.660980,Pollo,Heart & Cooking,24200,5000,29200
15834,15835,21-10-2020 15:49:29.810306,Saludable · Desayunos,Agua Dulce,11870,3700,15570
15835,15836,21-10-2020 15:49:30.058935,Pollo · Saludable,Gratina,48750,4200,52950
15836,15837,21-10-2020 15:49:30.257347,Desayunos · Comida Rápida,Chocolatto,11870,3400,15270
15837,15838,21-10-2020 15:49:30.555874,Postres · Desayunos,Gelateria Da Favola,24200,6500,30700
15838,15839,21-10-2020 15:49:30.954169,Desayunos · Panadería,Limarys,23000,6500,29500
15839,15840,21-10-2020 15:49:31.102337,Desayunos · Típica,Papadió - Colombianas,37900,5700,43600
15840,15841,21-10-2020 15:49:31.400751,Desayunos · Café,Norma's Ice Cream Café,18900,6300,25200
15841,15842,21-10-2020 15:49:31.699298,Café · Helados,Sofia heladería y café,15000,5800,20800
15842,15843,21-10-2020 15:49:31.947678,Internacional,La Esquina con Sabor Parrilla,24200,3000,27200
15843,15844,21-10-2020 15:49:32.346072,Típica,El Cucharón - Tipica,37900,4400,42300
15844,15845,21-10-2020 15:49:32.644779,Saludable,A2manos,17800,4200,22000
15845,15846,21-10-2020 15:49:32.942937,Pescados y Mariscos,La Gran Cazuela,10700,3200,13900
15846,15847,21-10-2020 15:49:33.191052,Peruana,Masivo,70000,5800,75800
15847,15848,21-10-2020 15:49:33.339308,Desayunos · Parrilla,Mi Patria,10700,4600,15300
15848,15849,21-10-2020 15:49:33.587503,Jugos y Batidos,Pomponio,35000,3600,38600
15849,15850,21-10-2020 15:49:33.885798,Desayunos,Jacinta Arepas de Huevo,15600,4000,19600
15850,15851,21-10-2020 15:49:34.184374,Desayunos,El Fogón Castellano,15600,3200,18800
15851,15852,21-10-2020 15:49:34.433822,Saludable · Típica,Saludable Mrg,35000,5800,40800
15852,15853,21-10-2020 15:49:34.783260,Postres · Desayunos,Sweet Tale,35000,5800,40800
15853,15854,21-10-2020 15:49:35.082697,Típica · Parrilla,Mi Ranchito Parrilla,37900,4400,42300
15854,15855,21-10-2020 15:49:35.331268,Pollo · Saludable,Gratina,35000,4200,39200
15855,15856,21-10-2020 15:49:35.479775,Desayunos,El Corral - Desayunos,7500,5000,12500
15856,15857,21-10-2020 15:49:35.628326,Pollo · Típica,Auyama,24200,3900,28100
15857,15858,21-10-2020 15:49:35.926801,Mexicana,Hidalgo Taquería,12500,4900,17400
15858,15859,21-10-2020 15:49:36.275327,Saludable,A2manos,7500,4200,11700
15859,15860,21-10-2020 15:49:36.424471,Internacional,La Esquina con Sabor Parrilla,45800,3000,48800
15860,15861,21-10-2020 15:49:36.572864,Asiática,Thai Station,10700,6000,16700
15861,15862,21-10-2020 15:49:36.821608,Típica,La Cocina,12500,4600,17100
15862,15863,21-10-2020 15:49:37.169925,Pizza,18 Scalini,29500,4300,33800
15863,15864,21-10-2020 15:49:37.468481,Típica,Sabrosito,9000,4000,13000
15864,15865,21-10-2020 15:49:37.716952,Desayunos · Café,Aromacafé el Placer de Compartir,18900,5000,23900
15865,15866,21-10-2020 15:49:37.965811,Saludable,Amor Propio saludable,10700,4000,14700
15866,15867,21-10-2020 15:49:38.264689,Postres · Desayunos,Cosmo Cookies,27800,5900,33700
15867,15868,21-10-2020 15:49:38.563366,Hamburguesas · Pescados y Mariscos,El Velero,65000,6500,71500
15868,15869,21-10-2020 15:49:38.711582,Saludable · Desayunos,Bon Eat - Saludable,29500,4800,34300
15869,15870,21-10-2020 15:49:38.909688,Desayunos · Café,El Gualilo,53400,6200,59600
15870,15871,21-10-2020 15:49:39.057897,Desayunos · Típica,90 Calentados,48750,3700,52450
15871,15872,21-10-2020 15:49:39.406940,Mexicana,La leyenda mexican kitchen,18900,3200,22100
15872,15873,21-10-2020 15:49:39.705884,Pizza · Italiana,Pisapore - Pizza,17800,6600,24400
15873,15874,21-10-2020 15:49:39.854295,Desayunos · Sánduches,Garnish,9000,5200,14200
15874,15875,21-10-2020 15:49:40.153583,Pizza · Italiana,Piatto - Pizza,39700,6600,46300
15875,15876,21-10-2020 15:49:40.502006,Parrilla,Restaurante Bar Mi Ranchito,34500,5200,39700
15876,15877,21-10-2020 15:49:40.900621,Pollo · Desayunos,Piaf,18900,6500,25400
15877,15878,21-10-2020 15:49:41.149636,Desayunos,Desayunos en Bogotá,24200,3400,27600
15878,15879,21-10-2020 15:49:41.297976,Asiática,Thai Station,65000,6000,71000
15879,15880,21-10-2020 15:49:41.646746,Sushi · Asiática,Tu Sushi,29500,6400,35900
15880,15881,21-10-2020 15:49:41.945242,Postres · Desayunos,Protein Bakes,15600,5900,21500
15881,15882,21-10-2020 15:49:42.193798,Hamburguesas · Pescados y Mariscos,El Velero,24200,6500,30700
15882,15883,21-10-2020 15:49:42.592280,Desayunos · Típica,D'Porco - Lechona,70000,6300,76300
15883,15884,21-10-2020 15:49:42.891000,Peruana · Internacional,La Chifería,17800,6600,24400
15884,15885,21-10-2020 15:49:43.139828,Típica,Juan Chorizo,35000,3900,38900
15885,15886,21-10-2020 15:49:43.438798,Parrilla,Beraca Parrilla Bbq,12500,5600,18100
15886,15887,21-10-2020 15:49:43.837545,Sushi,Kim Pop,13000,5400,18400
15887,15888,21-10-2020 15:49:44.136510,Sánduches,Submarin,48750,3800,52550
15888,15889,21-10-2020 15:49:44.386443,Pollo · Desayunos,Piaf,24300,6500,30800
15889,15890,21-10-2020 15:49:44.585370,Parrilla,Parrilla Pimentón,10700,3400,14100
15890,15891,21-10-2020 15:49:44.883574,Pollo,Heart & Cooking,24300,5000,29300
15891,15892,21-10-2020 15:49:45.032339,Típica,Lo Nuestro,39700,3100,42800
15892,15893,21-10-2020 15:49:45.282352,Desayunos · Típica,Peninsula Calentados y Parrilla,31800,3400,35200
15893,15894,21-10-2020 15:49:45.631445,Postres · Desayunos,BagBog Bagels,29500,6400,35900
15894,15895,21-10-2020 15:49:45.829977,Desayunos · Pescados y Mariscos,Luzí­a - Mediterranea,8900,5700,14600
15895,15896,21-10-2020 15:49:46.229783,Desayunos · Internacional,Camilia,11870,3900,15770
15896,15897,21-10-2020 15:49:46.478755,Helados,Orso To Go,23000,6800,29800
15897,15898,21-10-2020 15:49:46.827327,Desayunos · Panadería,Artesanos,23000,4300,27300
15898,15899,21-10-2020 15:49:46.975793,Desayunos · Panadería,Le Pain Quotidien,18900,3900,22800
15899,15900,21-10-2020 15:49:47.275055,Desayunos,Desayunos en Bogotá,24300,3400,27700
15900,15901,21-10-2020 15:49:47.673721,Parrilla,Campocina,24300,4600,28900
15901,15902,21-10-2020 15:49:48.072859,Desayunos,Fratelli - Desayunos,53900,4600,58500
15902,15903,21-10-2020 15:49:48.321637,Mexicana,Mexicanachos,8900,3900,12800
15903,15904,21-10-2020 15:49:48.470403,Típica · Parrilla,Typykos,13600,6000,19600
15904,15905,21-10-2020 15:49:48.869108,Postres,Beiked,24300,4000,28300
15905,15906,21-10-2020 15:49:49.067626,Pollo · Desayunos,Workzone,23000,3100,26100
15906,15907,21-10-2020 15:49:49.266141,Desayunos · Panadería,Ficchi Panadería,65000,3100,68100
15907,15908,21-10-2020 15:49:49.515262,Postres,La Galeta,29500,3000,32500
15908,15909,21-10-2020 15:49:49.913993,Asiática,TeT,53900,5900,59800
15909,15910,21-10-2020 15:49:50.112227,Típica · Parrilla,La Parilla de David,12500,3100,15600
15910,15911,21-10-2020 15:49:50.412305,Típica,Campo Victoria,15600,3000,18600
15911,15912,21-10-2020 15:49:50.711030,Parrilla · Internacional,Taperia de la Plaza,31800,5700,37500
15912,15913,21-10-2020 15:49:51.059873,Pizza · Parrilla,Urban Lunch,31800,4000,35800
15913,15914,21-10-2020 15:49:51.359197,Desayunos,Desayunos en Bogotá,13000,3400,16400
15914,15915,21-10-2020 15:49:51.758312,Desayunos · Panadería,Siena Café,12500,3700,16200
15915,15916,21-10-2020 15:49:52.107056,Típica,La Cocina,31800,4600,36400
15916,15917,21-10-2020 15:49:52.257378,Desayunos · Italiana,Rceta By Rausch,53900,3600,57500
15917,15918,21-10-2020 15:49:52.507530,Postres · Desayunos,Protein Bakes,12500,5900,18400
15918,15919,21-10-2020 15:49:52.906132,Pollo · Pescados y Mariscos,Bang Bang Rice,31800,3400,35200
15919,15920,21-10-2020 15:49:53.155150,Típica · Parrilla,La Ternera Parrilla,31800,5200,37000
15920,15921,21-10-2020 15:49:53.403801,Saludable · Desayunos,Fresh Co,17800,5600,23400
15921,15922,21-10-2020 15:49:53.652605,Parrilla,Rústico Picadería,10700,3800,14500
15922,15923,21-10-2020 15:49:54.051535,Postres,La Tertulia,48750,3400,52150
15923,15924,21-10-2020 15:49:54.200106,Típica,Campo Victoria,45800,3000,48800
15924,15925,21-10-2020 15:49:54.499270,Desayunos · Jugos y Batidos,Dont Be Hungry,10700,5600,16300
15925,15926,21-10-2020 15:49:54.848327,Desayunos · Panadería,Pasteleite,45800,5900,51700
15926,15927,21-10-2020 15:49:55.197312,Pollo · Desayunos,Candelina,35000,5300,40300
15927,15928,21-10-2020 15:49:55.496688,Hamburguesas,Burger Society,24300,4100,28400
15928,15929,21-10-2020 15:49:55.645743,Desayunos · Pescados y Mariscos,Luzí­a - Mediterranea,35000,5700,40700
15929,15930,21-10-2020 15:49:55.944061,Pescados y Mariscos,La Gran Cazuela,35000,3200,38200
15930,15931,21-10-2020 15:49:56.092561,Saludable · Desayunos,Copacabana Açai Bowls,35000,3000,38000
15931,15932,21-10-2020 15:49:56.341250,Desayunos · Parrilla,Mi Patria,48750,4600,53350
15932,15933,21-10-2020 15:49:56.739959,Desayunos · Típica,Fogón Sangileño,34500,5000,39500
15933,15934,21-10-2020 15:49:56.888571,Típica,Lo Nuestro,15000,3100,18100
15934,15935,21-10-2020 15:49:57.187532,Desayunos,Bagel Shop,11870,3200,15070
15935,15936,21-10-2020 15:49:57.386243,Típica · Parrilla,La Parilla de David,13000,3100,16100
15936,15937,21-10-2020 15:49:57.785580,Saludable · Desayunos,Básico y elemental,39700,5000,44700
15937,15938,21-10-2020 15:49:58.184416,Desayunos,Señor Desayuno,35000,6800,41800
15938,15939,21-10-2020 15:49:58.533489,Típica,Salsig,18900,5600,24500
15939,15940,21-10-2020 15:49:58.932392,Parrilla,Campocina,9000,4600,13600
15940,15941,21-10-2020 15:49:59.231164,Desayunos · Sánduches,Garnish,45800,5200,51000
15941,15942,21-10-2020 15:49:59.529965,Típica · Parrilla,Mi Ranchito Parrilla,24200,4400,28600
15942,15943,21-10-2020 15:49:59.928948,Desayunos · Típica,Parrilla Farandula Típico,31800,5900,37700
15943,15944,21-10-2020 15:50:00.228211,Saludable · Desayunos,Raices Bienestar Gourmet,53900,6600,60500
15944,15945,21-10-2020 15:50:00.527996,Postres · Desayunos,Maltihelados,10700,6200,16900
15945,15946,21-10-2020 15:50:00.826909,Postres,La Tertulia,10700,3400,14100
15946,15947,21-10-2020 15:50:01.175656,Italiana,F*cking Good Pizza,27800,4200,32000
15947,15948,21-10-2020 15:50:01.324352,Desayunos,Cafetería el Kippe,53400,3200,56600
15948,15949,21-10-2020 15:50:01.572911,Desayunos,Cafetería el Kippe,45800,3200,49000
15949,15950,21-10-2020 15:50:01.871386,Desayunos · Helados,San Giorgio Gelateria,39700,3100,42800
15950,15951,21-10-2020 15:50:02.220921,Postres · Desayunos,Restaurante Cornelia,13000,5500,18500
15951,15952,21-10-2020 15:50:02.470417,Saludable · Parrilla,The Angels Grill and Drinks,35000,6200,41200
15952,15953,21-10-2020 15:50:02.619697,Desayunos · Árabe,Boniato Sabores Vivos,70000,5300,75300
15953,15954,21-10-2020 15:50:02.968854,Parrilla,El Tambor,39700,6800,46500
15954,15955,21-10-2020 15:50:03.317656,Desayunos · Panadería,Santa Juana Food Bar,35000,5900,40900
15955,15956,21-10-2020 15:50:03.616633,Pizza · Italiana,Piatto - Pizza,13600,6600,20200
15956,15957,21-10-2020 15:50:03.865408,Sushi,Canoa To Go,45800,5900,51700
15957,15958,21-10-2020 15:50:04.164258,Desayunos · Pescados y Mariscos,Gypsy Bistro,15000,4500,19500
15958,15959,21-10-2020 15:50:04.464202,Postres,La Tertulia,70000,3400,73400
15959,15960,21-10-2020 15:50:04.763259,Postres · Desayunos,Sweet Tale,39700,5800,45500
15960,15961,21-10-2020 15:50:05.061924,Postres,La Galeta,27800,3000,30800
15961,15962,21-10-2020 15:50:05.410709,Saludable · Desayunos,Bawana - Sandwich,70000,3400,73400
15962,15963,21-10-2020 15:50:05.710651,Crepes,San Crepes,39700,4900,44600
15963,15964,21-10-2020 15:50:05.858924,Postres · Café,Loló Coffee & Snacks,10700,4600,15300
15964,15965,21-10-2020 15:50:06.107658,Típica · Parrilla,Mi Ranchito Parrilla,37900,4400,42300
15965,15966,21-10-2020 15:50:06.256389,Pizza · Parrilla,Urban Lunch,34500,4000,38500
15966,15967,21-10-2020 15:50:06.655527,Hamburguesas · Panadería,NYC Burgers,37900,6200,44100
15967,15968,21-10-2020 15:50:06.854012,Postres · Helados,Mahé,18900,6000,24900
15968,15969,21-10-2020 15:50:07.052403,Alta Cocina · Postres,La Pinta,15600,4500,20100
15969,15970,21-10-2020 15:50:07.351953,Típica,Lo Nuestro,7500,3100,10600
15970,15971,21-10-2020 15:50:07.501317,Sushi,Sushi Reel,17800,4700,22500
15971,15972,21-10-2020 15:50:07.850443,Parrilla,Rústico Picadería,11870,3800,15670
15972,15973,21-10-2020 15:50:08.249862,Postres · Desayunos,Café Quindio,18900,5700,24600
15973,15974,21-10-2020 15:50:08.399314,Pollo · Pescados y Mariscos,Bang Bang Rice,15000,3400,18400
15974,15975,21-10-2020 15:50:08.748647,Desayunos · Panadería,Le Pain Quotidien,12500,3900,16400
15975,15976,21-10-2020 15:50:09.097449,Desayunos · Jugos y Batidos,Kuriwaji,24300,6300,30600
15976,15977,21-10-2020 15:50:09.346271,Desayunos · Típica,Casa Vieja,10700,6000,16700
15977,15978,21-10-2020 15:50:09.545530,Internacional,Rio Sabores y Experiencias,23000,4100,27100
15978,15979,21-10-2020 15:50:09.694642,Desayunos,Desayunos en Bogotá,37900,3400,41300
15979,15980,21-10-2020 15:50:09.843696,Desayunos · Café,Aromacafé el Placer de Compartir,48750,5000,53750
15980,15981,21-10-2020 15:50:09.992413,Típica,Cazuelitas 93,31800,3900,35700
15981,15982,21-10-2020 15:50:10.391819,Saludable · Desayunos,La Estampilla,29500,6000,35500
15982,15983,21-10-2020 15:50:10.741683,Desayunos,El Corral - Desayunos,23000,5000,28000
15983,15984,21-10-2020 15:50:11.140891,Desayunos · Italiana,Rceta By Rausch,13600,3600,17200
15984,15985,21-10-2020 15:50:11.439918,Desayunos · Panadería,Limarys,53900,6500,60400
15985,15986,21-10-2020 15:50:11.788970,Postres · Desayunos,KOKOA & co.,31800,4700,36500
15986,15987,21-10-2020 15:50:11.987790,Parrilla,Antojo a Domicilio,35000,5000,40000
15987,15988,21-10-2020 15:50:12.336745,Desayunos · Panadería,Decofruta,15000,4700,19700
15988,15989,21-10-2020 15:50:12.485501,Internacional,La Esquina con Sabor Parrilla,13600,3000,16600
15989,15990,21-10-2020 15:50:12.834231,Típica,La Herencia,39700,5900,45600
15990,15991,21-10-2020 15:50:12.983258,Parrilla,Carnes la Zarza,9000,4900,13900
15991,15992,21-10-2020 15:50:13.283260,Mexicana,Hidalgo Taquería,11870,4900,16770
15992,15993,21-10-2020 15:50:13.682208,Pollo · Desayunos,Workzone,13000,3100,16100
15993,15994,21-10-2020 15:50:13.880815,Pescados y Mariscos,Fish Place - Del Mar,15000,5400,20400
15994,15995,21-10-2020 15:50:14.130142,Desayunos · Panadería,Choclofee,9000,4700,13700
15995,15996,21-10-2020 15:50:14.529199,Parrilla,Beraca Parrilla Bbq,15600,5600,21200
15996,15997,21-10-2020 15:50:14.778204,Mexicana,La leyenda mexican kitchen,65000,3200,68200
15997,15998,21-10-2020 15:50:14.977284,Saludable · Desayunos,La Estampilla,48750,6000,54750
15998,15999,21-10-2020 15:50:15.376160,Saludable · Desayunos,Malú,15600,3700,19300
15999,16000,21-10-2020 15:50:15.725688,Peruana · Internacional,La Chifería,35000,6600,41600
16000,16001,21-10-2020 15:50:15.874787,Desayunos · Internacional,Camilia,17800,3900,21700
16001,16002,21-10-2020 15:50:16.123932,Típica,La Herencia,24300,5900,30200
16002,16003,21-10-2020 15:50:16.322701,Parrilla,Antojo a Domicilio,7500,5000,12500
16003,16004,21-10-2020 15:50:16.471626,Hamburguesas,Bendito Cordero,23000,5800,28800
16004,16005,21-10-2020 15:50:16.870697,Desayunos · Empanadas,Mis Delicias,17800,3200,21000
16005,16006,21-10-2020 15:50:17.219684,Pollo,Heart & Cooking,34500,5000,39500
16006,16007,21-10-2020 15:50:17.568540,Desayunos · Panadería,El Pan de Phillippe,15000,4600,19600
16007,16008,21-10-2020 15:50:17.767293,Típica · Pescados y Mariscos,Arroces Mrg,23000,4300,27300
16008,16009,21-10-2020 15:50:17.966664,Saludable · Típica,Saludable Mrg,15600,5800,21400
16009,16010,21-10-2020 15:50:18.116293,Alta Cocina · Italiana,Trattoria de la Plaza,23000,6000,29000
16010,16011,21-10-2020 15:50:18.515857,Postres · Desayunos,Buñuelos nacho,31800,6600,38400
16011,16012,21-10-2020 15:50:18.915475,Hamburguesas · Alitas,Beer,53900,6600,60500
16012,16013,21-10-2020 15:50:19.215018,Desayunos · Café,Moramia,15600,4700,20300
16013,16014,21-10-2020 15:50:19.364186,Pizza,Pizza Andante,35000,6300,41300
16014,16015,21-10-2020 15:50:19.663842,Típica · Parrilla,La Ternera Parrilla,45800,5200,51000
16015,16016,21-10-2020 15:50:20.063217,Postres · Panadería,RIGHT AWAY FOODS,10700,6600,17300
16016,16017,21-10-2020 15:50:20.212054,Hamburguesas · Pescados y Mariscos,El Velero,8900,6500,15400
16017,16018,21-10-2020 15:50:20.611402,Saludable,Ventura Soup y Salad,24300,3800,28100
16018,16019,21-10-2020 15:50:20.810284,Típica · Parrilla,Mi Ranchito Parrilla,12500,4400,16900
16019,16020,21-10-2020 15:50:20.960031,Desayunos · Café,Libertario Coffee Roasters,45800,4600,50400
16020,16021,21-10-2020 15:50:21.309148,Pizza · Italiana,Pisapore - Pizza,23000,6600,29600
16021,16022,21-10-2020 15:50:21.608594,Desayunos · Típica,Parrilla Farandula Típico,24300,5900,30200
16022,16023,21-10-2020 15:50:21.807575,Desayunos · Panadería,Decofruta,10700,4700,15400
16023,16024,21-10-2020 15:50:22.206883,Típica · Parrilla,El Portal de la Antigua,27800,5600,33400
16024,16025,21-10-2020 15:50:22.456483,Italiana,Bocatto Di Passo,45800,5000,50800
16025,16026,21-10-2020 15:50:22.755813,Internacional,Rio Sabores y Experiencias,23000,4100,27100
16026,16027,21-10-2020 15:50:22.904710,Helados,Buon Gelato,8900,4400,13300
16027,16028,21-10-2020 15:50:23.254542,Parrilla · Café,Figaro Café/ Restaurante Argentino,10700,5800,16500
16028,16029,21-10-2020 15:50:23.554441,Italiana,Bocatto Di Passo,13000,5000,18000
16029,16030,21-10-2020 15:50:23.904497,Desayunos · Típica,Cochon,15600,3300,18900
16030,16031,21-10-2020 15:50:24.104577,Típica,El Cucharón - Tipica,15600,4400,20000
16031,16032,21-10-2020 15:50:24.404391,Parrilla,Rústico Picadería,34500,3800,38300
16032,16033,21-10-2020 15:50:24.603655,Postres · Desayunos,Café Quindio,27800,5700,33500
16033,16034,21-10-2020 15:50:25.002690,Postres · Desayunos,Jacques Pastelería,53900,5900,59800
16034,16035,21-10-2020 15:50:25.201213,Pollo,Heart & Cooking,11870,5000,16870
16035,16036,21-10-2020 15:50:25.400009,Típica,Campo Victoria,53400,3000,56400
16036,16037,21-10-2020 15:50:25.749470,Desayunos · Típica,Rojo Gourmet,48750,4700,53450
16037,16038,21-10-2020 15:50:25.898562,Saludable,The Good Rice Bowls,8900,3500,12400
16038,16039,21-10-2020 15:50:26.248159,Desayunos · Empanadas,Empanadas Doraditas.com,24200,3000,27200
16039,16040,21-10-2020 15:50:26.497648,Desayunos · Café,Aromacafé el Placer de Compartir,8900,5000,13900
16040,16041,21-10-2020 15:50:26.647093,Parrilla,Parrilla Pimentón,15600,3400,19000
16041,16042,21-10-2020 15:50:26.945813,Saludable,Puro Verde,39700,5700,45400
16042,16043,21-10-2020 15:50:27.295062,Parrilla,Rústico Picadería,45800,3800,49600
16043,16044,21-10-2020 15:50:27.644693,Desayunos · Jugos y Batidos,Kuriwaji,10700,6300,17000
16044,16045,21-10-2020 15:50:27.893551,Desayunos · Panadería,El Pan de Phillippe,34500,4600,39100
16045,16046,21-10-2020 15:50:28.143220,Desayunos · Típica,Desayunadero de la 42,45800,5900,51700
16046,16047,21-10-2020 15:50:28.542383,Saludable · Desayunos,Re.al Alimentos Reales,9000,4000,13000
16047,16048,21-10-2020 15:50:28.841396,Pescados y Mariscos,La Gran Cazuela,10700,3200,13900
16048,16049,21-10-2020 15:50:29.240962,Típica · Parrilla,Parrilla Farandula Gourmet,23000,5100,28100
16049,16050,21-10-2020 15:50:29.390415,Parrilla,Campocina,10700,4600,15300
16050,16051,21-10-2020 15:50:29.690107,Desayunos · Típica,La Frijolada,10700,4500,15200
16051,16052,21-10-2020 15:50:30.039835,Desayunos · Típica,D´Porco,18900,3900,22800
16052,16053,21-10-2020 15:50:30.289293,Alta Cocina · Postres,La Pinta,48750,4500,53250
16053,16054,21-10-2020 15:50:30.689361,Saludable · Desayunos,Bon Eat - Saludable,11870,4800,16670
16054,16055,21-10-2020 15:50:30.838860,Pizza · Italiana,Pisapore - Pizza,65000,6600,71600
16055,16056,21-10-2020 15:50:31.238875,Desayunos · Sánduches,Frutos del Bosque,8900,3500,12400
16056,16057,21-10-2020 15:50:31.639697,Típica,La Herencia,10700,5900,16600
16057,16058,21-10-2020 15:50:31.939580,Desayunos · Típica,D´Porco,13600,3900,17500
16058,16059,21-10-2020 15:50:32.238879,Perros Calientes,Dog Shop - Rapida,35000,4900,39900
16059,16060,21-10-2020 15:50:32.588872,Desayunos · Panadería,Ficchi Panadería,70000,3100,73100
16060,16061,21-10-2020 15:50:32.938014,Desayunos,Desayunos en Bogotá,35000,3400,38400
16061,16062,21-10-2020 15:50:33.187162,Postres · Desayunos,Protein Bakes,48750,5900,54650
16062,16063,21-10-2020 15:50:33.536551,Postres · Desayunos,Buñuelos nacho,17800,6600,24400
16063,16064,21-10-2020 15:50:33.786410,Postres · Café,Loló Coffee & Snacks,10700,4600,15300
16064,16065,21-10-2020 15:50:34.136126,Desayunos · Café,El Gualilo,9000,6200,15200
16065,16066,21-10-2020 15:50:34.536070,Mexicana,Hidalgo Taquería,18900,4900,23800
16066,16067,21-10-2020 15:50:34.685255,Típica,Bandejas Mrg,53900,3800,57700
16067,16068,21-10-2020 15:50:35.084394,Helados,Buon Gelato,35000,4400,39400
16068,16069,21-10-2020 15:50:35.484066,Desayunos · Típica,Alce,10700,4900,15600
16069,16070,21-10-2020 15:50:35.733729,Parrilla,Beraca Parrilla Bbq,23000,5600,28600
16070,16071,21-10-2020 15:50:35.933421,Desayunos · Árabe,Boniato Sabores Vivos,24200,5300,29500
16071,16072,21-10-2020 15:50:36.133042,Típica · Pescados y Mariscos,La Vitualla,29500,6300,35800
16072,16073,21-10-2020 15:50:36.532363,Saludable · Desayunos,Básico y Elemental,23000,5900,28900
16073,16074,21-10-2020 15:50:36.682669,Pollo · Típica,Auyama,70000,3900,73900
16074,16075,21-10-2020 15:50:36.982225,Típica,La Olla de Barro,8900,5300,14200
16075,16076,21-10-2020 15:50:37.331812,Saludable · Desayunos,Re.al Alimentos Reales,23000,4000,27000
16076,16077,21-10-2020 15:50:37.481151,Desayunos,Señor Desayuno,48750,6800,55550
16077,16078,21-10-2020 15:50:37.630903,Saludable · Típica,Saludable Mrg,39700,5800,45500
16078,16079,21-10-2020 15:50:37.930251,Desayunos · Típica,Parrilla Farandula Típico,24300,5900,30200
16079,16080,21-10-2020 15:50:38.130203,Saludable,Hanai - Bowls Saludables,12500,5900,18400
16080,16081,21-10-2020 15:50:38.280035,Desayunos · Panadería,Limarys,7500,6500,14000
16081,16082,21-10-2020 15:50:38.479465,Desayunos · Empanadas,Mis Delicias,35000,3200,38200
16082,16083,21-10-2020 15:50:38.728941,Típica,Cabrito Santandereano,23000,6600,29600
16083,16084,21-10-2020 15:50:39.078248,Típica · Pescados y Mariscos,La Vitualla,27800,6300,34100
16084,16085,21-10-2020 15:50:39.428102,Pollo,Heart & Cooking,39700,5000,44700
16085,16086,21-10-2020 15:50:39.677746,Típica · Parrilla,Toya,11870,4200,16070
16086,16087,21-10-2020 15:50:39.827149,Desayunos · Típica,90 Calentados,35000,3700,38700
16087,16088,21-10-2020 15:50:40.026380,Postres · Desayunos,Amelie Helados,23000,6400,29400
16088,16089,21-10-2020 15:50:40.175409,Postres · Desayunos,BagBog Bagels,9000,6400,15400
16089,16090,21-10-2020 15:50:40.475336,Mexicana,La leyenda mexican kitchen,27800,3200,31000
16090,16091,21-10-2020 15:50:40.724602,Hamburguesas,Monchis - Hamburguesa,24200,4300,28500
16091,16092,21-10-2020 15:50:41.073680,Desayunos,Señor Desayuno,18900,6800,25700
16092,16093,21-10-2020 15:50:41.322921,Saludable · Típica,Saludable Mrg,23000,5800,28800
16093,16094,21-10-2020 15:50:41.672488,Desayunos · Típica,La Parrilla Dorada Polo,24200,6600,30800
16094,16095,21-10-2020 15:50:42.072273,Desayunos,Sr Buñuelo,15600,6400,22000
16095,16096,21-10-2020 15:50:42.272002,Crepes,San Crepes,8900,4900,13800
16096,16097,21-10-2020 15:50:42.622300,Desayunos · Internacional,Camilia,48750,3900,52650
16097,16098,21-10-2020 15:50:42.821741,Desayunos,Butter,24300,6700,31000
16098,16099,21-10-2020 15:50:43.221361,Pollo · Saludable,Tremenda Sal y Dulce,48750,6500,55250
16099,16100,21-10-2020 15:50:43.521707,Postres · Desayunos,Sharmus,53400,6100,59500
16100,16101,21-10-2020 15:50:43.921164,Pollo · Desayunos,Abasto,27800,3600,31400
16101,16102,21-10-2020 15:50:44.120748,Saludable · Desayunos,Malú,27800,3700,31500
16102,16103,21-10-2020 15:50:44.421252,Mexicana,Cantina La 15,35000,4300,39300
16103,16104,21-10-2020 15:50:44.820983,Pollo,Chicken House,35000,4200,39200
16104,16105,21-10-2020 15:50:44.970908,Pizza · Parrilla,Urban Lunch,53900,4000,57900
16105,16106,21-10-2020 15:50:45.271119,Pollo · Saludable,Tremenda Sal y Dulce,24300,6500,30800
16106,16107,21-10-2020 15:50:45.520456,Desayunos,El Fogón Castellano,9000,3200,12200
16107,16108,21-10-2020 15:50:45.869862,Desayunos,Fratelli - Desayunos,34500,4600,39100
16108,16109,21-10-2020 15:50:46.269851,Saludable · Desayunos,Raices Bienestar Gourmet,9000,6600,15600
16109,16110,21-10-2020 15:50:46.469505,Italiana,Bocatto Di Passo,10700,5000,15700
16110,16111,21-10-2020 15:50:46.768797,Comida Rápida,Fiesta Digital Andrés,37900,3100,41000
16111,16112,21-10-2020 15:50:47.018347,Postres · Desayunos,Maltihelados,17800,6200,24000
16112,16113,21-10-2020 15:50:47.318517,Desayunos · Panadería,Choclofee,24300,4700,29000
16113,16114,21-10-2020 15:50:47.618576,Sushi,Umi,70000,5600,75600
16114,16115,21-10-2020 15:50:47.767729,Desayunos · Sánduches,Garnish,65000,5200,70200
16115,16116,21-10-2020 15:50:48.016964,Desayunos · Empanadas,Mis Delicias,27800,3200,31000
16116,16117,21-10-2020 15:50:48.216759,Saludable · Típica,Saludable Mrg,18900,5800,24700
16117,16118,21-10-2020 15:50:48.516759,Comida Rápida,Fiesta Digital Andrés,37900,3100,41000
16118,16119,21-10-2020 15:50:48.716294,Típica · Parrilla,Parrilla Farandula Gourmet,53400,5100,58500
16119,16120,21-10-2020 15:50:49.016155,Típica,El Cucharón - Tipica,29500,4400,33900
16120,16121,21-10-2020 15:50:49.365983,Pollo · Desayunos,Abasto,37900,3600,41500
16121,16122,21-10-2020 15:50:49.665586,Desayunos · Mexicana,La Mera Mera - Mexicana,24200,3100,27300
16122,16123,21-10-2020 15:50:50.015548,Típica · Parrilla,La Ternera Parrilla,11870,5200,17070
16123,16124,21-10-2020 15:50:50.315114,Postres,La Galeta,7500,3000,10500
16124,16125,21-10-2020 15:50:50.464421,Postres · Desayunos,BagBog Bagels,23000,6400,29400
16125,16126,21-10-2020 15:50:50.864136,Saludable,MIMA,10700,3700,14400
16126,16127,21-10-2020 15:50:51.063406,Pollo · Desayunos,Piaf,35000,6500,41500
16127,16128,21-10-2020 15:50:51.413241,Pescados y Mariscos,La Gran Cazuela,24300,3200,27500
16128,16129,21-10-2020 15:50:51.763416,Panadería,Boul,18900,3100,22000
16129,16130,21-10-2020 15:50:52.163611,Típica,El Cucharón - Tipica,13600,4400,18000
16130,16131,21-10-2020 15:50:52.463821,Mexicana,Mexicanachos,35000,3900,38900
16131,16132,21-10-2020 15:50:52.663834,Típica,El Mondongo y Mucho Mas,35000,5600,40600
16132,16133,21-10-2020 15:50:53.063730,Desayunos · Típica,Parrilla Farandula Típico,35000,5900,40900
16133,16134,21-10-2020 15:50:53.463736,Perros Calientes,Dog Shop - Rapida,17800,4900,22700
16134,16135,21-10-2020 15:50:53.813425,Hamburguesas · Panadería,NYC Burgers,11870,6200,18070
16135,16136,21-10-2020 15:50:54.113195,Desayunos · Típica,Calentao Express,70000,6000,76000
16136,16137,21-10-2020 15:50:54.263200,Mexicana,Hidalgo Taquería,13000,4900,17900
16137,16138,21-10-2020 15:50:54.562947,Desayunos · Café,vereda central calle 99,37900,5700,43600
16138,16139,21-10-2020 15:50:54.762319,Sushi · Asiática,Tu Sushi,29500,6400,35900
16139,16140,21-10-2020 15:50:55.011744,Hamburguesas,Bendito Cordero,29500,5800,35300
16140,16141,21-10-2020 15:50:55.211261,Saludable · Desayunos,Guadalupe - Fruteria,39700,5900,45600
16141,16142,21-10-2020 15:50:55.461289,Desayunos · Café,Moramia,15000,4700,19700
16142,16143,21-10-2020 15:50:55.610816,China,China Food Col,24300,3600,27900
16143,16144,21-10-2020 15:50:55.810298,Parrilla,El Tambor,48750,6800,55550
16144,16145,21-10-2020 15:50:56.059640,Desayunos · Empanadas,Empanadas Doraditas.com,27800,3000,30800
16145,16146,21-10-2020 15:50:56.208964,Postres,La Tertulia,17800,3400,21200
16146,16147,21-10-2020 15:50:56.558544,Postres · Saludable,Ana Rebana,11870,6300,18170
16147,16148,21-10-2020 15:50:56.708191,Parrilla,Beraca Parrilla Bbq,7500,5600,13100
16148,16149,21-10-2020 15:50:56.958019,Desayunos · Típica,Peninsula Calentados y Parrilla,35000,3400,38400
16149,16150,21-10-2020 15:50:57.307412,Típica,Campo Victoria,48750,3000,51750
16150,16151,21-10-2020 15:50:57.607827,Saludable · Desayunos,Distrito Gourmet,53900,3700,57600
16151,16152,21-10-2020 15:50:57.807847,Peruana · Internacional,La Chifería,35000,6600,41600
16152,16153,21-10-2020 15:50:58.158084,Saludable · Típica,Sopas Mrg,31800,3100,34900
16153,16154,21-10-2020 15:50:58.507524,Típica · Parrilla,Typykos,53900,6000,59900
16154,16155,21-10-2020 15:50:58.906806,Parrilla,Beraca Parrilla Bbq,9000,5600,14600
16155,16156,21-10-2020 15:50:59.206252,Pollo,Señor Fantástico,15000,4700,19700
16156,16157,21-10-2020 15:50:59.456290,Desayunos · Típica,Calentao Express,31800,6000,37800
16157,16158,21-10-2020 15:50:59.655955,Pizza · Italiana,Piatto - Pizza,9000,6600,15600
16158,16159,21-10-2020 15:51:00.005330,Típica,Cabrito Santandereano,65000,6600,71600
16159,16160,21-10-2020 15:51:00.255665,Sushi,Canoa To Go,13000,5900,18900
16160,16161,21-10-2020 15:51:00.605169,Postres,Toledo Pastelería,53900,6800,60700
16161,16162,21-10-2020 15:51:00.954743,Típica · Parrilla,Mi Ranchito Parrilla,15000,4400,19400
16162,16163,21-10-2020 15:51:01.204264,Parrilla,Coquitas,11870,5600,17470
16163,16164,21-10-2020 15:51:01.603967,Típica,La Cocina,35000,4600,39600
16164,16165,21-10-2020 15:51:01.953743,Hamburguesas,Burger Society,35000,4100,39100
16165,16166,21-10-2020 15:51:02.153582,Pollo,Señor Fantástico,24300,4700,29000
16166,16167,21-10-2020 15:51:02.353249,Desayunos,Desayunos en Bogotá,39700,3400,43100
16167,16168,21-10-2020 15:51:02.502231,Saludable · Desayunos,Distrito Gourmet,70000,3700,73700
16168,16169,21-10-2020 15:51:02.702491,Sushi · Desayunos,Maki Roll,11870,4300,16170
16169,16170,21-10-2020 15:51:03.001864,Saludable · Desayunos,Agua Dulce,29500,3700,33200
16170,16171,21-10-2020 15:51:03.201198,Pizza · Italiana,Piatto - Pizza,23000,6600,29600
16171,16172,21-10-2020 15:51:03.550822,Pizza · Parrilla,Urban Lunch,15000,4000,19000
16172,16173,21-10-2020 15:51:03.750106,Hamburguesas · Alitas,Beer,18900,6600,25500
16173,16174,21-10-2020 15:51:04.149800,Saludable · Típica,Sopas Mrg,8900,3100,12000
16174,16175,21-10-2020 15:51:04.499779,Desayunos · Panadería,Le Pain Quotidien,13000,3900,16900
16175,16176,21-10-2020 15:51:04.849266,Asiática,TeT,39700,5900,45600
16176,16177,21-10-2020 15:51:05.048913,Saludable · Desayunos,Fresh Co,31800,5600,37400
16177,16178,21-10-2020 15:51:05.298607,Pizza · Italiana,Piatto - Pizza,9000,6600,15600
16178,16179,21-10-2020 15:51:05.447959,Pollo · Pescados y Mariscos,Bang Bang Rice,18900,3400,22300
16179,16180,21-10-2020 15:51:05.747927,Postres · Desayunos,Maltihelado,7500,4500,12000
16180,16181,21-10-2020 15:51:05.947794,Típica,Sabores De Mi Tierra,18900,5400,24300
16181,16182,21-10-2020 15:51:06.147452,Pollo · Típica,Auyama,15000,3900,18900
16182,16183,21-10-2020 15:51:06.347764,Sánduches · China,Peru Mix,24200,5900,30100
16183,16184,21-10-2020 15:51:06.647310,Saludable · Desayunos,Raices Bienestar Gourmet,31800,6600,38400
16184,16185,21-10-2020 15:51:06.896999,Típica · Parrilla,La Parilla de David,7500,3100,10600
16185,16186,21-10-2020 15:51:07.146617,Desayunos · Típica,Peninsula Calentados y Parrilla,39700,3400,43100
16186,16187,21-10-2020 15:51:07.295765,Pollo · Desayunos,Piaf,15600,6500,22100
16187,16188,21-10-2020 15:51:07.695419,Desayunos · Café,Matchacha,34500,5900,40400
16188,16189,21-10-2020 15:51:07.946063,Saludable · Desayunos,Fresh Co,34500,5600,40100
16189,16190,21-10-2020 15:51:08.246164,Hamburguesas,Burger Society,13000,4100,17100
16190,16191,21-10-2020 15:51:08.396252,Postres,Levelma,23000,6200,29200
16191,16192,21-10-2020 15:51:08.695595,Parrilla,Parrilla Pimentón,29500,3400,32900
16192,16193,21-10-2020 15:51:09.045279,Pescados y Mariscos,Pescadero Héroes del Mar,24300,6600,30900
16193,16194,21-10-2020 15:51:09.395195,Típica,La Olla de Barro,13600,5300,18900
16194,16195,21-10-2020 15:51:09.595073,Desayunos,El Corral - Desayunos,24300,5000,29300
16195,16196,21-10-2020 15:51:09.994834,Sushi,Umi,48750,5600,54350
16196,16197,21-10-2020 15:51:10.344420,Parrilla,El Tambor,15000,6800,21800
16197,16198,21-10-2020 15:51:10.543720,Desayunos · Sánduches,Frutos del Bosque,15600,3500,19100
16198,16199,21-10-2020 15:51:10.893079,Helados,Orso To Go,17800,6800,24600
16199,16200,21-10-2020 15:51:11.092819,Desayunos · Café,Moramia,39700,4700,44400
16200,16201,21-10-2020 15:51:11.342426,Desayunos · Típica,Fogón Sangileño,35000,5000,40000
16201,16202,21-10-2020 15:51:11.642781,Pizza · Italiana,Piatto - Pizza,37900,6600,44500
16202,16203,21-10-2020 15:51:11.792513,Típica,Bendita S,15000,4600,19600
16203,16204,21-10-2020 15:51:12.192204,Parrilla,Rústico Picadería,13600,3800,17400
16204,16205,21-10-2020 15:51:12.392049,Típica · Parrilla,La Parilla de David,23000,3100,26100
16205,16206,21-10-2020 15:51:12.791833,Parrilla · Internacional,Taperia de la Plaza,24300,5700,30000
16206,16207,21-10-2020 15:51:12.992898,Pollo · Desayunos,Abasto,35000,3600,38600
16207,16208,21-10-2020 15:51:13.292727,Pizza,Pizza Andante,17800,6300,24100
16208,16209,21-10-2020 15:51:13.642901,Parrilla,Arepaisa de Medellín,15600,5600,21200
16209,16210,21-10-2020 15:51:14.042986,Desayunos · Típica,Rojo Gourmet,13600,4700,18300
16210,16211,21-10-2020 15:51:14.342841,Desayunos · Panadería,Pasteleite,48750,5900,54650
16211,16212,21-10-2020 15:51:14.542282,Desayunos · Empanadas,Mis Delicias,24200,3200,27400
16212,16213,21-10-2020 15:51:14.891426,Desayunos,Fratelli - Desayunos,15000,4600,19600
16213,16214,21-10-2020 15:51:15.291386,Sushi,Umi,27800,5600,33400
16214,16215,21-10-2020 15:51:15.691014,Desayunos · Sánduches,Danilo Colombia,24200,3300,27500
16215,16216,21-10-2020 15:51:15.840387,Pizza · Parrilla,Urban Lunch,53900,4000,57900
16216,16217,21-10-2020 15:51:16.189777,Saludable · Desayunos,Bawana - Sandwich,48750,3400,52150
16217,16218,21-10-2020 15:51:16.489459,Parrilla,Beraca Parrilla Bbq,23000,5600,28600
16218,16219,21-10-2020 15:51:16.788907,Hamburguesas · Alitas,Beer,24200,6600,30800
16219,16220,21-10-2020 15:51:16.988726,Desayunos · Típica,Rojo Gourmet,11870,4700,16570
16220,16221,21-10-2020 15:51:17.338303,Desayunos · Café,El Gualilo,17800,6200,24000
16221,16222,21-10-2020 15:51:17.587915,Parrilla,Antojo a Domicilio,18900,5000,23900
16222,16223,21-10-2020 15:51:17.937676,Hamburguesas,Monchis - Hamburguesa,65000,4300,69300
16223,16224,21-10-2020 15:51:18.138488,Panadería,Boul,65000,3100,68100
16224,16225,21-10-2020 15:51:18.288510,Desayunos,Cafetería el Kippe,35000,3200,38200
16225,16226,21-10-2020 15:51:18.688858,Italiana,F*cking Good Pizza,45800,4200,50000
16226,16227,21-10-2020 15:51:18.838432,Saludable · Desayunos,La Estampilla,15600,6000,21600
16227,16228,21-10-2020 15:51:19.087840,Sushi,Sushi Reel,24200,4700,28900
16228,16229,21-10-2020 15:51:19.438814,Comida Rápida,Fiesta Digital Andrés,23000,3100,26100
16229,16230,21-10-2020 15:51:19.688635,Peruana · Internacional,La Chifería,35000,6600,41600
16230,16231,21-10-2020 15:51:19.888342,Panadería,Boul,39700,3100,42800
16231,16232,21-10-2020 15:51:20.087562,Pollo · China,China Tao,29500,3500,33000
16232,16233,21-10-2020 15:51:20.338049,Peruana,Masivo,70000,5800,75800
16233,16234,21-10-2020 15:51:20.487892,Desayunos · Jugos y Batidos,Frutiwow,15000,4100,19100
16234,16235,21-10-2020 15:51:20.738498,Desayunos · Típica,Criollomania,9000,5200,14200
16235,16236,21-10-2020 15:51:21.138863,Saludable,Puro Verde,27800,5700,33500
16236,16237,21-10-2020 15:51:21.439541,Desayunos · Panadería,Le Pain Quotidien,8900,3900,12800
16237,16238,21-10-2020 15:51:21.788897,Típica · Parrilla,Toya,15600,4200,19800
16238,16239,21-10-2020 15:51:22.188349,Saludable · Desayunos,Maracuyá,29500,6700,36200
16239,16240,21-10-2020 15:51:22.438540,Helados,Buon Gelato,15600,4400,20000
16240,16241,21-10-2020 15:51:22.638345,Pollo · Desayunos,Abasto,15600,3600,19200
16241,16242,21-10-2020 15:51:22.937915,Desayunos · Comida Rápida,Chocolatto,29500,3400,32900
16242,16243,21-10-2020 15:51:23.087053,Típica · Parrilla,El Santandereano,11870,5200,17070
16243,16244,21-10-2020 15:51:23.387716,Saludable,Amor Propio saludable,17800,4000,21800
16244,16245,21-10-2020 15:51:23.737871,Desayunos · Típica,D´Porco,53900,3900,57800
16245,16246,21-10-2020 15:51:24.087703,Saludable · Desayunos,Libre de Culpa,23000,4000,27000
16246,16247,21-10-2020 15:51:24.287357,Postres · Desayunos,Jacques Pastelería,27800,5900,33700
16247,16248,21-10-2020 15:51:24.436769,Saludable · Desayunos,Fresh Co,45800,5600,51400
16248,16249,21-10-2020 15:51:24.686482,Saludable,A2manos,53400,4200,57600
16249,16250,21-10-2020 15:51:24.937524,Sushi · Desayunos,Maki Roll,17800,4300,22100
16250,16251,21-10-2020 15:51:25.088122,Desayunos · Parrilla,Mi Patria,53900,4600,58500
16251,16252,21-10-2020 15:51:25.239193,Desayunos · Helados,San Giorgio Gelateria,24200,3100,27300
16252,16253,21-10-2020 15:51:25.640143,Alta Cocina · Italiana,Trattoria de la Plaza,27800,6000,33800
16253,16254,21-10-2020 15:51:25.839774,Postres · Desayunos,La Folie - Postres,35000,3300,38300
16254,16255,21-10-2020 15:51:25.989015,Típica,Carbón & Mondongos,15600,6400,22000
16255,16256,21-10-2020 15:51:26.239005,Desayunos · Italiana,Rceta By Rausch,17800,3600,21400
16256,16257,21-10-2020 15:51:26.438710,Saludable,A2manos,31800,4200,36000
16257,16258,21-10-2020 15:51:26.838474,Pollo · Desayunos,Piaf,23000,6500,29500
16258,16259,21-10-2020 15:51:27.187960,Desayunos · Pescados y Mariscos,Luzí­a - Mediterranea,13600,5700,19300
16259,16260,21-10-2020 15:51:27.487821,Típica · Parrilla,La Parilla de David,13000,3100,16100
16260,16261,21-10-2020 15:51:27.837521,Postres · Desayunos,Vivalight Market.,34500,6500,41000
16261,16262,21-10-2020 15:51:28.187734,Comida Rápida,Fiesta Digital Andrés,13600,3100,16700
16262,16263,21-10-2020 15:51:28.588064,Desayunos,Jacinta Arepas de Huevo,27800,4000,31800
16263,16264,21-10-2020 15:51:28.987677,Desayunos · Típica,D'Porco - Lechona,17800,6300,24100
16264,16265,21-10-2020 15:51:29.337087,Parrilla,Carnes la Zarza,53900,4900,58800
16265,16266,21-10-2020 15:51:29.736492,Asiática,Thai Station,24300,6000,30300
16266,16267,21-10-2020 15:51:29.986153,Postres · Desayunos,Jacques Pastelería,70000,5900,75900
16267,16268,21-10-2020 15:51:30.286079,Café · Helados,Sofia heladería y café,31800,5800,37600
16268,16269,21-10-2020 15:51:30.686035,Desayunos · Típica,D'Porco - Lechona,29500,6300,35800
16269,16270,21-10-2020 15:51:30.936102,Internacional,Rio Sabores y Experiencias,8900,4100,13000
16270,16271,21-10-2020 15:51:31.335637,Desayunos · Helados,San Giorgio Gelateria,35000,3100,38100
16271,16272,21-10-2020 15:51:31.636228,Desayunos · Típica,Fogón Sangileño,7500,5000,12500
16272,16273,21-10-2020 15:51:32.035736,Saludable · Desayunos,Distrito Gourmet,48750,3700,52450
16273,16274,21-10-2020 15:51:32.335386,Saludable · Típica,Sopas Mrg,12500,3100,15600
16274,16275,21-10-2020 15:51:32.734923,Postres,La Tertulia,15000,3400,18400
16275,16276,21-10-2020 15:51:33.084281,Saludable · Parrilla,The Angels Grill and Drinks,15600,6200,21800
16276,16277,21-10-2020 15:51:33.233886,Desayunos · Típica,Desayunadero de la 42,53400,5900,59300
16277,16278,21-10-2020 15:51:33.483760,Postres · Café,Loló Coffee & Snacks,53900,4600,58500
16278,16279,21-10-2020 15:51:33.834188,Asiática,Thai Station,15000,6000,21000
16279,16280,21-10-2020 15:51:34.184049,Postres · Desayunos,Sweet Tale,23000,5800,28800
16280,16281,21-10-2020 15:51:34.383898,Sushi,Umi,12500,5600,18100
16281,16282,21-10-2020 15:51:34.533404,Hamburguesas,Bendito Cordero,7500,5800,13300
16282,16283,21-10-2020 15:51:34.932783,Saludable · Típica,Saludable Mrg,39700,5800,45500
16283,16284,21-10-2020 15:51:35.082641,Poke,Poke Go,15600,4600,20200
16284,16285,21-10-2020 15:51:35.332327,Saludable · Desayunos,Básico y elemental,39700,5000,44700
16285,16286,21-10-2020 15:51:35.481974,Saludable · Parrilla,Box,15000,3700,18700
16286,16287,21-10-2020 15:51:35.631838,Saludable · Típica,Saludable Mrg,7500,5800,13300
16287,16288,21-10-2020 15:51:36.031569,Pizza,18 Scalini,12500,4300,16800
16288,16289,21-10-2020 15:51:36.281680,Típica,Campo Victoria,27800,3000,30800
16289,16290,21-10-2020 15:51:36.481328,Desayunos · Jugos y Batidos,Frutiwow,24200,4100,28300
16290,16291,21-10-2020 15:51:36.630785,Típica,Bandejas Mrg,9000,3800,12800
16291,16292,21-10-2020 15:51:36.880391,Típica,Cabrito Santandereano,31800,6600,38400
16292,16293,21-10-2020 15:51:37.280646,Hamburguesas · Saludable,Restaurant Inn,39700,6100,45800
16293,16294,21-10-2020 15:51:37.430359,Postres · Desayunos,Sweet Tale,37900,5800,43700
16294,16295,21-10-2020 15:51:37.630838,Desayunos · Típica,D´Porco,11870,3900,15770
16295,16296,21-10-2020 15:51:37.830049,Desayunos · Sánduches,Danilo Colombia,24200,3300,27500
16296,16297,21-10-2020 15:51:38.029420,Desayunos · Panadería,Premium Break Bakery,27800,3700,31500
16297,16298,21-10-2020 15:51:38.281436,Desayunos,Jacinta Arepas de Huevo,53900,4000,57900
16298,16299,21-10-2020 15:51:38.581314,Saludable · Típica,Saludable Mrg,15000,5800,20800
16299,16300,21-10-2020 15:51:38.781341,Desayunos · Panadería,Juliana Restaurante,31800,6100,37900
16300,16301,21-10-2020 15:51:38.982340,Desayunos · Típica,Cochon,70000,3300,73300
16301,16302,21-10-2020 15:51:39.132579,Desayunos · Típica,Parrilla Farandula Típico,35000,5900,40900
16302,16303,21-10-2020 15:51:39.432795,Típica,Sopitas y Más,9000,4200,13200
16303,16304,21-10-2020 15:51:39.683092,Desayunos,Archies Desayunos,35000,3100,38100
16304,16305,21-10-2020 15:51:39.832469,Desayunos · Pescados y Mariscos,Gypsy Bistro,29500,4500,34000
16305,16306,21-10-2020 15:51:40.182128,Desayunos,Archies Desayunos,70000,3100,73100
16306,16307,21-10-2020 15:51:40.432655,Típica · Parrilla,Mi Ranchito Parrilla,53900,4400,58300
16307,16308,21-10-2020 15:51:40.682709,Desayunos,Sunny Breakfast Brunch,8900,4300,13200
16308,16309,21-10-2020 15:51:41.082236,Desayunos · Jugos y Batidos,Frutiwow,7500,4100,11600
16309,16310,21-10-2020 15:51:41.332033,Desayunos,Bagel Shop,7500,3200,10700
16310,16311,21-10-2020 15:51:41.732037,Postres · Desayunos,Buñuelos nacho,45800,6600,52400
16311,16312,21-10-2020 15:51:41.881470,Típica · Parrilla,El Portal de la Antigua,12500,5600,18100
16312,16313,21-10-2020 15:51:42.131312,Pizza,18 Scalini,53900,4300,58200
16313,16314,21-10-2020 15:51:42.431937,Crepes,San Crepes,70000,4900,74900
16314,16315,21-10-2020 15:51:42.632645,Desayunos · Sánduches,Frutos del Bosque,13600,3500,17100
16315,16316,21-10-2020 15:51:42.882344,Pizza · Italiana,Piatto - Pizza,18900,6600,25500
16316,16317,21-10-2020 15:51:43.031885,Desayunos,La Frijolada Desayunos,11870,4400,16270
16317,16318,21-10-2020 15:51:43.331663,Desayunos · Café,Frambas,53400,3400,56800
16318,16319,21-10-2020 15:51:43.531754,Desayunos,Desayunos en Bogotá,34500,3400,37900
16319,16320,21-10-2020 15:51:43.732232,Pollo · Desayunos,Candelina,53900,5300,59200
16320,16321,21-10-2020 15:51:44.033172,Desayunos · Café,Libertario Coffee Roasters,13000,4600,17600
16321,16322,21-10-2020 15:51:44.332893,Hamburguesas · Pescados y Mariscos,El Velero,10700,6500,17200
16322,16323,21-10-2020 15:51:44.633216,Parrilla,Carnes la Zarza,65000,4900,69900
16323,16324,21-10-2020 15:51:44.783355,Desayunos,Sr Buñuelo,7500,6400,13900
16324,16325,21-10-2020 15:51:45.183058,Peruana,Uma Cantina Peruana,15600,3200,18800
16325,16326,21-10-2020 15:51:45.483033,Parrilla · Café,Figaro Café/ Restaurante Argentino,53900,5800,59700
16326,16327,21-10-2020 15:51:45.733103,Saludable · Típica,Saludable Mrg,35000,5800,40800
16327,16328,21-10-2020 15:51:45.882458,Pollo · Saludable,Gratina,7500,4200,11700
16328,16329,21-10-2020 15:51:46.082330,Desayunos · Café,El Gualilo,8900,6200,15100
16329,16330,21-10-2020 15:51:46.382076,Pizza,Pastas Laurentina,35000,4800,39800
16330,16331,21-10-2020 15:51:46.531752,Desayunos,Señor Desayuno,11870,6800,18670
16331,16332,21-10-2020 15:51:46.731504,Postres · Café,Celestino Café,13000,5900,18900
16332,16333,21-10-2020 15:51:47.131668,Desayunos · Árabe,Boniato Sabores Vivos,18900,5300,24200
16333,16334,21-10-2020 15:51:47.531797,Desayunos · Típica,Alce,10700,4900,15600
16334,16335,21-10-2020 15:51:47.681760,Típica,Sopitas y Más,53900,4200,58100
16335,16336,21-10-2020 15:51:47.831253,Postres · Café,Loló Coffee & Snacks,24300,4600,28900
16336,16337,21-10-2020 15:51:48.081546,Sushi · Asiática,Tu Sushi,10700,6400,17100
16337,16338,21-10-2020 15:51:48.231593,Postres · Desayunos,La Folie - Postres,23000,3300,26300
16338,16339,21-10-2020 15:51:48.381523,Parrilla · Café,Gaira Café,8900,4400,13300
16339,16340,21-10-2020 15:51:48.631762,Saludable · Parrilla,Box,13000,3700,16700
16340,16341,21-10-2020 15:51:48.881082,Postres · Desayunos,KOKOA & co.,65000,4700,69700
16341,16342,21-10-2020 15:51:49.131969,Desayunos · Típica,D'Porco - Lechona,29500,6300,35800
16342,16343,21-10-2020 15:51:49.481886,Saludable,Ventura Soup y Salad,65000,3800,68800
16343,16344,21-10-2020 15:51:49.731890,Desayunos · Típica,La Parrilla Dorada Polo,35000,6600,41600
16344,16345,21-10-2020 15:51:50.081760,Parrilla,El Tambor,34500,6800,41300
16345,16346,21-10-2020 15:51:50.381548,Pescados y Mariscos,La Gran Cazuela,48750,3200,51950
16346,16347,21-10-2020 15:51:50.681472,Postres · Desayunos,Vivalight Market.,12500,6500,19000
16347,16348,21-10-2020 15:51:50.930902,Postres · Desayunos,Jacques Pastelería,8900,5900,14800
16348,16349,21-10-2020 15:51:51.080423,Típica,Sopitas y Más,37900,4200,42100
16349,16350,21-10-2020 15:51:51.330351,Pescados y Mariscos,Fish Place - Del Mar,45800,5400,51200
16350,16351,21-10-2020 15:51:51.680758,Postres,Levelma,34500,6200,40700
16351,16352,21-10-2020 15:51:52.080930,Típica,Carbón & Mondongos,31800,6400,38200
16352,16353,21-10-2020 15:51:52.381275,Pollo · Pescados y Mariscos,Bang Bang Rice,15000,3400,18400
16353,16354,21-10-2020 15:51:52.731143,Típica,Sabores De Mi Tierra,70000,5400,75400
16354,16355,21-10-2020 15:51:53.030889,Sushi,Sushi Reel,37900,4700,42600
16355,16356,21-10-2020 15:51:53.380543,Parrilla,Campocina,10700,4600,15300
16356,16357,21-10-2020 15:51:53.680431,Desayunos · Típica,D'Porco - Lechona,37900,6300,44200
16357,16358,21-10-2020 15:51:54.080547,Desayunos,Jacinta Arepas de Huevo,7500,4000,11500
16358,16359,21-10-2020 15:51:54.231549,Sánduches · Pescados y Mariscos,Pacific Comida de Mar,48750,4000,52750
16359,16360,21-10-2020 15:51:54.481799,Típica · Parrilla,Toya,17800,4200,22000
16360,16361,21-10-2020 15:51:54.731264,Saludable,Amor Propio saludable,24300,4000,28300
16361,16362,21-10-2020 15:51:55.080766,Desayunos · Pescados y Mariscos,Gypsy Bistro,65000,4500,69500
16362,16363,21-10-2020 15:51:55.330112,Saludable,The Good Rice Bowls,23000,3500,26500
16363,16364,21-10-2020 15:51:55.680074,Jugos y Batidos,Pomponio,24200,3600,27800
16364,16365,21-10-2020 15:51:55.879786,Postres · Desayunos,Sweet Tale,35000,5800,40800
16365,16366,21-10-2020 15:51:56.129472,Parrilla,Rústico Picadería,9000,3800,12800
16366,16367,21-10-2020 15:51:56.328816,Postres · Panadería,RIGHT AWAY FOODS,23000,6600,29600
16367,16368,21-10-2020 15:51:56.478814,Desayunos · Panadería,Artesanos,24300,4300,28600
16368,16369,21-10-2020 15:51:56.778787,Postres · Desayunos,Sharmus,9000,6100,15100
16369,16370,21-10-2020 15:51:56.978237,Hamburguesas,Burger Society,45800,4100,49900
16370,16371,21-10-2020 15:51:57.177908,Postres · Desayunos,Café Quindio,39700,5700,45400
16371,16372,21-10-2020 15:51:57.578094,Hamburguesas,Gofi Burger,24300,5100,29400
16372,16373,21-10-2020 15:51:57.978259,Desayunos · Panadería,Ficchi Panadería,8900,3100,12000
16373,16374,21-10-2020 15:51:58.228364,Postres · Desayunos,Café Quindio,11870,5700,17570
16374,16375,21-10-2020 15:51:58.478148,Típica,El Cucharón - Tipica,27800,4400,32200
16375,16376,21-10-2020 15:51:58.678107,Pollo · Sánduches,Pollos Century,17800,3000,20800
16376,16377,21-10-2020 15:51:58.927477,Pollo · Desayunos,Workzone,27800,3100,30900
16377,16378,21-10-2020 15:51:59.229260,Desayunos · Típica,90 Calentados,13000,3700,16700
16378,16379,21-10-2020 15:51:59.430183,Pollo · China,China Tao,15000,3500,18500
16379,16380,21-10-2020 15:51:59.580344,Comida Rápida · Perros Calientes,Similoa - Comida Rapida,18900,3700,22600
16380,16381,21-10-2020 15:51:59.930497,Saludable · Parrilla,Box,53400,3700,57100
16381,16382,21-10-2020 15:52:00.230856,Postres · Helados,Mahé,13600,6000,19600
16382,16383,21-10-2020 15:52:00.380637,Parrilla,Antojo a Domicilio,8900,5000,13900
16383,16384,21-10-2020 15:52:00.530471,Helados,Buon Gelato,27800,4400,32200
16384,16385,21-10-2020 15:52:00.680765,Desayunos · Típica,Casa Vieja,23000,6000,29000
16385,16386,21-10-2020 15:52:00.930358,Típica · Parrilla,El Portal de la Antigua,45800,5600,51400
16386,16387,21-10-2020 15:52:01.180285,Parrilla,Rústico Picadería,48750,3800,52550
16387,16388,21-10-2020 15:52:01.430543,Desayunos · Mexicana,La Mera Mera - Mexicana,23000,3100,26100
16388,16389,21-10-2020 15:52:01.830877,Postres,Levelma,23000,6200,29200
16389,16390,21-10-2020 15:52:02.080938,Pollo · Pescados y Mariscos,Bang Bang Rice,7500,3400,10900
16390,16391,21-10-2020 15:52:02.231308,Postres,La Galeta,24300,3000,27300
16391,16392,21-10-2020 15:52:02.581155,Desayunos · Café,El Gualilo,15000,6200,21200
16392,16393,21-10-2020 15:52:02.831404,Pollo · Desayunos,Workzone,13600,3100,16700
16393,16394,21-10-2020 15:52:03.231784,Parrilla,Coquitas,53900,5600,59500
16394,16395,21-10-2020 15:52:03.381736,Asiática,Thai Station,27800,6000,33800
16395,16396,21-10-2020 15:52:03.581914,Postres · Desayunos,Sharmus,23000,6100,29100
16396,16397,21-10-2020 15:52:03.731610,Postres · Desayunos,Sweet Tale,13600,5800,19400
16397,16398,21-10-2020 15:52:03.881310,Desayunos · Panadería,Siena Café,48750,3700,52450
16398,16399,21-10-2020 15:52:04.030938,Desayunos,El Fogón Castellano,12500,3200,15700
16399,16400,21-10-2020 15:52:04.381774,Postres · Desayunos,Aury Postres - Comidas & Picadas,9000,4700,13700
16400,16401,21-10-2020 15:52:04.532068,Saludable · Desayunos,Básico y elemental,27800,5000,32800
16401,16402,21-10-2020 15:52:04.682409,Saludable · Desayunos,Re.al Alimentos Reales,13000,4000,17000
16402,16403,21-10-2020 15:52:05.032907,Típica,Sabores De Mi Tierra,12500,5400,17900
16403,16404,21-10-2020 15:52:05.383166,Parrilla · Café,Figaro Café/ Restaurante Argentino,53900,5800,59700
16404,16405,21-10-2020 15:52:05.633342,Típica,Baondish,24300,5800,30100
16405,16406,21-10-2020 15:52:05.782987,Parrilla,Arroces Maria Paula,12500,6800,19300
16406,16407,21-10-2020 15:52:06.033050,Típica · Parrilla,El Portal de la Antigua,39700,5600,45300
16407,16408,21-10-2020 15:52:06.433875,Asiática,TeT,7500,5900,13400
16408,16409,21-10-2020 15:52:06.583265,Típica · Parrilla,Parrilla Farandula Gourmet,39700,5100,44800
16409,16410,21-10-2020 15:52:06.932978,Desayunos · Típica,D'Porco - Lechona,45800,6300,52100
16410,16411,21-10-2020 15:52:07.082733,Mexicana,Cantina La 15,65000,4300,69300
16411,16412,21-10-2020 15:52:07.233362,Sushi · Asiática,Arigato,23000,5300,28300
16412,16413,21-10-2020 15:52:07.433294,Saludable · Desayunos,Agua Dulce,53400,3700,57100
16413,16414,21-10-2020 15:52:07.633290,Alta Cocina · Parrilla,Criterión,10700,6000,16700
16414,16415,21-10-2020 15:52:07.833296,Postres · Desayunos,Café Quindio,24300,5700,30000
16415,16416,21-10-2020 15:52:07.982796,Típica,Sopitas y Más,39700,4200,43900
16416,16417,21-10-2020 15:52:08.332999,Desayunos · Jugos y Batidos,Kuriwaji,17800,6300,24100
16417,16418,21-10-2020 15:52:08.632999,Pizza,pizza andante,34500,4200,38700
16418,16419,21-10-2020 15:52:08.933081,Postres,Levelma,13600,6200,19800
16419,16420,21-10-2020 15:52:09.083007,Mexicana,Cantina La 15,13600,4300,17900
16420,16421,21-10-2020 15:52:09.232967,Postres · Desayunos,KOKOA & co.,13600,4700,18300
16421,16422,21-10-2020 15:52:09.434087,Postres · Desayunos,Café Quindio,48750,5700,54450
16422,16423,21-10-2020 15:52:09.635179,Postres · Desayunos,Vivalight Market.,8900,6500,15400
16423,16424,21-10-2020 15:52:09.835295,Postres,Toledo Pastelería,10700,6800,17500
16424,16425,21-10-2020 15:52:10.185607,Desayunos · Café,Norma's Ice Cream Café,34500,6300,40800
16425,16426,21-10-2020 15:52:10.585944,Desayunos,Sunny Breakfast Brunch,15600,4300,19900
16426,16427,21-10-2020 15:52:10.736110,Postres · Desayunos,Jacques Pastelería,48750,5900,54650
16427,16428,21-10-2020 15:52:11.136844,Postres · Desayunos,Amelie Helados,27800,6400,34200
16428,16429,21-10-2020 15:52:11.287444,Postres · Desayunos,La Folie - Postres,34500,3300,37800
16429,16430,21-10-2020 15:52:11.537591,Parrilla,Arroces Maria Paula,7500,6800,14300
16430,16431,21-10-2020 15:52:11.938280,Postres,Toledo Pastelería,39700,6800,46500
16431,16432,21-10-2020 15:52:12.188485,Pollo · China,China Tao,53400,3500,56900
16432,16433,21-10-2020 15:52:12.538442,Desayunos · Típica,Alce,53400,4900,58300
16433,16434,21-10-2020 15:52:12.738272,Pollo · Saludable,Yerbabuena,8900,3900,12800
16434,16435,21-10-2020 15:52:12.938359,Típica · Parrilla,Parrilla Farandula Gourmet,23000,5100,28100
16435,16436,21-10-2020 15:52:13.238646,Postres · Desayunos,Cosmo Cookies,15000,5900,20900
16436,16437,21-10-2020 15:52:13.539065,Desayunos · Café,Libertario Coffee Roasters,12500,4600,17100
16437,16438,21-10-2020 15:52:13.739050,Típica · Pescados y Mariscos,La Vitualla,48750,6300,55050
16438,16439,21-10-2020 15:52:13.939629,Pescados y Mariscos,Fish Place - Del Mar,39700,5400,45100
16439,16440,21-10-2020 15:52:14.190522,Helados,Orso To Go,65000,6800,71800
16440,16441,21-10-2020 15:52:14.491697,Italiana,F*cking Good Pizza,8900,4200,13100
16441,16442,21-10-2020 15:52:14.891899,Postres · Desayunos,KOKOA & co.,24200,4700,28900
16442,16443,21-10-2020 15:52:15.242572,Desayunos,Señor Desayuno,31800,6800,38600
16443,16444,21-10-2020 15:52:15.642953,Pollo · China,China Tao,35000,3500,38500
16444,16445,21-10-2020 15:52:15.992954,Postres · Desayunos,Sharmus,12500,6100,18600
16445,16446,21-10-2020 15:52:16.393660,Desayunos · Panadería,Pasteleite,15000,5900,20900
16446,16447,21-10-2020 15:52:16.743852,Peruana,Uma Cantina Peruana,8900,3200,12100
16447,16448,21-10-2020 15:52:17.148598,Postres · Panadería,RIGHT AWAY FOODS,18900,6600,25500
16448,16449,21-10-2020 15:52:17.448905,Típica · Parrilla,Typykos,31800,6000,37800
16449,16450,21-10-2020 15:52:17.649913,Desayunos · Café,El Gualilo,8900,6200,15100
16450,16451,21-10-2020 15:52:17.900220,Típica · Parrilla,El Santandereano,53400,5200,58600
16451,16452,21-10-2020 15:52:18.151398,Pizza,pizza andante,34500,4200,38700
16452,16453,21-10-2020 15:52:18.502132,Típica · Parrilla,La Parilla de David,45800,3100,48900
16453,16454,21-10-2020 15:52:18.652309,Postres · Desayunos,Restaurante Cornelia,53400,5500,58900
16454,16455,21-10-2020 15:52:19.002958,Hamburguesas · Desayunos,El Inglés Gastro Pub,35000,6600,41600
16455,16456,21-10-2020 15:52:19.153052,Desayunos · Empanadas,Empanadas Doraditas.com,27800,3000,30800
16456,16457,21-10-2020 15:52:19.303603,Típica · Pescados y Mariscos,La Vitualla,11870,6300,18170
16457,16458,21-10-2020 15:52:19.654682,Parrilla,Campocina,15000,4600,19600
16458,16459,21-10-2020 15:52:19.904566,Parrilla,OAK Ahumado y Brebajes,35000,6000,41000
16459,16460,21-10-2020 15:52:20.256582,Alta Cocina · Italiana,Trattoria de la Plaza,10700,6000,16700
16460,16461,21-10-2020 15:52:20.407579,Desayunos,Fratelli - Desayunos,70000,4600,74600
16461,16462,21-10-2020 15:52:20.608801,Pollo,Oliva Va,23000,5600,28600
16462,16463,21-10-2020 15:52:20.909796,Típica,Lo Nuestro,70000,3100,73100
16463,16464,21-10-2020 15:52:21.311173,Perros Calientes,Dog Shop - Rapida,34500,4900,39400
16464,16465,21-10-2020 15:52:21.512062,Postres · Desayunos,Sweet Tale,13600,5800,19400
16465,16466,21-10-2020 15:52:21.812729,Sushi · Asiática,Arigato,13600,5300,18900
16466,16467,21-10-2020 15:52:21.963997,Parrilla,OAK Ahumado y Brebajes,27800,6000,33800
16467,16468,21-10-2020 15:52:22.215238,Pizza,Pizza Andante,24200,6300,30500
16468,16469,21-10-2020 15:52:22.416595,Parrilla · Café,Figaro Café/ Restaurante Argentino,27800,5800,33600
16469,16470,21-10-2020 15:52:22.717373,Peruana · Internacional,La Chifería,48750,6600,55350
16470,16471,21-10-2020 15:52:22.968076,Postres,Levelma,15000,6200,21200
16471,16472,21-10-2020 15:52:23.218722,Saludable · Desayunos,Re.al Alimentos Reales,53900,4000,57900
16472,16473,21-10-2020 15:52:23.519408,Postres · Desayunos,Maltihelados,10700,6200,16900
16473,16474,21-10-2020 15:52:23.720256,Pollo · Desayunos,Piaf,13000,6500,19500
16474,16475,21-10-2020 15:52:23.922416,Desayunos · Panadería,Choclofee,23000,4700,27700
16475,16476,21-10-2020 15:52:24.073024,Desayunos · Típica,D´Porco,23000,3900,26900
16476,16477,21-10-2020 15:52:24.374463,Comida Rápida,Fiesta Digital Andrés,65000,3100,68100
16477,16478,21-10-2020 15:52:24.576288,Desayunos · Típica,Peninsula Calentados y Parrilla,48750,3400,52150
16478,16479,21-10-2020 15:52:24.828841,Italiana,F*cking Good Pizza,10700,4200,14900
16479,16480,21-10-2020 15:52:25.029544,Típica · Parrilla,Typykos,10700,6000,16700
16480,16481,21-10-2020 15:52:25.379834,Típica · Parrilla,El Santandereano,9000,5200,14200
16481,16482,21-10-2020 15:52:25.630888,Pollo · Desayunos,Caserito Gourmet,15000,6700,21700
16482,16483,21-10-2020 15:52:26.031480,Jugos y Batidos,Pomponio,13000,3600,16600
16483,16484,21-10-2020 15:52:26.282450,Desayunos · Café,Matchacha,53900,5900,59800
16484,16485,21-10-2020 15:52:26.483881,Desayunos,Don Leo,65000,6000,71000
16485,16486,21-10-2020 15:52:26.635271,Típica,Sabrosito,13000,4000,17000
16486,16487,21-10-2020 15:52:26.886814,Desayunos · Panadería,El Pan de Phillippe,24300,4600,28900
16487,16488,21-10-2020 15:52:27.038059,Postres · Desayunos,Restaurante Cornelia,53900,5500,59400
16488,16489,21-10-2020 15:52:27.288854,Desayunos · Pescados y Mariscos,Luzí­a - Mediterranea,53900,5700,59600
16489,16490,21-10-2020 15:52:27.689390,Hamburguesas · Alitas,Beer,23000,6600,29600
16490,16491,21-10-2020 15:52:27.940632,Pollo,Chicken House,35000,4200,39200
16491,16492,21-10-2020 15:52:28.241854,Típica,Lo Nuestro,45800,3100,48900
16492,16493,21-10-2020 15:52:28.492594,Desayunos · Café,Aromacafé el Placer de Compartir,45800,5000,50800
16493,16494,21-10-2020 15:52:28.743464,Desayunos · Típica,Peninsula Calentados y Parrilla,34500,3400,37900
16494,16495,21-10-2020 15:52:29.143831,Desayunos · Panadería,Artesanos,34500,4300,38800
16495,16496,21-10-2020 15:52:29.394632,Asiática,TeT,23000,5900,28900
16496,16497,21-10-2020 15:52:29.595228,Postres · Desayunos,Restaurante Cornelia,13000,5500,18500
16497,16498,21-10-2020 15:52:29.947049,Típica · Parrilla,Typykos,65000,6000,71000
16498,16499,21-10-2020 15:52:30.198358,Pollo · Desayunos,Caserito Gourmet,27800,6700,34500
16499,16500,21-10-2020 15:52:30.549665,Sánduches · Pescados y Mariscos,Pacific Comida de Mar,12500,4000,16500
16500,16501,21-10-2020 15:52:30.850824,Perros Calientes,Dog Shop - Rapida,27800,4900,32700
16501,16502,21-10-2020 15:52:31.001591,Hamburguesas · Alitas,Beer,31800,6600,38400
16502,16503,21-10-2020 15:52:31.252132,Postres · Desayunos,Sweet Tale,12500,5800,18300
16503,16504,21-10-2020 15:52:31.653197,Mexicana,Cantina La 15,39700,4300,44000
16504,16505,21-10-2020 15:52:31.803461,Italiana,F*cking Good Pizza,24200,4200,28400
16505,16506,21-10-2020 15:52:32.053613,Desayunos · Típica,D'Porco - Lechona,15000,6300,21300
16506,16507,21-10-2020 15:52:32.404276,Saludable · Desayunos,Básico y Elemental,23000,5900,28900
16507,16508,21-10-2020 15:52:32.805429,Desayunos · Típica,Casa Vieja,35000,6000,41000
16508,16509,21-10-2020 15:52:33.055795,Postres · Desayunos,Maltihelados,70000,6200,76200
16509,16510,21-10-2020 15:52:33.406660,Típica,La Cocina,48750,4600,53350
16510,16511,21-10-2020 15:52:33.606971,Comida Rápida · Perros Calientes,Similoa - Comida Rapida,24300,3700,28000
16511,16512,21-10-2020 15:52:33.957778,Postres · Desayunos,Protein Bakes,70000,5900,75900
16512,16513,21-10-2020 15:52:34.108105,Desayunos · Típica,Cochon,12500,3300,15800
16513,16514,21-10-2020 15:52:34.358312,Saludable · Desayunos,La Cesta,18900,4700,23600
16514,16515,21-10-2020 15:52:34.608580,Internacional,La Esquina con Sabor Parrilla,10700,3000,13700
16515,16516,21-10-2020 15:52:34.959767,Típica,Salsig,48750,5600,54350
16516,16517,21-10-2020 15:52:35.109781,Saludable,Ventura Soup y Salad,48750,3800,52550
16517,16518,21-10-2020 15:52:35.260005,Desayunos · Café,Norma's Ice Cream Café,23000,6300,29300
16518,16519,21-10-2020 15:52:35.410925,Desayunos,Don Leo,48750,6000,54750
16519,16520,21-10-2020 15:52:35.561380,Desayunos · Panadería,Pasteleite,17800,5900,23700
16520,16521,21-10-2020 15:52:35.861892,Saludable · Típica,Sopas Mrg,65000,3100,68100
16521,16522,21-10-2020 15:52:36.062080,Típica,La Olla de Barro,15000,5300,20300
16522,16523,21-10-2020 15:52:36.463100,Desayunos · Café,Norma's Ice Cream Café,10700,6300,17000
16523,16524,21-10-2020 15:52:36.813180,Internacional,Rio Sabores y Experiencias,23000,4100,27100
16524,16525,21-10-2020 15:52:37.213898,Hamburguesas · Panadería,NYC Burgers,65000,6200,71200
16525,16526,21-10-2020 15:52:37.564106,Típica,El Cucharón - Tipica,10700,4400,15100
16526,16527,21-10-2020 15:52:37.814572,Postres · Desayunos,Restaurante Cornelia,27800,5500,33300
16527,16528,21-10-2020 15:52:37.964900,Pollo · Desayunos,Candelina,29500,5300,34800
16528,16529,21-10-2020 15:52:38.115011,Parrilla,Beraca Parrilla Bbq,48750,5600,54350
16529,16530,21-10-2020 15:52:38.465852,China,China Food Col,35000,3600,38600
16530,16531,21-10-2020 15:52:38.766479,Comida Rápida,Fiesta Digital Andrés,34500,3100,37600
16531,16532,21-10-2020 15:52:39.066966,Típica,Campo Victoria,13000,3000,16000
16532,16533,21-10-2020 15:52:39.267831,Postres,La Tertulia,45800,3400,49200
16533,16534,21-10-2020 15:52:39.618812,Desayunos · Comida Rápida,Chocolatto,27800,3400,31200
16534,16535,21-10-2020 15:52:40.020630,Pescados y Mariscos,Fish Place - Del Mar,13600,5400,19000
16535,16536,21-10-2020 15:52:40.221562,Internacional,La Esquina con Sabor Parrilla,10700,3000,13700
16536,16537,21-10-2020 15:52:40.522336,Desayunos · Pescados y Mariscos,Gypsy Bistro,12500,4500,17000
16537,16538,21-10-2020 15:52:40.672809,Hamburguesas · Saludable,Restaurant Inn,45800,6100,51900
16538,16539,21-10-2020 15:52:40.823389,Típica,La Olla de Barro,31800,5300,37100
16539,16540,21-10-2020 15:52:41.224553,Parrilla · Café,Figaro Café/ Restaurante Argentino,9000,5800,14800
16540,16541,21-10-2020 15:52:41.425635,Pollo · Desayunos,Workzone,24200,3100,27300
16541,16542,21-10-2020 15:52:41.575918,Desayunos,La Frijolada Desayunos,31800,4400,36200
16542,16543,21-10-2020 15:52:41.876405,Pizza · Parrilla,Urban Lunch,39700,4000,43700
16543,16544,21-10-2020 15:52:42.277552,Desayunos · Típica,La Parrilla Dorada Polo,10700,6600,17300
16544,16545,21-10-2020 15:52:42.578150,Pizza,Pizza Andante,12500,6300,18800
16545,16546,21-10-2020 15:52:42.728590,Pollo · China,China Tao,65000,3500,68500
16546,16547,21-10-2020 15:52:43.079121,Desayunos · Café,Moramia,24300,4700,29000
16547,16548,21-10-2020 15:52:43.430395,Pollo · Desayunos,Abasto,27800,3600,31400
16548,16549,21-10-2020 15:52:43.631846,Hamburguesas · Pescados y Mariscos,El Velero,13000,6500,19500
16549,16550,21-10-2020 15:52:43.783162,Pollo · Sánduches,Pollos Century,13600,3000,16600
16550,16551,21-10-2020 15:52:43.984164,Desayunos · Empanadas,Mis Delicias,24300,3200,27500
16551,16552,21-10-2020 15:52:44.184989,Pescados y Mariscos,La Gran Cazuela,7500,3200,10700
16552,16553,21-10-2020 15:52:44.586134,Parrilla,Antojo a Domicilio,11870,5000,16870
16553,16554,21-10-2020 15:52:44.736407,Pizza,pizza andante,65000,4200,69200
16554,16555,21-10-2020 15:52:45.137822,Jugos y Batidos,Pomponio,17800,3600,21400
16555,16556,21-10-2020 15:52:45.388759,Saludable · Parrilla,The Angels Grill and Drinks,53900,6200,60100
16556,16557,21-10-2020 15:52:45.739913,Típica · Parrilla,La Parilla de David,45800,3100,48900
16557,16558,21-10-2020 15:52:46.090624,Saludable · Desayunos,Básico y Elemental,12500,5900,18400
16558,16559,21-10-2020 15:52:46.291131,Sushi,Umi,31800,5600,37400
16559,16560,21-10-2020 15:52:46.641860,Típica,Lo Nuestro,9000,3100,12100
16560,16561,21-10-2020 15:52:46.992541,Pizza,Pizza Andante,10700,6300,17000
16561,16562,21-10-2020 15:52:47.394194,Pollo · Desayunos,Candelina,37900,5300,43200
16562,16563,21-10-2020 15:52:47.645088,Desayunos · Típica,Parrilla Farandula Típico,48750,5900,54650
16563,16564,21-10-2020 15:52:47.945530,Saludable · Desayunos,Básico y Elemental,24200,5900,30100
16564,16565,21-10-2020 15:52:48.196175,Parrilla · Café,Gaira Café,15000,4400,19400
16565,16566,21-10-2020 15:52:48.346776,Hamburguesas,Burger Society,13600,4100,17700
16566,16567,21-10-2020 15:52:48.547803,Saludable · Desayunos,Copacabana Açai Bowls,17800,3000,20800
16567,16568,21-10-2020 15:52:48.748552,Desayunos · Panadería,Ficchi Panadería,24200,3100,27300
16568,16569,21-10-2020 15:52:49.149855,Típica,La Herencia,70000,5900,75900
16569,16570,21-10-2020 15:52:49.400936,Pollo · China,China Tao,48750,3500,52250
16570,16571,21-10-2020 15:52:49.602621,Saludable · Desayunos,Bawana - Sandwich,10700,3400,14100
16571,16572,21-10-2020 15:52:49.803746,Postres · Desayunos,Amelie Helados,34500,6400,40900
16572,16573,21-10-2020 15:52:50.104247,Saludable · Desayunos,Distrito Gourmet,35000,3700,38700
16573,16574,21-10-2020 15:52:50.304961,Pollo,Oliva Va,29500,5600,35100
16574,16575,21-10-2020 15:52:50.555492,Desayunos · Empanadas,Mis Delicias,24200,3200,27400
16575,16576,21-10-2020 15:52:50.956225,Desayunos · Típica,Casa Vieja,18900,6000,24900
16576,16577,21-10-2020 15:52:51.156850,Saludable · Desayunos,Agua Dulce,7500,3700,11200
16577,16578,21-10-2020 15:52:51.457704,Típica · Parrilla,El Santandereano,39700,5200,44900
16578,16579,21-10-2020 15:52:51.858426,Sushi,Sushi Reel,15000,4700,19700
16579,16580,21-10-2020 15:52:52.058894,Postres · Desayunos,Café Quindio,13600,5700,19300
16580,16581,21-10-2020 15:52:52.259228,Mexicana,Cantina La 15,48750,4300,53050
16581,16582,21-10-2020 15:52:52.610854,Pollo · Desayunos,Candelina,70000,5300,75300
16582,16583,21-10-2020 15:52:52.962290,Postres · Helados,Mahé,24300,6000,30300
16583,16584,21-10-2020 15:52:53.263047,Desayunos · Panadería,Decofruta,34500,4700,39200
16584,16585,21-10-2020 15:52:53.464379,Típica,Salsig,15000,5600,20600
16585,16586,21-10-2020 15:52:53.765676,Saludable · Desayunos,Raices Bienestar Gourmet,13600,6600,20200
16586,16587,21-10-2020 15:52:54.066653,Saludable · Parrilla,The Angels Grill and Drinks,24300,6200,30500
16587,16588,21-10-2020 15:52:54.367369,Parrilla,Arroces Maria Paula,17800,6800,24600
16588,16589,21-10-2020 15:52:54.517464,Pizza,18 Scalini,65000,4300,69300
16589,16590,21-10-2020 15:52:54.717701,Típica · Pescados y Mariscos,Arroces Mrg,7500,4300,11800
16590,16591,21-10-2020 15:52:54.968309,Desayunos · Comida Rápida,Chocolatto,29500,3400,32900
16591,16592,21-10-2020 15:52:55.368958,Desayunos,Bagel Shop,34500,3200,37700
16592,16593,21-10-2020 15:52:55.569332,Poke,Poke Go,37900,4600,42500
16593,16594,21-10-2020 15:52:55.919635,Desayunos,Bagel Shop,45800,3200,49000
16594,16595,21-10-2020 15:52:56.070103,Desayunos · Café,El Gualilo,18900,6200,25100
16595,16596,21-10-2020 15:52:56.421188,Postres · Desayunos,Gelateria Da Favola,12500,6500,19000
16596,16597,21-10-2020 15:52:56.621941,Pollo,Señor Fantástico,10700,4700,15400
16597,16598,21-10-2020 15:52:56.972862,Parrilla,Carnes la Zarza,34500,4900,39400
16598,16599,21-10-2020 15:52:57.323129,Pollo · Saludable,Tremenda Sal y Dulce,11870,6500,18370
16599,16600,21-10-2020 15:52:57.725400,Desayunos · Sánduches,Garnish,7500,5200,12700
16600,16601,21-10-2020 15:52:57.926286,Postres · Saludable,Ana Rebana,45800,6300,52100
16601,16602,21-10-2020 15:52:58.227830,Sushi,Sushi Reel,29500,4700,34200
16602,16603,21-10-2020 15:52:58.579413,Postres · Desayunos,Cosmo Cookies,45800,5900,51700
16603,16604,21-10-2020 15:52:58.780506,Desayunos · Jugos y Batidos,Frutiwow,7500,4100,11600
16604,16605,21-10-2020 15:52:59.081000,Típica,La Olla de Barro,35000,5300,40300
16605,16606,21-10-2020 15:52:59.231899,Saludable · Desayunos,La Cesta,31800,4700,36500
16606,16607,21-10-2020 15:52:59.382719,Peruana,Uma Cantina Peruana,23000,3200,26200
16607,16608,21-10-2020 15:52:59.633683,Parrilla,Arepaisa de Medellín,29500,5600,35100
16608,16609,21-10-2020 15:52:59.884404,Desayunos,La Frijolada Desayunos,45800,4400,50200
16609,16610,21-10-2020 15:53:00.235393,Desayunos · Típica,Rojo Gourmet,10700,4700,15400
16610,16611,21-10-2020 15:53:00.586391,Saludable · Desayunos,Guadalupe - Fruteria,24300,5900,30200
16611,16612,21-10-2020 15:53:00.886782,Saludable,MIMA,11870,3700,15570
16612,16613,21-10-2020 15:53:01.237702,Sushi,Canoa To Go,17800,5900,23700
16613,16614,21-10-2020 15:53:01.538510,Desayunos · Típica,D'Porco - Lechona,53900,6300,60200
16614,16615,21-10-2020 15:53:01.889663,Pollo,Oliva Va,18900,5600,24500
16615,16616,21-10-2020 15:53:02.290551,Desayunos · Café,Norma's Ice Cream Café,45800,6300,52100
16616,16617,21-10-2020 15:53:02.591621,Pollo,Oliva Va,11870,5600,17470
16617,16618,21-10-2020 15:53:02.843005,Desayunos,El Corral - Desayunos,23000,5000,28000
16618,16619,21-10-2020 15:53:03.144109,Hamburguesas · Desayunos,El Inglés Gastro Pub,53400,6600,60000
16619,16620,21-10-2020 15:53:03.545183,Mexicana,La leyenda mexican kitchen,35000,3200,38200
16620,16621,21-10-2020 15:53:03.745885,Helados,Buon Gelato,35000,4400,39400
16621,16622,21-10-2020 15:53:04.046695,Saludable · Parrilla,Box,24200,3700,27900
16622,16623,21-10-2020 15:53:04.347650,Típica · Pescados y Mariscos,Arroces Mrg,10700,4300,15000
16623,16624,21-10-2020 15:53:04.548199,Parrilla,Campocina,29500,4600,34100
16624,16625,21-10-2020 15:53:04.899857,Sushi,Canoa To Go,8900,5900,14800
16625,16626,21-10-2020 15:53:05.200851,Típica,Cabrito Santandereano,53900,6600,60500
16626,16627,21-10-2020 15:53:05.551992,Peruana,Masivo,35000,5800,40800
16627,16628,21-10-2020 15:53:05.852655,Alta Cocina · Parrilla,Criterión,35000,6000,41000
16628,16629,21-10-2020 15:53:06.103167,Típica · Parrilla,La Ternera Parrilla,70000,5200,75200
16629,16630,21-10-2020 15:53:06.304173,Parrilla,Arroces Maria Paula,13600,6800,20400
16630,16631,21-10-2020 15:53:06.555130,Postres,Beiked,35000,4000,39000
16631,16632,21-10-2020 15:53:06.706294,Desayunos,Archies Desayunos,35000,3100,38100
16632,16633,21-10-2020 15:53:07.007482,Pizza,pizza andante,13000,4200,17200
16633,16634,21-10-2020 15:53:07.158596,Desayunos · Café,Aromacafé el Placer de Compartir,53900,5000,58900
16634,16635,21-10-2020 15:53:07.309783,Típica · Pescados y Mariscos,Arroces Mrg,37900,4300,42200
16635,16636,21-10-2020 15:53:07.560740,Saludable · Desayunos,Distrito Gourmet,13600,3700,17300
16636,16637,21-10-2020 15:53:07.811587,Pizza · Italiana,Pisapore - Pizza,9000,6600,15600
16637,16638,21-10-2020 15:53:08.214044,Desayunos,Bagel Shop,35000,3200,38200
16638,16639,21-10-2020 15:53:08.416086,Desayunos · Panadería,Santa Juana Food Bar,15000,5900,20900
16639,16640,21-10-2020 15:53:08.766927,Pollo,Señor Fantástico,24300,4700,29000
16640,16641,21-10-2020 15:53:09.117626,Desayunos · Típica,Rojo Gourmet,27800,4700,32500
16641,16642,21-10-2020 15:53:09.469022,Postres · Desayunos,La Folie - Postres,35000,3300,38300
16642,16643,21-10-2020 15:53:09.820108,Panadería,Boul,65000,3100,68100
16643,16644,21-10-2020 15:53:10.171378,Postres · Desayunos,BagBog Bagels,23000,6400,29400
16644,16645,21-10-2020 15:53:10.472446,Pollo,Chicken House,8900,4200,13100
16645,16646,21-10-2020 15:53:10.673687,Desayunos · Típica,Rojo Gourmet,23000,4700,27700
16646,16647,21-10-2020 15:53:11.074564,Típica,Lo Nuestro,15600,3100,18700
16647,16648,21-10-2020 15:53:11.275207,Saludable,A2manos,23000,4200,27200
16648,16649,21-10-2020 15:53:11.626112,Desayunos · Café,vereda central calle 99,45800,5700,51500
16649,16650,21-10-2020 15:53:12.027042,Sushi,Sushi Reel,12500,4700,17200
16650,16651,21-10-2020 15:53:12.178165,Postres,La Tertulia,18900,3400,22300
16651,16652,21-10-2020 15:53:12.578971,Parrilla · Internacional,Taperia de la Plaza,65000,5700,70700
16652,16653,21-10-2020 15:53:12.929878,Perros Calientes,Dog Shop - Rapida,53400,4900,58300
16653,16654,21-10-2020 15:53:13.281581,Mexicana,Cantina La 15,39700,4300,44000
16654,16655,21-10-2020 15:53:13.432949,Desayunos · Típica,Rojo Gourmet,9000,4700,13700
16655,16656,21-10-2020 15:53:13.583818,Desayunos · Comida Rápida,La Veneca,37900,6300,44200
16656,16657,21-10-2020 15:53:13.784502,Saludable,Hanai - Bowls Saludables,23000,5900,28900
16657,16658,21-10-2020 15:53:13.935078,Parrilla,Parrilla Pimentón,31800,3400,35200
16658,16659,21-10-2020 15:53:14.185770,Sushi,Kim Pop,65000,5400,70400
16659,16660,21-10-2020 15:53:14.339653,Saludable,Hanai - Bowls Saludables,35000,5900,40900
16660,16661,21-10-2020 15:53:14.490564,Desayunos · Jugos y Batidos,Frutiwow,12500,4100,16600
16661,16662,21-10-2020 15:53:14.841053,Desayunos · Panadería,Limarys,48750,6500,55250
16662,16663,21-10-2020 15:53:15.041741,Pescados y Mariscos,Pescadero Héroes del Mar,23000,6600,29600
16663,16664,21-10-2020 15:53:15.292421,Típica,Baondish,18900,5800,24700
16664,16665,21-10-2020 15:53:15.542989,Jugos y Batidos,Pomponio,23000,3600,26600
16665,16666,21-10-2020 15:53:15.843793,Saludable · Típica,Saludable Mrg,35000,5800,40800
16666,16667,21-10-2020 15:53:16.245236,Desayunos · Sánduches,Frutos del Bosque,29500,3500,33000
16667,16668,21-10-2020 15:53:16.596045,Peruana · Internacional,La Chifería,70000,6600,76600
16668,16669,21-10-2020 15:53:16.997442,Hamburguesas,Monchis - Hamburguesa,23000,4300,27300
16669,16670,21-10-2020 15:53:17.198384,Saludable · Típica,Sopas Mrg,15000,3100,18100
16670,16671,21-10-2020 15:53:17.449839,Saludable,MIMA,70000,3700,73700
16671,16672,21-10-2020 15:53:17.750902,Parrilla,Rústico Picadería,48750,3800,52550
16672,16673,21-10-2020 15:53:17.951382,Desayunos · Parrilla,Mi Patria,23000,4600,27600
16673,16674,21-10-2020 15:53:18.101872,Sushi,Kim Pop,37900,5400,43300
16674,16675,21-10-2020 15:53:18.253075,Pizza · Parrilla,Urban Lunch,65000,4000,69000
16675,16676,21-10-2020 15:53:18.504933,Desayunos · Panadería,Premium Break Bakery,10700,3700,14400
16676,16677,21-10-2020 15:53:18.905860,Pollo · Desayunos,Candelina,13600,5300,18900
16677,16678,21-10-2020 15:53:19.256925,Italiana,F*cking Good Pizza,35000,4200,39200
16678,16679,21-10-2020 15:53:19.558382,Postres · Desayunos,Sweet Tale,17800,5800,23600
16679,16680,21-10-2020 15:53:19.909517,Sushi,Umi,13600,5600,19200
16680,16681,21-10-2020 15:53:20.210778,Pescados y Mariscos,Fish Place - Del Mar,23000,5400,28400
16681,16682,21-10-2020 15:53:20.512547,Pescados y Mariscos,La Gran Cazuela,17800,3200,21000
16682,16683,21-10-2020 15:53:20.813799,Típica,Salsig,17800,5600,23400
16683,16684,21-10-2020 15:53:21.065040,Desayunos,Sr Buñuelo,12500,6400,18900
16684,16685,21-10-2020 15:53:21.316555,Desayunos · Pescados y Mariscos,Luzí­a - Mediterranea,13000,5700,18700
16685,16686,21-10-2020 15:53:21.718790,Desayunos · Típica,Alce,15600,4900,20500
16686,16687,21-10-2020 15:53:21.920589,Desayunos · Típica,Desayunadero de la 42,9000,5900,14900
16687,16688,21-10-2020 15:53:22.272462,Típica,Sabores De Mi Tierra,53400,5400,58800
16688,16689,21-10-2020 15:53:22.574178,Desayunos · Comida Rápida,Chocolatto,48750,3400,52150
16689,16690,21-10-2020 15:53:22.826038,Poke,Poke Go,13000,4600,17600
16690,16691,21-10-2020 15:53:23.077766,Desayunos,Desayunos en Bogotá,13600,3400,17000
16691,16692,21-10-2020 15:53:23.480118,Saludable · Desayunos,Distrito Gourmet,27800,3700,31500
16692,16693,21-10-2020 15:53:23.733045,Sánduches · China,Peru Mix,18900,5900,24800
16693,16694,21-10-2020 15:53:24.034061,Típica,Juan Chorizo,11870,3900,15770
16694,16695,21-10-2020 15:53:24.186175,Pizza,pizza andante,23000,4200,27200
16695,16696,21-10-2020 15:53:24.337284,Crepes,La Chabatta,35000,5900,40900
16696,16697,21-10-2020 15:53:24.639032,Saludable · Desayunos,Raices Bienestar Gourmet,65000,6600,71600
16697,16698,21-10-2020 15:53:24.839992,Típica,Carbón & Mondongos,7500,6400,13900
16698,16699,21-10-2020 15:53:25.142166,Mexicana,Hidalgo Taquería,13600,4900,18500
16699,16700,21-10-2020 15:53:25.343039,Jugos y Batidos,Pomponio,13000,3600,16600
16700,16701,21-10-2020 15:53:25.545973,Típica,La Herencia,70000,5900,75900
16701,16702,21-10-2020 15:53:25.948087,Postres,La Tertulia,35000,3400,38400
16702,16703,21-10-2020 15:53:26.200757,Saludable · Desayunos,La Estampilla,11870,6000,17870
16703,16704,21-10-2020 15:53:26.551964,Mexicana,La leyenda mexican kitchen,31800,3200,35000
16704,16705,21-10-2020 15:53:26.904253,Saludable,Puro Verde,18900,5700,24600
16705,16706,21-10-2020 15:53:27.104905,Desayunos · Helados,San Giorgio Gelateria,17800,3100,20900
16706,16707,21-10-2020 15:53:27.456117,Postres · Desayunos,Vivalight Market.,27800,6500,34300
16707,16708,21-10-2020 15:53:27.656635,Desayunos · Típica,Parrilla Farandula Típico,18900,5900,24800
16708,16709,21-10-2020 15:53:27.856983,Postres · Desayunos,BagBog Bagels,9000,6400,15400
16709,16710,21-10-2020 15:53:28.258148,Peruana · Internacional,La Chifería,15000,6600,21600
16710,16711,21-10-2020 15:53:28.658816,Saludable · Desayunos,Raices Bienestar Gourmet,29500,6600,36100
16711,16712,21-10-2020 15:53:28.810406,Desayunos · Empanadas,Empanadas Doraditas.com,24200,3000,27200
16712,16713,21-10-2020 15:53:29.011376,Desayunos · Café,Matchacha,35000,5900,40900
16713,16714,21-10-2020 15:53:29.262982,Postres · Desayunos,Sharmus,12500,6100,18600
16714,16715,21-10-2020 15:53:29.464060,Saludable,Puro Verde,23000,5700,28700
16715,16716,21-10-2020 15:53:29.615312,Desayunos,Sunny Breakfast Brunch,35000,4300,39300
16716,16717,21-10-2020 15:53:29.766130,Desayunos · Típica,Fogón Sangileño,35000,5000,40000
16717,16718,21-10-2020 15:53:30.167091,Parrilla,Coquitas,10700,5600,16300
16718,16719,21-10-2020 15:53:30.418586,Alta Cocina · Parrilla,Criterión,70000,6000,76000
16719,16720,21-10-2020 15:53:30.819332,Desayunos · Típica,D'Porco - Lechona,15000,6300,21300
16720,16721,21-10-2020 15:53:30.971145,Saludable · Desayunos,Agua Dulce,10700,3700,14400
16721,16722,21-10-2020 15:53:31.321985,Típica · Parrilla,La Ternera Parrilla,23000,5200,28200
16722,16723,21-10-2020 15:53:31.572643,Peruana,Masivo,35000,5800,40800
16723,16724,21-10-2020 15:53:31.773585,Saludable · Desayunos,Malú,7500,3700,11200
16724,16725,21-10-2020 15:53:32.174627,Desayunos · Panadería,Ficchi Panadería,53900,3100,57000
16725,16726,21-10-2020 15:53:32.426497,Postres · Desayunos,Gelateria Da Favola,13600,6500,20100
16726,16727,21-10-2020 15:53:32.677433,Desayunos · Típica,Rojo Gourmet,7500,4700,12200
16727,16728,21-10-2020 15:53:33.078141,Desayunos · Típica,90 Calentados,45800,3700,49500
16728,16729,21-10-2020 15:53:33.229413,Postres · Desayunos,Maltihelados,8900,6200,15100
16729,16730,21-10-2020 15:53:33.580412,Desayunos,El Corral - Desayunos,24200,5000,29200
16730,16731,21-10-2020 15:53:33.982087,Parrilla,Carnes la Zarza,31800,4900,36700
16731,16732,21-10-2020 15:53:34.133904,Parrilla,Beraca Parrilla Bbq,23000,5600,28600
16732,16733,21-10-2020 15:53:34.484671,Desayunos · Típica,Alce,7500,4900,12400
16733,16734,21-10-2020 15:53:34.635737,Saludable · Desayunos,Básico y elemental,24300,5000,29300
16734,16735,21-10-2020 15:53:34.786263,Saludable · Desayunos,La Estampilla,23000,6000,29000
16735,16736,21-10-2020 15:53:34.937014,Típica,Juan Chorizo,39700,3900,43600
16736,16737,21-10-2020 15:53:35.288440,Pollo,Señor Fantástico,48750,4700,53450
16737,16738,21-10-2020 15:53:35.489847,Saludable,The Good Rice Bowls,45800,3500,49300
16738,16739,21-10-2020 15:53:35.891145,Postres,Toledo Pastelería,10700,6800,17500
16739,16740,21-10-2020 15:53:36.242591,Parrilla,Arroces Maria Paula,24300,6800,31100
16740,16741,21-10-2020 15:53:36.593750,Pollo,Heart & Cooking,17800,5000,22800
16741,16742,21-10-2020 15:53:36.794428,Hamburguesas,Burger Society,39700,4100,43800
16742,16743,21-10-2020 15:53:37.145349,Típica,Lo Nuestro,39700,3100,42800
16743,16744,21-10-2020 15:53:37.496044,Saludable · Desayunos,Bon Eat - Saludable,39700,4800,44500
16744,16745,21-10-2020 15:53:37.797057,Saludable · Desayunos,Fresh Co,53400,5600,59000
16745,16746,21-10-2020 15:53:38.097950,Postres · Desayunos,Cosmo Cookies,11870,5900,17770
16746,16747,21-10-2020 15:53:38.449749,Postres · Desayunos,Aury Postres - Comidas & Picadas,53900,4700,58600
16747,16748,21-10-2020 15:53:38.601176,Típica,Cazuelitas 93,8900,3900,12800
16748,16749,21-10-2020 15:53:38.852604,Desayunos · Mexicana,La Mera Mera - Mexicana,11870,3100,14970
16749,16750,21-10-2020 15:53:39.054462,Sánduches · Pescados y Mariscos,Pacific Comida de Mar,24200,4000,28200
16750,16751,21-10-2020 15:53:39.256964,Desayunos,Fratelli - Desayunos,23000,4600,27600
16751,16752,21-10-2020 15:53:39.508292,Desayunos · Panadería,Siena Café,45800,3700,49500
16752,16753,21-10-2020 15:53:39.709635,Postres · Desayunos,Cosmo Cookies,23000,5900,28900
16753,16754,21-10-2020 15:53:39.960808,Alta Cocina · Parrilla,Criterión,18900,6000,24900
16754,16755,21-10-2020 15:53:40.162314,Pizza,Pizza Andante,24300,6300,30600
16755,16756,21-10-2020 15:53:40.413565,Hamburguesas · Saludable,Restaurant Inn,27800,6100,33900
16756,16757,21-10-2020 15:53:40.814852,Pollo · Desayunos,Caserito Gourmet,23000,6700,29700
16757,16758,21-10-2020 15:53:41.215962,Desayunos · Típica,Rojo Gourmet,53400,4700,58100
16758,16759,21-10-2020 15:53:41.617485,Desayunos · Jugos y Batidos,Kuriwaji,31800,6300,38100
16759,16760,21-10-2020 15:53:41.968635,Comida Rápida · Perros Calientes,Similoa - Comida Rapida,24200,3700,27900
16760,16761,21-10-2020 15:53:42.119879,Saludable · Típica,Saludable Mrg,7500,5800,13300
16761,16762,21-10-2020 15:53:42.370809,Desayunos · Café,Libertario Coffee Roasters,23000,4600,27600
16762,16763,21-10-2020 15:53:42.722241,Sushi,Umi,35000,5600,40600
16763,16764,21-10-2020 15:53:43.023068,Italiana,F*cking Good Pizza,29500,4200,33700
16764,16765,21-10-2020 15:53:43.373805,Desayunos · Panadería,Choclofee,7500,4700,12200
16765,16766,21-10-2020 15:53:43.625572,Desayunos · Típica,Parrilla Farandula Típico,15600,5900,21500
16766,16767,21-10-2020 15:53:43.826858,Desayunos · Típica,90 Calentados,35000,3700,38700
16767,16768,21-10-2020 15:53:43.978133,Asiática,Thai Station,37900,6000,43900
16768,16769,21-10-2020 15:53:44.331643,Desayunos · Típica,Papadió - Colombianas,35000,5700,40700
16769,16770,21-10-2020 15:53:44.633412,Saludable · Desayunos,Re.al Alimentos Reales,23000,4000,27000
16770,16771,21-10-2020 15:53:44.834436,Postres,La Tertulia,34500,3400,37900
16771,16772,21-10-2020 15:53:45.135729,Desayunos · Típica,Criollomania,53900,5200,59100
16772,16773,21-10-2020 15:53:45.436943,Postres · Desayunos,Vivalight Market.,27800,6500,34300
16773,16774,21-10-2020 15:53:45.738541,Desayunos,Sunny Breakfast Brunch,15000,4300,19300
16774,16775,21-10-2020 15:53:45.989990,Hamburguesas · Desayunos,El Inglés Gastro Pub,23000,6600,29600
16775,16776,21-10-2020 15:53:46.241381,Mexicana,La leyenda mexican kitchen,45800,3200,49000
16776,16777,21-10-2020 15:53:46.542169,Típica · Pescados y Mariscos,Arroces Mrg,34500,4300,38800
16777,16778,21-10-2020 15:53:46.943194,Desayunos · Típica,Rojo Gourmet,39700,4700,44400
16778,16779,21-10-2020 15:53:47.244565,Típica,La Cocina,37900,4600,42500
16779,16780,21-10-2020 15:53:47.645796,Desayunos · Panadería,Ficchi Panadería,29500,3100,32600
16780,16781,21-10-2020 15:53:47.846780,Internacional,La Esquina con Sabor Parrilla,29500,3000,32500
16781,16782,21-10-2020 15:53:47.997770,Mexicana,La leyenda mexican kitchen,24200,3200,27400
16782,16783,21-10-2020 15:53:48.399437,Típica · Parrilla,Toya,48750,4200,52950
16783,16784,21-10-2020 15:53:48.700285,Saludable · Desayunos,Fresh Co,12500,5600,18100
16784,16785,21-10-2020 15:53:49.002013,Típica,El Cucharón - Tipica,29500,4400,33900
16785,16786,21-10-2020 15:53:49.354115,Desayunos · Panadería,Artesanos,48750,4300,53050
16786,16787,21-10-2020 15:53:49.554910,Típica · Parrilla,Typykos,15600,6000,21600
16787,16788,21-10-2020 15:53:49.756022,Postres · Desayunos,Sweet Tale,65000,5800,70800
16788,16789,21-10-2020 15:53:49.957060,Postres · Helados,Mahé,15600,6000,21600
16789,16790,21-10-2020 15:53:50.107754,Mexicana,Cantina La 15,13000,4300,17300
16790,16791,21-10-2020 15:53:50.459417,Desayunos,Cafetería el Kippe,23000,3200,26200
16791,16792,21-10-2020 15:53:50.860643,Crepes,San Crepes,8900,4900,13800
16792,16793,21-10-2020 15:53:51.061561,Alta Cocina · Postres,La Pinta,27800,4500,32300
16793,16794,21-10-2020 15:53:51.263255,Saludable · Desayunos,Re.al Alimentos Reales,13000,4000,17000
16794,16795,21-10-2020 15:53:51.564519,Pollo · Desayunos,Candelina,15600,5300,20900
16795,16796,21-10-2020 15:53:51.865580,Pollo · Desayunos,Caserito Gourmet,15600,6700,22300
16796,16797,21-10-2020 15:53:52.116974,Desayunos · Típica,Criollomania,13600,5200,18800
16797,16798,21-10-2020 15:53:52.418531,Postres · Desayunos,Maltihelados,13000,6200,19200
16798,16799,21-10-2020 15:53:52.619846,Hamburguesas · Panadería,NYC Burgers,15600,6200,21800
16799,16800,21-10-2020 15:53:52.920884,Peruana,Uma Cantina Peruana,8900,3200,12100
16800,16801,21-10-2020 15:53:53.121962,Sushi,Kim Pop,24300,5400,29700
16801,16802,21-10-2020 15:53:53.423894,Mexicana,Mexicanachos,23000,3900,26900
16802,16803,21-10-2020 15:53:53.725582,Saludable · Desayunos,Bawana - Sandwich,15600,3400,19000
16803,16804,21-10-2020 15:53:54.127127,Típica,La Herencia,45800,5900,51700
16804,16805,21-10-2020 15:53:54.429495,Típica,Carbón & Mondongos,24300,6400,30700
16805,16806,21-10-2020 15:53:54.830505,Típica,Bendita S,35000,4600,39600
16806,16807,21-10-2020 15:53:54.981247,Peruana,Masivo,15000,5800,20800
16807,16808,21-10-2020 15:53:55.382896,Hamburguesas,Monchis - Hamburguesa,15000,4300,19300
16808,16809,21-10-2020 15:53:55.583595,Desayunos,El Fogón Castellano,11870,3200,15070
16809,16810,21-10-2020 15:53:55.985334,Desayunos · Empanadas,Mis Delicias,31800,3200,35000
16810,16811,21-10-2020 15:53:56.286743,Típica,El Cucharón - Tipica,34500,4400,38900
16811,16812,21-10-2020 15:53:56.687837,Desayunos,Don Leo,23000,6000,29000
16812,16813,21-10-2020 15:53:57.089170,Saludable · Desayunos,La Estampilla,12500,6000,18500
16813,16814,21-10-2020 15:53:57.490483,Parrilla · Café,Gaira Café,13000,4400,17400
16814,16815,21-10-2020 15:53:57.641089,Pollo,Heart & Cooking,18900,5000,23900
16815,16816,21-10-2020 15:53:57.841828,Sánduches,Submarin,37900,3800,41700
16816,16817,21-10-2020 15:53:58.043061,Desayunos · Sánduches,Frutos del Bosque,35000,3500,38500
16817,16818,21-10-2020 15:53:58.394091,Saludable · Parrilla,Box,15000,3700,18700
16818,16819,21-10-2020 15:53:58.745632,Parrilla,Antojo a Domicilio,27800,5000,32800
16819,16820,21-10-2020 15:53:59.147410,Peruana · Internacional,La Chifería,23000,6600,29600
16820,16821,21-10-2020 15:53:59.449891,Sushi,Kim Pop,24200,5400,29600
16821,16822,21-10-2020 15:53:59.701068,China,China Food Col,23000,3600,26600
16822,16823,21-10-2020 15:54:00.051908,Típica,Bendita S,9000,4600,13600
16823,16824,21-10-2020 15:54:00.303111,Pollo · Desayunos,Piaf,29500,6500,36000
16824,16825,21-10-2020 15:54:00.654634,Hamburguesas,Monchis - Hamburguesa,13600,4300,17900
16825,16826,21-10-2020 15:54:00.906066,Café · Helados,Sofia heladería y café,53900,5800,59700
16826,16827,21-10-2020 15:54:01.106700,Saludable,A2manos,23000,4200,27200
16827,16828,21-10-2020 15:54:01.307846,Comida Rápida · Perros Calientes,Similoa - Comida Rapida,29500,3700,33200
16828,16829,21-10-2020 15:54:01.559045,Desayunos · Típica,Alce,10700,4900,15600
16829,16830,21-10-2020 15:54:01.909938,Desayunos · Sánduches,Garnish,12500,5200,17700
16830,16831,21-10-2020 15:54:02.161481,Parrilla · Café,Figaro Café/ Restaurante Argentino,70000,5800,75800
16831,16832,21-10-2020 15:54:02.462839,Típica,La Cocina,24300,4600,28900
16832,16833,21-10-2020 15:54:02.614132,Desayunos · Café,Norma's Ice Cream Café,11870,6300,18170
16833,16834,21-10-2020 15:54:02.865736,Pizza,Pastas Laurentina,18900,4800,23700
16834,16835,21-10-2020 15:54:03.267416,Típica,Lo Nuestro,45800,3100,48900
16835,16836,21-10-2020 15:54:03.618822,Mexicana,Cantina La 15,8900,4300,13200
16836,16837,21-10-2020 15:54:03.770267,Desayunos · Sánduches,Danilo Colombia,24300,3300,27600
16837,16838,21-10-2020 15:54:04.171631,Típica · Parrilla,Typykos,13600,6000,19600
16838,16839,21-10-2020 15:54:04.523540,Saludable,Amor Propio saludable,65000,4000,69000
16839,16840,21-10-2020 15:54:04.675266,Alta Cocina · Postres,La Pinta,48750,4500,53250
16840,16841,21-10-2020 15:54:05.076344,Saludable · Desayunos,Básico y Elemental,48750,5900,54650
16841,16842,21-10-2020 15:54:05.327142,Desayunos · Panadería,Santa Juana Food Bar,65000,5900,70900
16842,16843,21-10-2020 15:54:05.728934,Pollo · Pescados y Mariscos,Bang Bang Rice,65000,3400,68400
16843,16844,21-10-2020 15:54:05.930168,Desayunos · Panadería,Choclofee,31800,4700,36500
16844,16845,21-10-2020 15:54:06.331394,Desayunos · Panadería,Choclofee,70000,4700,74700
16845,16846,21-10-2020 15:54:06.682552,Sushi,Kim Pop,15000,5400,20400
16846,16847,21-10-2020 15:54:06.883147,Desayunos · Típica,Alce,13600,4900,18500
16847,16848,21-10-2020 15:54:07.034056,Hamburguesas · Pescados y Mariscos,El Velero,53900,6500,60400
16848,16849,21-10-2020 15:54:07.185342,Pollo · Saludable,Tremenda Sal y Dulce,15000,6500,21500
16849,16850,21-10-2020 15:54:07.387290,Desayunos,Señor Desayuno,39700,6800,46500
16850,16851,21-10-2020 15:54:07.789437,Postres · Café,Loló Coffee & Snacks,35000,4600,39600
16851,16852,21-10-2020 15:54:08.092054,Desayunos · Típica,La Frijolada,45800,4500,50300
16852,16853,21-10-2020 15:54:08.244391,Desayunos · Típica,Cochon,53900,3300,57200
16853,16854,21-10-2020 15:54:08.596378,Desayunos · Panadería,Le Pain Quotidien,12500,3900,16400
16854,16855,21-10-2020 15:54:08.797876,Típica,Salsig,12500,5600,18100
16855,16856,21-10-2020 15:54:09.200132,Italiana,F*cking Good Pizza,23000,4200,27200
16856,16857,21-10-2020 15:54:09.352195,Parrilla · Café,Gaira Café,9000,4400,13400
16857,16858,21-10-2020 15:54:09.705844,Desayunos · Típica,Desayunadero de la 42,39700,5900,45600
16858,16859,21-10-2020 15:54:10.007578,Desayunos · Café,El Gualilo,24300,6200,30500
16859,16860,21-10-2020 15:54:10.260065,Desayunos · Empanadas,Mis Delicias,48750,3200,51950
16860,16861,21-10-2020 15:54:10.662042,Desayunos · Típica,D'Porco - Lechona,17800,6300,24100
16861,16862,21-10-2020 15:54:10.964102,Pollo · China,China Tao,13600,3500,17100
16862,16863,21-10-2020 15:54:11.216028,Desayunos · Helados,San Giorgio Gelateria,31800,3100,34900
16863,16864,21-10-2020 15:54:11.567915,Típica,Sabrosito,15600,4000,19600
16864,16865,21-10-2020 15:54:11.769915,Pescados y Mariscos,Fish Place - Del Mar,29500,5400,34900
16865,16866,21-10-2020 15:54:12.021729,Helados,Buon Gelato,65000,4400,69400
16866,16867,21-10-2020 15:54:12.173483,Parrilla · Café,Gaira Café,35000,4400,39400
16867,16868,21-10-2020 15:54:12.575119,Postres · Desayunos,Sharmus,45800,6100,51900
16868,16869,21-10-2020 15:54:12.977346,Desayunos · Sánduches,Garnish,11870,5200,17070
16869,16870,21-10-2020 15:54:13.179109,Saludable · Desayunos,Bawana - Sandwich,15000,3400,18400
16870,16871,21-10-2020 15:54:13.581585,Desayunos · Panadería,Siena Café,9000,3700,12700
16871,16872,21-10-2020 15:54:13.933552,Desayunos · Típica,Alce,53400,4900,58300
16872,16873,21-10-2020 15:54:14.085700,Comida Rápida · Perros Calientes,Similoa - Comida Rapida,70000,3700,73700
16873,16874,21-10-2020 15:54:14.237685,Desayunos · Parrilla,Mi Patria,29500,4600,34100
16874,16875,21-10-2020 15:54:14.389313,Saludable,Hanai - Bowls Saludables,53900,5900,59800
16875,16876,21-10-2020 15:54:14.792730,Mexicana,La leyenda mexican kitchen,17800,3200,21000
16876,16877,21-10-2020 15:54:15.094372,Parrilla,Coquitas,48750,5600,54350
16877,16878,21-10-2020 15:54:15.296489,Típica · Parrilla,La Ternera Parrilla,9000,5200,14200
16878,16879,21-10-2020 15:54:15.648827,Postres · Desayunos,Maltihelados,39700,6200,45900
16879,16880,21-10-2020 15:54:15.850411,Típica · Pescados y Mariscos,La Vitualla,12500,6300,18800
16880,16881,21-10-2020 15:54:16.101968,Postres · Desayunos,Gelateria Da Favola,34500,6500,41000
16881,16882,21-10-2020 15:54:16.454111,Desayunos,Señor Desayuno,10700,6800,17500
16882,16883,21-10-2020 15:54:16.655997,Desayunos · Pescados y Mariscos,Gypsy Bistro,34500,4500,39000
16883,16884,21-10-2020 15:54:16.957801,Desayunos,Sunny Breakfast Brunch,48750,4300,53050
16884,16885,21-10-2020 15:54:17.159670,Parrilla · Café,Gaira Café,31800,4400,36200
16885,16886,21-10-2020 15:54:17.561876,Saludable · Desayunos,Básico y elemental,17800,5000,22800
16886,16887,21-10-2020 15:54:17.714267,Parrilla,Restaurante Bar Mi Ranchito,13000,5200,18200
16887,16888,21-10-2020 15:54:17.965931,Saludable · Típica,Sopas Mrg,35000,3100,38100
16888,16889,21-10-2020 15:54:18.217963,Saludable · Desayunos,Raices Bienestar Gourmet,35000,6600,41600
16889,16890,21-10-2020 15:54:18.369736,Saludable · Desayunos,Fresh Co,24200,5600,29800
16890,16891,21-10-2020 15:54:18.621973,Pollo · Desayunos,Piaf,31800,6500,38300
16891,16892,21-10-2020 15:54:18.823281,Postres · Café,Celestino Café,13600,5900,19500
16892,16893,21-10-2020 15:54:19.175363,Desayunos · Sánduches,Danilo Colombia,29500,3300,32800
16893,16894,21-10-2020 15:54:19.427794,Parrilla,Rústico Picadería,17800,3800,21600
16894,16895,21-10-2020 15:54:19.630110,Hamburguesas · Saludable,Restaurant Inn,23000,6100,29100
16895,16896,21-10-2020 15:54:19.932207,Poke,Poke Go,24300,4600,28900
16896,16897,21-10-2020 15:54:20.334000,Típica,El Mondongo y Mucho Mas,37900,5600,43500
16897,16898,21-10-2020 15:54:20.535424,Postres,Beiked,39700,4000,43700
16898,16899,21-10-2020 15:54:20.786612,Típica · Parrilla,El Portal de la Antigua,17800,5600,23400
16899,16900,21-10-2020 15:54:20.938106,Típica · Pescados y Mariscos,Arroces Mrg,35000,4300,39300
16900,16901,21-10-2020 15:54:21.089420,Saludable · Desayunos,Fresh Co,39700,5600,45300
16901,16902,21-10-2020 15:54:21.341706,Típica · Pescados y Mariscos,La Vitualla,15000,6300,21300
16902,16903,21-10-2020 15:54:21.543380,Pollo · Desayunos,Caserito Gourmet,23000,6700,29700
16903,16904,21-10-2020 15:54:21.945382,Postres · Desayunos,Sharmus,15000,6100,21100
16904,16905,21-10-2020 15:54:22.097283,Postres · Desayunos,Restaurante Cornelia,24300,5500,29800
16905,16906,21-10-2020 15:54:22.499192,Desayunos · Parrilla,Mi Patria,7500,4600,12100
16906,16907,21-10-2020 15:54:22.750162,Postres · Helados,Mahé,48750,6000,54750
16907,16908,21-10-2020 15:54:23.151977,Desayunos · Café,Aromacafé el Placer de Compartir,23000,5000,28000
16908,16909,21-10-2020 15:54:23.503777,Típica,Juan Chorizo,34500,3900,38400
16909,16910,21-10-2020 15:54:23.705428,Hamburguesas,Gofi Burger,23000,5100,28100
16910,16911,21-10-2020 15:54:23.956614,Pollo · Desayunos,Candelina,35000,5300,40300
16911,16912,21-10-2020 15:54:24.107757,Desayunos · Típica,Criollomania,11870,5200,17070
16912,16913,21-10-2020 15:54:24.509410,Postres · Desayunos,Café Quindio,53900,5700,59600
16913,16914,21-10-2020 15:54:24.860662,Típica · Parrilla,Mi Ranchito Parrilla,13600,4400,18000
16914,16915,21-10-2020 15:54:25.112215,Sushi · Asiática,Arigato,31800,5300,37100
16915,16916,21-10-2020 15:54:25.314387,Postres · Desayunos,Aury Postres - Comidas & Picadas,12500,4700,17200
16916,16917,21-10-2020 15:54:25.566839,Típica · Pescados y Mariscos,Arroces Mrg,29500,4300,33800
16917,16918,21-10-2020 15:54:25.719243,Desayunos · Sánduches,Garnish,65000,5200,70200
16918,16919,21-10-2020 15:54:26.121494,Saludable · Parrilla,Box,35000,3700,38700
16919,16920,21-10-2020 15:54:26.272731,Desayunos · Pescados y Mariscos,Gypsy Bistro,9000,4500,13500
16920,16921,21-10-2020 15:54:26.425527,Saludable · Parrilla,The Angels Grill and Drinks,37900,6200,44100
16921,16922,21-10-2020 15:54:26.826797,Desayunos · Típica,Calentao Express,35000,6000,41000
16922,16923,21-10-2020 15:54:27.178328,Sushi · Asiática,Arigato,34500,5300,39800
16923,16924,21-10-2020 15:54:27.379859,Desayunos · Pescados y Mariscos,Gypsy Bistro,29500,4500,34000
16924,16925,21-10-2020 15:54:27.781032,Desayunos,El Corral - Desayunos,35000,5000,40000
16925,16926,21-10-2020 15:54:27.982338,Postres,Levelma,15000,6200,21200
16926,16927,21-10-2020 15:54:28.233869,Saludable · Parrilla,The Angels Grill and Drinks,24300,6200,30500
16927,16928,21-10-2020 15:54:28.436092,Pollo,Señor Fantástico,53400,4700,58100
16928,16929,21-10-2020 15:54:28.587654,Postres,La Tertulia,23000,3400,26400
16929,16930,21-10-2020 15:54:28.938745,Helados,Buon Gelato,9000,4400,13400
16930,16931,21-10-2020 15:54:29.090060,Desayunos · Helados,San Giorgio Gelateria,9000,3100,12100
16931,16932,21-10-2020 15:54:29.241407,Desayunos · Café,Moramia,11870,4700,16570
16932,16933,21-10-2020 15:54:29.593936,Pollo,Heart & Cooking,8900,5000,13900
16933,16934,21-10-2020 15:54:29.795893,Postres · Desayunos,La Folie - Postres,65000,3300,68300
16934,16935,21-10-2020 15:54:29.947447,Parrilla,Restaurante Bar Mi Ranchito,24200,5200,29400
16935,16936,21-10-2020 15:54:30.150122,Desayunos · Panadería,Premium Break Bakery,34500,3700,38200
16936,16937,21-10-2020 15:54:30.501838,Desayunos · Panadería,Decofruta,48750,4700,53450
16937,16938,21-10-2020 15:54:30.852970,Desayunos · Pescados y Mariscos,Luzí­a - Mediterranea,23000,5700,28700
16938,16939,21-10-2020 15:54:31.054411,Desayunos · Jugos y Batidos,Dont Be Hungry,70000,5600,75600
16939,16940,21-10-2020 15:54:31.456244,Sánduches · Pescados y Mariscos,Pacific Comida de Mar,7500,4000,11500
16940,16941,21-10-2020 15:54:31.757836,Postres,La Galeta,70000,3000,73000
16941,16942,21-10-2020 15:54:31.909423,Típica · Pescados y Mariscos,Arroces Mrg,13000,4300,17300
16942,16943,21-10-2020 15:54:32.311407,Pizza · Italiana,Piatto - Pizza,18900,6600,25500
16943,16944,21-10-2020 15:54:32.613456,Saludable · Desayunos,Bawana - Sandwich,53400,3400,56800
16944,16945,21-10-2020 15:54:33.015089,Típica · Pescados y Mariscos,La Vitualla,29500,6300,35800
16945,16946,21-10-2020 15:54:33.366409,Típica · Parrilla,La Parilla de David,17800,3100,20900
16946,16947,21-10-2020 15:54:33.567873,Parrilla,Arepaisa de Medellín,45800,5600,51400
16947,16948,21-10-2020 15:54:33.819959,Típica,Bendita S,11870,4600,16470
16948,16949,21-10-2020 15:54:34.171360,Típica · Parrilla,La Parilla de David,12500,3100,15600
16949,16950,21-10-2020 15:54:34.523078,Pizza · Italiana,Pisapore - Pizza,7500,6600,14100
16950,16951,21-10-2020 15:54:34.774885,Parrilla · Café,Gaira Café,7500,4400,11900
16951,16952,21-10-2020 15:54:35.076859,Desayunos · Internacional,Camilia,15600,3900,19500
16952,16953,21-10-2020 15:54:35.430052,Desayunos,Sunny Breakfast Brunch,45800,4300,50100
16953,16954,21-10-2020 15:54:35.681891,Desayunos,El Corral - Desayunos,70000,5000,75000
16954,16955,21-10-2020 15:54:35.834404,Pollo,Señor Fantástico,9000,4700,13700
16955,16956,21-10-2020 15:54:36.137240,Saludable · Desayunos,Raices Bienestar Gourmet,15600,6600,22200
16956,16957,21-10-2020 15:54:36.338603,Parrilla,El Tambor,10700,6800,17500
16957,16958,21-10-2020 15:54:36.641053,Desayunos · Café,Aromacafé el Placer de Compartir,35000,5000,40000
16958,16959,21-10-2020 15:54:36.942661,Asiática,TeT,29500,5900,35400
16959,16960,21-10-2020 15:54:37.244959,Parrilla,El Tambor,15000,6800,21800
16960,16961,21-10-2020 15:54:37.597055,Comida Rápida · Perros Calientes,Similoa - Comida Rapida,13000,3700,16700
16961,16962,21-10-2020 15:54:37.898443,Mexicana,Cantina La 15,65000,4300,69300
16962,16963,21-10-2020 15:54:38.049751,Desayunos,El Corral - Desayunos,24200,5000,29200
16963,16964,21-10-2020 15:54:38.201094,Pollo · Sánduches,Pollos Century,65000,3000,68000
16964,16965,21-10-2020 15:54:38.352125,Desayunos · Típica,Casa Vieja,53400,6000,59400
16965,16966,21-10-2020 15:54:38.553426,Pollo · Desayunos,Piaf,7500,6500,14000
16966,16967,21-10-2020 15:54:38.854991,Pollo · Desayunos,Piaf,11870,6500,18370
16967,16968,21-10-2020 15:54:39.106422,Sánduches,Submarin,48750,3800,52550
16968,16969,21-10-2020 15:54:39.508081,Desayunos · Típica,Parrilla Farandula Típico,24300,5900,30200
16969,16970,21-10-2020 15:54:39.910036,Desayunos · Jugos y Batidos,Kuriwaji,53900,6300,60200
16970,16971,21-10-2020 15:54:40.211844,Desayunos · Comida Rápida,La Veneca,70000,6300,76300
16971,16972,21-10-2020 15:54:40.514154,Típica,Salsig,34500,5600,40100
16972,16973,21-10-2020 15:54:40.816113,Internacional,La Esquina con Sabor Parrilla,65000,3000,68000
16973,16974,21-10-2020 15:54:41.217703,Parrilla · Internacional,Taperia de la Plaza,29500,5700,35200
16974,16975,21-10-2020 15:54:41.419276,Saludable · Parrilla,Box,23000,3700,26700
16975,16976,21-10-2020 15:54:41.671010,Sushi · Asiática,Arigato,53400,5300,58700
16976,16977,21-10-2020 15:54:41.822326,Desayunos · Típica,D'Porco - Lechona,9000,6300,15300
16977,16978,21-10-2020 15:54:42.023733,Desayunos · Panadería,Artesanos,7500,4300,11800
16978,16979,21-10-2020 15:54:42.375791,Mexicana,La leyenda mexican kitchen,13600,3200,16800
16979,16980,21-10-2020 15:54:42.727442,Típica,Juan Chorizo,24300,3900,28200
16980,16981,21-10-2020 15:54:43.129579,Asiática,Thai Station,13600,6000,19600
16981,16982,21-10-2020 15:54:43.532076,Hamburguesas,Bendito Cordero,15600,5800,21400
16982,16983,21-10-2020 15:54:43.883796,Postres · Desayunos,Jacques Pastelería,31800,5900,37700
16983,16984,21-10-2020 15:54:44.235679,Saludable · Desayunos,Guadalupe - Fruteria,15600,5900,21500
16984,16985,21-10-2020 15:54:44.487937,Postres · Desayunos,Café Quindio,35000,5700,40700
16985,16986,21-10-2020 15:54:44.639354,Típica,El Mondongo y Mucho Mas,24300,5600,29900
16986,16987,21-10-2020 15:54:45.041592,Pizza,Pizza Andante,45800,6300,52100
16987,16988,21-10-2020 15:54:45.244214,Pizza,pizza andante,31800,4200,36000
16988,16989,21-10-2020 15:54:45.445770,Desayunos · Típica,Rojo Gourmet,15000,4700,19700
16989,16990,21-10-2020 15:54:45.798496,Desayunos · Comida Rápida,La Veneca,65000,6300,71300
16990,16991,21-10-2020 15:54:46.050149,Saludable · Desayunos,Básico y Elemental,13000,5900,18900
16991,16992,21-10-2020 15:54:46.452655,Típica,Sopitas y Más,35000,4200,39200
16992,16993,21-10-2020 15:54:46.604398,Típica · Parrilla,Typykos,70000,6000,76000
16993,16994,21-10-2020 15:54:46.856231,Italiana,Bocatto Di Passo,23000,5000,28000
16994,16995,21-10-2020 15:54:47.258112,Desayunos,Butter,13000,6700,19700
16995,16996,21-10-2020 15:54:47.560661,Postres,Toledo Pastelería,17800,6800,24600
16996,16997,21-10-2020 15:54:47.862130,Saludable · Desayunos,Fresh Co,9000,5600,14600
16997,16998,21-10-2020 15:54:48.113937,Comida Rápida · Perros Calientes,Similoa - Comida Rapida,70000,3700,73700
16998,16999,21-10-2020 15:54:48.417111,Típica,Juan Chorizo,13600,3900,17500
16999,17000,21-10-2020 15:54:48.769380,Desayunos · Árabe,Boniato Sabores Vivos,23000,5300,28300
17000,17001,21-10-2020 15:54:49.070959,Saludable,A2manos,24300,4200,28500
17001,17002,21-10-2020 15:54:49.223438,Parrilla,Arepaisa de Medellín,11870,5600,17470
17002,17003,21-10-2020 15:54:49.426585,Desayunos · Café,Moramia,8900,4700,13600
17003,17004,21-10-2020 15:54:49.778898,Sánduches · Pescados y Mariscos,Pacific Comida de Mar,23000,4000,27000
17004,17005,21-10-2020 15:54:50.181478,Poke,Poke Go,37900,4600,42500
17005,17006,21-10-2020 15:54:50.533011,Desayunos · Italiana,Rceta By Rausch,7500,3600,11100
17006,17007,21-10-2020 15:54:50.784255,Saludable · Desayunos,Distrito Gourmet,9000,3700,12700
17007,17008,21-10-2020 15:54:51.086657,Típica,Cazuelitas 93,53900,3900,57800
17008,17009,21-10-2020 15:54:51.487970,Hamburguesas,Bendito Cordero,37900,5800,43700
17009,17010,21-10-2020 15:54:51.689634,Saludable · Desayunos,Distrito Gourmet,8900,3700,12600
17010,17011,21-10-2020 15:54:51.841037,Desayunos · Árabe,Boniato Sabores Vivos,53900,5300,59200
17011,17012,21-10-2020 15:54:52.142980,Postres · Desayunos,Vivalight Market.,13600,6500,20100
17012,17013,21-10-2020 15:54:52.394640,Hamburguesas · Saludable,Restaurant Inn,24200,6100,30300
17013,17014,21-10-2020 15:54:52.796432,Desayunos,El Fogón Castellano,12500,3200,15700
17014,17015,21-10-2020 15:54:53.098121,Típica · Parrilla,Toya,53400,4200,57600
17015,17016,21-10-2020 15:54:53.500312,Pollo · Típica,Auyama,37900,3900,41800
17016,17017,21-10-2020 15:54:53.701811,Postres · Desayunos,Café Quindio,7500,5700,13200
17017,17018,21-10-2020 15:54:54.053618,Pollo · Pescados y Mariscos,Bang Bang Rice,23000,3400,26400
17018,17019,21-10-2020 15:54:54.305024,Sushi · Asiática,Arigato,34500,5300,39800
17019,17020,21-10-2020 15:54:54.656836,Típica,Carbón & Mondongos,23000,6400,29400
17020,17021,21-10-2020 15:54:54.958409,Pizza · Italiana,Piatto - Pizza,17800,6600,24400
17021,17022,21-10-2020 15:54:55.310089,Parrilla · Café,Figaro Café/ Restaurante Argentino,23000,5800,28800
17022,17023,21-10-2020 15:54:55.611936,Desayunos · Árabe,Boniato Sabores Vivos,39700,5300,45000
17023,17024,21-10-2020 15:54:56.013519,Sushi,Kim Pop,53900,5400,59300
17024,17025,21-10-2020 15:54:56.216300,Desayunos,Sunny Breakfast Brunch,39700,4300,44000
17025,17026,21-10-2020 15:54:56.368191,Postres · Saludable,Ana Rebana,9000,6300,15300
17026,17027,21-10-2020 15:54:56.519637,Saludable · Parrilla,The Angels Grill and Drinks,15600,6200,21800
17027,17028,21-10-2020 15:54:56.771281,Típica · Parrilla,Toya,53400,4200,57600
17028,17029,21-10-2020 15:54:57.173283,Desayunos · Típica,Papadió - Colombianas,70000,5700,75700
17029,17030,21-10-2020 15:54:57.425358,Helados,Buon Gelato,18900,4400,23300
17030,17031,21-10-2020 15:54:57.727205,Postres · Desayunos,Cosmo Cookies,11870,5900,17770
17031,17032,21-10-2020 15:54:57.979132,Típica,La Olla de Barro,7500,5300,12800
17032,17033,21-10-2020 15:54:58.331233,Pollo · Desayunos,Piaf,34500,6500,41000
17033,17034,21-10-2020 15:54:58.682734,Desayunos · Típica,Rojo Gourmet,45800,4700,50500
17034,17035,21-10-2020 15:54:58.984367,Asiática,Thai Station,9000,6000,15000
17035,17036,21-10-2020 15:54:59.236364,Saludable · Desayunos,Re.al Alimentos Reales,15000,4000,19000
17036,17037,21-10-2020 15:54:59.387845,Desayunos · Café,Libertario Coffee Roasters,29500,4600,34100
17037,17038,21-10-2020 15:54:59.789962,Mexicana,Hidalgo Taquería,27800,4900,32700
17038,17039,21-10-2020 15:54:59.941883,Desayunos · Panadería,Artesanos,23000,4300,27300
17039,17040,21-10-2020 15:55:00.143886,Postres · Desayunos,Buñuelos nacho,15600,6600,22200
17040,17041,21-10-2020 15:55:00.396164,Desayunos · Panadería,Juliana Restaurante,17800,6100,23900
17041,17042,21-10-2020 15:55:00.798839,Desayunos · Típica,90 Calentados,15000,3700,18700
17042,17043,21-10-2020 15:55:01.200477,Alta Cocina · Parrilla,Criterión,24200,6000,30200
17043,17044,21-10-2020 15:55:01.503477,Saludable,A2manos,15000,4200,19200
17044,17045,21-10-2020 15:55:01.805099,Postres · Desayunos,Amelie Helados,12500,6400,18900
17045,17046,21-10-2020 15:55:02.007364,Saludable · Desayunos,Distrito Gourmet,24200,3700,27900
17046,17047,21-10-2020 15:55:02.359664,Desayunos · Panadería,Decofruta,34500,4700,39200
17047,17048,21-10-2020 15:55:02.511315,Postres · Desayunos,Maria Luisa - Postres,7500,4300,11800
17048,17049,21-10-2020 15:55:02.812973,Típica · Parrilla,La Parilla de David,23000,3100,26100
17049,17050,21-10-2020 15:55:03.165678,Sushi,Sushi Reel,10700,4700,15400
17050,17051,21-10-2020 15:55:03.317826,Hamburguesas · Desayunos,El Inglés Gastro Pub,23000,6600,29600
17051,17052,21-10-2020 15:55:03.620137,Saludable · Desayunos,La Cesta,27800,4700,32500
17052,17053,21-10-2020 15:55:04.022182,Parrilla · Internacional,Taperia de la Plaza,70000,5700,75700
17053,17054,21-10-2020 15:55:04.173958,Pollo · Típica,Auyama,17800,3900,21700
17054,17055,21-10-2020 15:55:04.525913,Saludable · Desayunos,Guadalupe - Fruteria,9000,5900,14900
17055,17056,21-10-2020 15:55:04.727643,Saludable,Amor Propio saludable,13600,4000,17600
17056,17057,21-10-2020 15:55:05.079427,Postres,La Tertulia,53900,3400,57300
17057,17058,21-10-2020 15:55:05.331034,Saludable · Desayunos,Agua Dulce,39700,3700,43400
17058,17059,21-10-2020 15:55:05.482736,Típica,La Olla de Barro,23000,5300,28300
17059,17060,21-10-2020 15:55:05.634650,Saludable · Desayunos,Re.al Alimentos Reales,13000,4000,17000
17060,17061,21-10-2020 15:55:05.885879,Saludable · Desayunos,Distrito Gourmet,29500,3700,33200
17061,17062,21-10-2020 15:55:06.137614,Pescados y Mariscos,La Gran Cazuela,23000,3200,26200
17062,17063,21-10-2020 15:55:06.540999,Hamburguesas,Bendito Cordero,48750,5800,54550
17063,17064,21-10-2020 15:55:06.795837,Típica · Parrilla,Parrilla Farandula Gourmet,9000,5100,14100
17064,17065,21-10-2020 15:55:07.198192,Desayunos · Sánduches,Danilo Colombia,12500,3300,15800
17065,17066,21-10-2020 15:55:07.500030,Desayunos,El Fogón Castellano,15000,3200,18200
17066,17067,21-10-2020 15:55:07.902610,Parrilla,Parrilla Pimentón,12500,3400,15900
17067,17068,21-10-2020 15:55:08.054410,Postres · Desayunos,Cosmo Cookies,8900,5900,14800
17068,17069,21-10-2020 15:55:08.306941,Desayunos · Empanadas,Empanadas Doraditas.com,17800,3000,20800
17069,17070,21-10-2020 15:55:08.558709,Desayunos · Árabe,Boniato Sabores Vivos,8900,5300,14200
17070,17071,21-10-2020 15:55:08.960720,Saludable · Desayunos,Libre de Culpa,35000,4000,39000
17071,17072,21-10-2020 15:55:09.262611,Alta Cocina · Parrilla,Criterión,18900,6000,24900
17072,17073,21-10-2020 15:55:09.664733,Desayunos,Archies Desayunos,35000,3100,38100
17073,17074,21-10-2020 15:55:10.016408,Pollo · Desayunos,Caserito Gourmet,18900,6700,25600
17074,17075,21-10-2020 15:55:10.269057,Postres · Helados,Mahé,53900,6000,59900
17075,17076,21-10-2020 15:55:10.471723,Postres · Desayunos,Maria Luisa - Postres,17800,4300,22100
17076,17077,21-10-2020 15:55:10.823526,Desayunos · Típica,Calentao Express,35000,6000,41000
17077,17078,21-10-2020 15:55:10.975255,Hamburguesas · Alitas,Beer,53400,6600,60000
17078,17079,21-10-2020 15:55:11.177067,Perros Calientes,Dog Shop - Rapida,23000,4900,27900
17079,17080,21-10-2020 15:55:11.479038,Asiática,Thai Station,24200,6000,30200
17080,17081,21-10-2020 15:55:11.731892,Desayunos · Típica,Fogón Sangileño,18900,5000,23900
17081,17082,21-10-2020 15:55:12.083953,Desayunos · Café,Aromacafé el Placer de Compartir,65000,5000,70000
17082,17083,21-10-2020 15:55:12.336127,Desayunos · Café,Moramia,35000,4700,39700
17083,17084,21-10-2020 15:55:12.638501,Postres · Café,Loló Coffee & Snacks,53900,4600,58500
17084,17085,21-10-2020 15:55:12.990584,Desayunos · Café,vereda central calle 99,45800,5700,51500
17085,17086,21-10-2020 15:55:13.192545,Saludable · Parrilla,The Angels Grill and Drinks,10700,6200,16900
17086,17087,21-10-2020 15:55:13.594930,Pollo,Heart & Cooking,53900,5000,58900
17087,17088,21-10-2020 15:55:13.947186,Pollo · Desayunos,Abasto,34500,3600,38100
17088,17089,21-10-2020 15:55:14.249997,Alta Cocina · Italiana,Trattoria de la Plaza,9000,6000,15000
17089,17090,21-10-2020 15:55:14.402062,Desayunos · Panadería,Choclofee,53900,4700,58600
17090,17091,21-10-2020 15:55:14.804680,Hamburguesas · Desayunos,El Inglés Gastro Pub,27800,6600,34400
17091,17092,21-10-2020 15:55:15.007001,Pizza · Parrilla,Urban Lunch,53900,4000,57900
17092,17093,21-10-2020 15:55:15.159245,Mexicana,Cantina La 15,48750,4300,53050
17093,17094,21-10-2020 15:55:15.512434,Saludable,Ventura Soup y Salad,9000,3800,12800
17094,17095,21-10-2020 15:55:15.814766,Postres · Desayunos,Vivalight Market.,15600,6500,22100
17095,17096,21-10-2020 15:55:16.117554,Desayunos · Parrilla,Mi Patria,53900,4600,58500
17096,17097,21-10-2020 15:55:16.519982,Desayunos · Mexicana,La Mera Mera - Mexicana,7500,3100,10600
17097,17098,21-10-2020 15:55:16.671881,Típica,La Cocina,18900,4600,23500
17098,17099,21-10-2020 15:55:16.875125,Mexicana,Hidalgo Taquería,53400,4900,58300
17099,17100,21-10-2020 15:55:17.077217,Parrilla,Campocina,53900,4600,58500
17100,17101,21-10-2020 15:55:17.430575,Típica,La Olla de Barro,31800,5300,37100
17101,17102,21-10-2020 15:55:17.633507,Desayunos · Típica,Cochon,70000,3300,73300
17102,17103,21-10-2020 15:55:17.835482,Pollo · Desayunos,Abasto,12500,3600,16100
17103,17104,21-10-2020 15:55:17.987348,Postres · Desayunos,Buñuelos nacho,35000,6600,41600
17104,17105,21-10-2020 15:55:18.189639,Típica,El Cucharón - Tipica,53900,4400,58300
17105,17106,21-10-2020 15:55:18.341237,Italiana,Bocatto Di Passo,70000,5000,75000
17106,17107,21-10-2020 15:55:18.593310,Desayunos · Típica,Casa Vieja,18900,6000,24900
17107,17108,21-10-2020 15:55:18.945216,Postres · Café,Celestino Café,11870,5900,17770
17108,17109,21-10-2020 15:55:19.297999,Jugos y Batidos,Pomponio,8900,3600,12500
17109,17110,21-10-2020 15:55:19.550040,Típica · Parrilla,Toya,27800,4200,32000
17110,17111,21-10-2020 15:55:19.802214,Saludable,Hanai - Bowls Saludables,37900,5900,43800
17111,17112,21-10-2020 15:55:20.054585,Postres · Desayunos,BagBog Bagels,15600,6400,22000
17112,17113,21-10-2020 15:55:20.257559,Postres · Desayunos,Sweet Tale,15600,5800,21400
17113,17114,21-10-2020 15:55:20.509734,Postres · Panadería,RIGHT AWAY FOODS,10700,6600,17300
17114,17115,21-10-2020 15:55:20.662072,Pollo,Oliva Va,9000,5600,14600
17115,17116,21-10-2020 15:55:20.964851,Típica · Parrilla,Parrilla Farandula Gourmet,45800,5100,50900
17116,17117,21-10-2020 15:55:21.167500,Desayunos,Bagel Shop,23000,3200,26200
17117,17118,21-10-2020 15:55:21.421309,Desayunos · Árabe,Boniato Sabores Vivos,24300,5300,29600
17118,17119,21-10-2020 15:55:21.774612,Italiana,F*cking Good Pizza,45800,4200,50000
17119,17120,21-10-2020 15:55:22.077766,Internacional,La Esquina con Sabor Parrilla,53900,3000,56900
17120,17121,21-10-2020 15:55:22.280263,Sánduches,Submarin,35000,3800,38800
17121,17122,21-10-2020 15:55:22.482225,Típica,Cabrito Santandereano,13000,6600,19600
17122,17123,21-10-2020 15:55:22.834382,Desayunos · Típica,D´Porco,13600,3900,17500
17123,17124,21-10-2020 15:55:23.086279,Desayunos · Pescados y Mariscos,Luzí­a - Mediterranea,15000,5700,20700
17124,17125,21-10-2020 15:55:23.338610,Pollo · Desayunos,Abasto,15600,3600,19200
17125,17126,21-10-2020 15:55:23.541202,Típica,Carbón & Mondongos,8900,6400,15300
17126,17127,21-10-2020 15:55:23.893096,Desayunos · Panadería,Decofruta,39700,4700,44400
17127,17128,21-10-2020 15:55:24.245416,Desayunos · Jugos y Batidos,Frutiwow,8900,4100,13000
17128,17129,21-10-2020 15:55:24.548218,Sánduches · China,Peru Mix,37900,5900,43800
17129,17130,21-10-2020 15:55:24.700131,Desayunos · Típica,Rojo Gourmet,35000,4700,39700
17130,17131,21-10-2020 15:55:25.002554,Desayunos · Típica,Rojo Gourmet,23000,4700,27700
17131,17132,21-10-2020 15:55:25.204582,Desayunos · Típica,90 Calentados,23000,3700,26700
17132,17133,21-10-2020 15:55:25.556432,Típica,Bandejas Mrg,53900,3800,57700
17133,17134,21-10-2020 15:55:25.908381,Saludable · Desayunos,Libre de Culpa,15000,4000,19000
17134,17135,21-10-2020 15:55:26.110363,Postres · Café,Celestino Café,12500,5900,18400
17135,17136,21-10-2020 15:55:26.312977,Parrilla,Parrilla Pimentón,37900,3400,41300
17136,17137,21-10-2020 15:55:26.465836,Postres · Helados,Mahé,24300,6000,30300
17137,17138,21-10-2020 15:55:26.868417,Comida Rápida · Perros Calientes,Similoa - Comida Rapida,35000,3700,38700
17138,17139,21-10-2020 15:55:27.221855,Pollo · Típica,Auyama,15000,3900,18900
17139,17140,21-10-2020 15:55:27.473788,Desayunos · Café,vereda central calle 99,9000,5700,14700
17140,17141,21-10-2020 15:55:27.825686,Helados,Buon Gelato,35000,4400,39400
17141,17142,21-10-2020 15:55:28.127785,Parrilla · Internacional,Taperia de la Plaza,35000,5700,40700
17142,17143,21-10-2020 15:55:28.379807,Desayunos · Típica,D'Porco - Lechona,53900,6300,60200
17143,17144,21-10-2020 15:55:28.581735,Internacional,La Esquina con Sabor Parrilla,70000,3000,73000
17144,17145,21-10-2020 15:55:28.833901,Crepes,La Chabatta,7500,5900,13400
17145,17146,21-10-2020 15:55:28.986178,Desayunos · Sánduches,Danilo Colombia,53400,3300,56700
17146,17147,21-10-2020 15:55:29.188445,Desayunos · Café,Frambas,53400,3400,56800
17147,17148,21-10-2020 15:55:29.441332,Desayunos · Panadería,Ficchi Panadería,11870,3100,14970
17148,17149,21-10-2020 15:55:29.744246,Postres · Desayunos,Cosmo Cookies,70000,5900,75900
17149,17150,21-10-2020 15:55:30.147576,Saludable · Desayunos,Distrito Gourmet,39700,3700,43400
17150,17151,21-10-2020 15:55:30.500990,Desayunos,El Corral - Desayunos,13000,5000,18000
17151,17152,21-10-2020 15:55:30.754390,Saludable · Jugos y Batidos,Berdes Drinks & Salads,39700,3500,43200
17152,17153,21-10-2020 15:55:31.008531,Crepes,La Chabatta,23000,5900,28900
17153,17154,21-10-2020 15:55:31.211789,Parrilla · Café,Figaro Café/ Restaurante Argentino,23000,5800,28800
17154,17155,21-10-2020 15:55:31.464621,Pollo · China,China Tao,31800,3500,35300
17155,17156,21-10-2020 15:55:31.767194,Mexicana,Mexicanachos,45800,3900,49700
17156,17157,21-10-2020 15:55:32.120291,Desayunos · Típica,Calentao Express,24300,6000,30300
17157,17158,21-10-2020 15:55:32.424380,Saludable · Desayunos,Libre de Culpa,48750,4000,52750
17158,17159,21-10-2020 15:55:32.627946,Italiana,Bocatto Di Passo,29500,5000,34500
17159,17160,21-10-2020 15:55:32.880789,Jugos y Batidos,Pomponio,7500,3600,11100
17160,17161,21-10-2020 15:55:33.183896,Parrilla · Café,Gaira Café,13000,4400,17400
17161,17162,21-10-2020 15:55:33.586368,Pizza,pizza andante,35000,4200,39200
17162,17163,21-10-2020 15:55:33.838578,Desayunos,Fratelli - Desayunos,53900,4600,58500
17163,17164,21-10-2020 15:55:34.141022,Sushi · Asiática,Tu Sushi,39700,6400,46100
17164,17165,21-10-2020 15:55:34.493186,Parrilla,Beraca Parrilla Bbq,29500,5600,35100
17165,17166,21-10-2020 15:55:34.796004,Postres · Desayunos,Restaurante Cornelia,53400,5500,58900
17166,17167,21-10-2020 15:55:35.148554,Postres · Desayunos,Jacques Pastelería,13600,5900,19500
17167,17168,21-10-2020 15:55:35.450978,Desayunos · Típica,Casa Vieja,15600,6000,21600
17168,17169,21-10-2020 15:55:35.703195,Postres · Desayunos,Maltihelado,24300,4500,28800
17169,17170,21-10-2020 15:55:36.005352,Asiática,Thai Station,35000,6000,41000
17170,17171,21-10-2020 15:55:36.357624,Típica,Sopitas y Más,12500,4200,16700
17171,17172,21-10-2020 15:55:36.510138,Parrilla,Parrilla Pimentón,10700,3400,14100
17172,17173,21-10-2020 15:55:36.862343,Desayunos · Típica,Parrilla Farandula Típico,31800,5900,37700
17173,17174,21-10-2020 15:55:37.164483,Desayunos · Típica,La Parrilla Dorada Polo,29500,6600,36100
17174,17175,21-10-2020 15:55:37.467847,Alta Cocina · Parrilla,Criterión,10700,6000,16700
17175,17176,21-10-2020 15:55:37.720150,Pizza · Italiana,Piatto - Pizza,31800,6600,38400
17176,17177,21-10-2020 15:55:37.972876,Hamburguesas,Burger Society,13000,4100,17100
17177,17178,21-10-2020 15:55:38.275274,Típica,Cazuelitas 93,48750,3900,52650
17178,17179,21-10-2020 15:55:38.527402,Pollo,Señor Fantástico,70000,4700,74700
17179,17180,21-10-2020 15:55:38.829906,Desayunos,Señor Desayuno,70000,6800,76800
17180,17181,21-10-2020 15:55:39.031751,Desayunos · Italiana,Rceta By Rausch,45800,3600,49400
17181,17182,21-10-2020 15:55:39.183727,Parrilla,Beraca Parrilla Bbq,13600,5600,19200
17182,17183,21-10-2020 15:55:39.586096,Típica · Pescados y Mariscos,La Vitualla,7500,6300,13800
17183,17184,21-10-2020 15:55:39.838486,Típica,Sabrosito,12500,4000,16500
17184,17185,21-10-2020 15:55:40.191080,Postres · Desayunos,Cosmo Cookies,53900,5900,59800
17185,17186,21-10-2020 15:55:40.493163,Desayunos,La Frijolada Desayunos,31800,4400,36200
17186,17187,21-10-2020 15:55:40.845111,Desayunos,El Fogón Castellano,17800,3200,21000
17187,17188,21-10-2020 15:55:41.097427,Saludable · Desayunos,La Estampilla,15000,6000,21000
17188,17189,21-10-2020 15:55:41.349621,Sánduches,Submarin,48750,3800,52550
17189,17190,21-10-2020 15:55:41.551440,Italiana,F*cking Good Pizza,10700,4200,14900
17190,17191,21-10-2020 15:55:41.753526,Típica,Cazuelitas 93,24300,3900,28200
17191,17192,21-10-2020 15:55:41.955648,Crepes,La Chabatta,35000,5900,40900
17192,17193,21-10-2020 15:55:42.157773,Típica,Campo Victoria,37900,3000,40900
17193,17194,21-10-2020 15:55:42.511818,Desayunos,El Fogón Castellano,65000,3200,68200
17194,17195,21-10-2020 15:55:42.763814,Saludable · Desayunos,Bon Eat - Saludable,35000,4800,39800
17195,17196,21-10-2020 15:55:43.015981,Postres · Desayunos,Sweet Tale,48750,5800,54550
17196,17197,21-10-2020 15:55:43.218424,Postres · Desayunos,Amelie Helados,70000,6400,76400
17197,17198,21-10-2020 15:55:43.571437,Hamburguesas,Bendito Cordero,24300,5800,30100
17198,17199,21-10-2020 15:55:43.823242,Saludable,Hanai - Bowls Saludables,13600,5900,19500
17199,17200,21-10-2020 15:55:43.975878,Pollo · China,China Tao,39700,3500,43200
17200,17201,21-10-2020 15:55:44.178442,Desayunos · Típica,La Parrilla Dorada Polo,35000,6600,41600
17201,17202,21-10-2020 15:55:44.330451,Hamburguesas · Panadería,NYC Burgers,48750,6200,54950
17202,17203,21-10-2020 15:55:44.632857,Desayunos · Internacional,Camilia,35000,3900,38900
17203,17204,21-10-2020 15:55:45.035216,Desayunos,La Frijolada Desayunos,45800,4400,50200
17204,17205,21-10-2020 15:55:45.237835,Típica,Bandejas Mrg,53400,3800,57200
17205,17206,21-10-2020 15:55:45.640372,Saludable · Desayunos,Copacabana Açai Bowls,9000,3000,12000
17206,17207,21-10-2020 15:55:45.942110,Desayunos,Sr Buñuelo,13000,6400,19400
17207,17208,21-10-2020 15:55:46.094223,Desayunos,Jacinta Arepas de Huevo,23000,4000,27000
17208,17209,21-10-2020 15:55:46.496754,Pescados y Mariscos,Fish Place - Del Mar,31800,5400,37200
17209,17210,21-10-2020 15:55:46.799115,China,China Food Col,23000,3600,26600
17210,17211,21-10-2020 15:55:47.201239,Postres · Desayunos,Vivalight Market.,29500,6500,36000
17211,17212,21-10-2020 15:55:47.604305,Hamburguesas · Alitas,Beer,39700,6600,46300
17212,17213,21-10-2020 15:55:48.007085,Pizza,18 Scalini,70000,4300,74300
17213,17214,21-10-2020 15:55:48.409587,Desayunos,Sunny Breakfast Brunch,53900,4300,58200
17214,17215,21-10-2020 15:55:48.561606,Saludable · Desayunos,Agua Dulce,15600,3700,19300
17215,17216,21-10-2020 15:55:48.964087,Parrilla,Restaurante Bar Mi Ranchito,24300,5200,29500
17216,17217,21-10-2020 15:55:49.116033,Saludable · Típica,Saludable Mrg,53400,5800,59200
17217,17218,21-10-2020 15:55:49.368938,Jugos y Batidos,Pomponio,10700,3600,14300
17218,17219,21-10-2020 15:55:49.520728,Postres · Desayunos,Restaurante Cornelia,34500,5500,40000
17219,17220,21-10-2020 15:55:49.723092,Desayunos,La Frijolada Desayunos,53400,4400,57800
17220,17221,21-10-2020 15:55:49.924735,Postres,Beiked,27800,4000,31800
17221,17222,21-10-2020 15:55:50.076650,Pescados y Mariscos,La Gran Cazuela,11870,3200,15070
17222,17223,21-10-2020 15:55:50.429279,Peruana · Internacional,La Chifería,9000,6600,15600
17223,17224,21-10-2020 15:55:50.581396,Saludable · Desayunos,Maracuyá,45800,6700,52500
17224,17225,21-10-2020 15:55:50.833772,Sánduches · China,Peru Mix,70000,5900,75900
17225,17226,21-10-2020 15:55:51.136435,Desayunos · Típica,D'Porco - Lechona,15600,6300,21900
17226,17227,21-10-2020 15:55:51.289110,Postres,Toledo Pastelería,29500,6800,36300
17227,17228,21-10-2020 15:55:51.491677,Típica · Parrilla,La Ternera Parrilla,45800,5200,51000
17228,17229,21-10-2020 15:55:51.794016,Desayunos · Sánduches,Garnish,70000,5200,75200
17229,17230,21-10-2020 15:55:51.946250,Desayunos,Sr Buñuelo,65000,6400,71400
17230,17231,21-10-2020 15:55:52.149527,Desayunos · Típica,Fogón Sangileño,10700,5000,15700
17231,17232,21-10-2020 15:55:52.501982,Hamburguesas,Bendito Cordero,23000,5800,28800
17232,17233,21-10-2020 15:55:52.805601,Desayunos · Típica,Parrilla Farandula Típico,27800,5900,33700
17233,17234,21-10-2020 15:55:53.107904,Jugos y Batidos,Pomponio,45800,3600,49400
17234,17235,21-10-2020 15:55:53.410377,Postres · Desayunos,Sweet Tale,11870,5800,17670
17235,17236,21-10-2020 15:55:53.813410,Pollo · Desayunos,Abasto,65000,3600,68600
17236,17237,21-10-2020 15:55:54.015994,Típica · Pescados y Mariscos,Arroces Mrg,70000,4300,74300
17237,17238,21-10-2020 15:55:54.318223,Pizza,pizza andante,37900,4200,42100
17238,17239,21-10-2020 15:55:54.721364,Desayunos · Helados,San Giorgio Gelateria,31800,3100,34900
17239,17240,21-10-2020 15:55:55.124309,Típica · Parrilla,Mi Ranchito Parrilla,17800,4400,22200
17240,17241,21-10-2020 15:55:55.326161,Desayunos · Típica,La Parrilla Dorada Polo,24200,6600,30800
17241,17242,21-10-2020 15:55:55.528781,Desayunos · Típica,Cochon,27800,3300,31100
17242,17243,21-10-2020 15:55:55.680625,Hamburguesas,Monchis - Hamburguesa,13000,4300,17300
17243,17244,21-10-2020 15:55:55.832510,Pollo · Desayunos,Piaf,35000,6500,41500
17244,17245,21-10-2020 15:55:56.035038,Desayunos · Típica,D´Porco,8900,3900,12800
17245,17246,21-10-2020 15:55:56.287727,Mexicana,La leyenda mexican kitchen,12500,3200,15700
17246,17247,21-10-2020 15:55:56.589895,Pollo,Oliva Va,10700,5600,16300
17247,17248,21-10-2020 15:55:56.741991,Sushi,Sushi Reel,23000,4700,27700
17248,17249,21-10-2020 15:55:57.144546,Pollo · Típica,Auyama,70000,3900,73900
17249,17250,21-10-2020 15:55:57.296964,Típica,Juan Chorizo,8900,3900,12800
17250,17251,21-10-2020 15:55:57.649504,Postres · Desayunos,Aury Postres - Comidas & Picadas,70000,4700,74700
17251,17252,21-10-2020 15:55:57.852672,Saludable,Puro Verde,17800,5700,23500
17252,17253,21-10-2020 15:55:58.155068,Desayunos · Sánduches,Garnish,13600,5200,18800
17253,17254,21-10-2020 15:55:58.457762,Saludable · Desayunos,Maracuyá,34500,6700,41200
17254,17255,21-10-2020 15:55:58.860247,Parrilla,Carnes la Zarza,15600,4900,20500
17255,17256,21-10-2020 15:55:59.162442,Postres · Desayunos,Aury Postres - Comidas & Picadas,8900,4700,13600
17256,17257,21-10-2020 15:55:59.364700,Desayunos · Café,Aromacafé el Placer de Compartir,53400,5000,58400
17257,17258,21-10-2020 15:55:59.516841,Desayunos · Panadería,Le Pain Quotidien,29500,3900,33400
17258,17259,21-10-2020 15:55:59.819514,Hamburguesas · Pescados y Mariscos,El Velero,23000,6500,29500
17259,17260,21-10-2020 15:55:59.971945,Saludable · Desayunos,Guadalupe - Fruteria,53400,5900,59300
17260,17261,21-10-2020 15:56:00.374535,Desayunos · Panadería,Decofruta,29500,4700,34200
17261,17262,21-10-2020 15:56:00.576827,Pollo · Saludable,Yerbabuena,27800,3900,31700
17262,17263,21-10-2020 15:56:00.979368,Desayunos · Comida Rápida,La Veneca,70000,6300,76300
17263,17264,21-10-2020 15:56:01.232160,Desayunos · Pescados y Mariscos,Luzí­a - Mediterranea,34500,5700,40200
17264,17265,21-10-2020 15:56:01.484444,Saludable · Desayunos,Bawana - Sandwich,18900,3400,22300
17265,17266,21-10-2020 15:56:01.637021,Pizza,Pastas Laurentina,17800,4800,22600
17266,17267,21-10-2020 15:56:01.789392,Pollo · Saludable,Gratina,9000,4200,13200
17267,17268,21-10-2020 15:56:01.991740,Típica,Baondish,34500,5800,40300
17268,17269,21-10-2020 15:56:02.294540,Internacional,La Esquina con Sabor Parrilla,35000,3000,38000
17269,17270,21-10-2020 15:56:02.546729,Típica · Parrilla,Parrilla Farandula Gourmet,70000,5100,75100
17270,17271,21-10-2020 15:56:02.849171,Postres · Desayunos,Aury Postres - Comidas & Picadas,10700,4700,15400
17271,17272,21-10-2020 15:56:03.052352,Desayunos · Típica,90 Calentados,10700,3700,14400
17272,17273,21-10-2020 15:56:03.455947,Hamburguesas,Burger Society,23000,4100,27100
17273,17274,21-10-2020 15:56:03.859131,Alta Cocina · Parrilla,Criterión,12500,6000,18500
17274,17275,21-10-2020 15:56:04.112256,Desayunos · Café,El Gualilo,65000,6200,71200
17275,17276,21-10-2020 15:56:04.465287,Helados,Buon Gelato,17800,4400,22200
17276,17277,21-10-2020 15:56:04.817321,Típica,Cabrito Santandereano,15600,6600,22200
17277,17278,21-10-2020 15:56:05.220030,Parrilla,El Tambor,13600,6800,20400
17278,17279,21-10-2020 15:56:05.423425,Postres · Desayunos,BagBog Bagels,35000,6400,41400
17279,17280,21-10-2020 15:56:05.776455,Parrilla · Internacional,Taperia de la Plaza,8900,5700,14600
17280,17281,21-10-2020 15:56:06.028817,Postres · Desayunos,Sweet Tale,53900,5800,59700
17281,17282,21-10-2020 15:56:06.231361,Desayunos · Panadería,Choclofee,15000,4700,19700
17282,17283,21-10-2020 15:56:06.634173,Desayunos · Panadería,El Pan de Phillippe,27800,4600,32400
17283,17284,21-10-2020 15:56:06.886872,Pizza · Parrilla,Urban Lunch,35000,4000,39000
17284,17285,21-10-2020 15:56:07.039086,Desayunos,Señor Desayuno,23000,6800,29800
17285,17286,21-10-2020 15:56:07.191761,Desayunos · Café,Norma's Ice Cream Café,29500,6300,35800
17286,17287,21-10-2020 15:56:07.344332,Postres · Café,Celestino Café,17800,5900,23700
17287,17288,21-10-2020 15:56:07.546192,Postres · Desayunos,Vivalight Market.,27800,6500,34300
17288,17289,21-10-2020 15:56:07.798465,Desayunos · Café,vereda central calle 99,15600,5700,21300
17289,17290,21-10-2020 15:56:08.151743,Desayunos · Típica,Desayunadero de la 42,48750,5900,54650
17290,17291,21-10-2020 15:56:08.304095,Desayunos,El Fogón Castellano,29500,3200,32700
17291,17292,21-10-2020 15:56:08.556855,Parrilla,OAK Ahumado y Brebajes,37900,6000,43900
17292,17293,21-10-2020 15:56:08.859054,Postres,La Galeta,53400,3000,56400
17293,17294,21-10-2020 15:56:09.111277,Desayunos · Comida Rápida,Chocolatto,13000,3400,16400
17294,17295,21-10-2020 15:56:09.363687,Desayunos · Sánduches,Garnish,23000,5200,28200
17295,17296,21-10-2020 15:56:09.616939,Mexicana,Hidalgo Taquería,70000,4900,74900
17296,17297,21-10-2020 15:56:09.969485,Postres · Desayunos,Protein Bakes,39700,5900,45600
17297,17298,21-10-2020 15:56:10.321893,Saludable · Desayunos,Malú,35000,3700,38700
17298,17299,21-10-2020 15:56:10.624544,Parrilla,Rústico Picadería,7500,3800,11300
17299,17300,21-10-2020 15:56:10.777056,Desayunos · Típica,Parrilla Farandula Típico,53400,5900,59300
17300,17301,21-10-2020 15:56:10.979440,Postres · Desayunos,Buñuelos nacho,7500,6600,14100
17301,17302,21-10-2020 15:56:11.182361,Típica,Salsig,35000,5600,40600
17302,17303,21-10-2020 15:56:11.535518,Postres · Saludable,Ana Rebana,35000,6300,41300
17303,17304,21-10-2020 15:56:11.738302,Desayunos · Café,Norma's Ice Cream Café,15000,6300,21300
17304,17305,21-10-2020 15:56:12.041153,Desayunos · Panadería,Limarys,8900,6500,15400
17305,17306,21-10-2020 15:56:12.343462,Pollo · Desayunos,Workzone,35000,3100,38100
17306,17307,21-10-2020 15:56:12.495901,Saludable · Desayunos,Copacabana Açai Bowls,53900,3000,56900
17307,17308,21-10-2020 15:56:12.748344,Sushi · Desayunos,Maki Roll,17800,4300,22100
17308,17309,21-10-2020 15:56:13.152078,Desayunos,Archies Desayunos,13000,3100,16100
17309,17310,21-10-2020 15:56:13.354608,Parrilla,El Tambor,24200,6800,31000
17310,17311,21-10-2020 15:56:13.507073,Parrilla,Parrilla Pimentón,27800,3400,31200
17311,17312,21-10-2020 15:56:13.759495,Alta Cocina · Parrilla,Criterión,13000,6000,19000
17312,17313,21-10-2020 15:56:14.062608,Típica,Sopitas y Más,13600,4200,17800
17313,17314,21-10-2020 15:56:14.415276,Postres · Desayunos,Aury Postres - Comidas & Picadas,35000,4700,39700
17314,17315,21-10-2020 15:56:14.617491,Saludable · Desayunos,Raices Bienestar Gourmet,35000,6600,41600
17315,17316,21-10-2020 15:56:14.970151,Parrilla,El Tambor,9000,6800,15800
17316,17317,21-10-2020 15:56:15.372653,Parrilla,Rústico Picadería,45800,3800,49600
17317,17318,21-10-2020 15:56:15.725570,Parrilla · Internacional,Taperia de la Plaza,70000,5700,75700
17318,17319,21-10-2020 15:56:16.078159,Saludable · Típica,Sopas Mrg,31800,3100,34900
17319,17320,21-10-2020 15:56:16.231256,Saludable · Desayunos,Libre de Culpa,23000,4000,27000
17320,17321,21-10-2020 15:56:16.484005,Sushi · Asiática,Tu Sushi,13600,6400,20000
17321,17322,21-10-2020 15:56:16.786452,Saludable · Desayunos,Libre de Culpa,23000,4000,27000
17322,17323,21-10-2020 15:56:17.139444,Saludable,MIMA,9000,3700,12700
17323,17324,21-10-2020 15:56:17.291747,Crepes,La Chabatta,15600,5900,21500
17324,17325,21-10-2020 15:56:17.493953,Alta Cocina · Italiana,Trattoria de la Plaza,53400,6000,59400
17325,17326,21-10-2020 15:56:17.746272,Desayunos,El Corral - Desayunos,24300,5000,29300
17326,17327,21-10-2020 15:56:18.048662,Postres · Desayunos,Jacques Pastelería,35000,5900,40900
17327,17328,21-10-2020 15:56:18.252336,Saludable · Desayunos,Copacabana Açai Bowls,34500,3000,37500
17328,17329,21-10-2020 15:56:18.604902,Postres · Desayunos,BagBog Bagels,24300,6400,30700
17329,17330,21-10-2020 15:56:18.807068,Crepes,La Chabatta,65000,5900,70900
17330,17331,21-10-2020 15:56:19.109491,Hamburguesas · Panadería,NYC Burgers,35000,6200,41200
17331,17332,21-10-2020 15:56:19.511961,Típica · Parrilla,Toya,29500,4200,33700
17332,17333,21-10-2020 15:56:19.864740,Saludable · Desayunos,Copacabana Açai Bowls,45800,3000,48800
17333,17334,21-10-2020 15:56:20.268008,Postres · Café,Loló Coffee & Snacks,45800,4600,50400
17334,17335,21-10-2020 15:56:20.470987,Desayunos · Jugos y Batidos,Dont Be Hungry,35000,5600,40600
17335,17336,21-10-2020 15:56:20.623476,Comida Rápida,Fiesta Digital Andrés,48750,3100,51850
17336,17337,21-10-2020 15:56:20.775976,Comida Rápida · Perros Calientes,Similoa - Comida Rapida,39700,3700,43400
17337,17338,21-10-2020 15:56:21.128925,Alta Cocina · Parrilla,Criterión,13000,6000,19000
17338,17339,21-10-2020 15:56:21.331240,Desayunos · Helados,San Giorgio Gelateria,23000,3100,26100
17339,17340,21-10-2020 15:56:21.483480,Postres · Desayunos,Buñuelos nacho,8900,6600,15500
17340,17341,21-10-2020 15:56:21.836063,Desayunos · Típica,Calentao Express,39700,6000,45700
17341,17342,21-10-2020 15:56:22.038544,Desayunos · Típica,Parrilla Farandula Típico,24200,5900,30100
17342,17343,21-10-2020 15:56:22.191116,Pollo · Saludable,Tremenda Sal y Dulce,70000,6500,76500
17343,17344,21-10-2020 15:56:22.343843,Desayunos · Café,Moramia,37900,4700,42600
17344,17345,21-10-2020 15:56:22.746529,Parrilla,Rústico Picadería,34500,3800,38300
17345,17346,21-10-2020 15:56:22.998830,Saludable,A2manos,17800,4200,22000
17346,17347,21-10-2020 15:56:23.201899,Desayunos · Típica,Cochon,11870,3300,15170
17347,17348,21-10-2020 15:56:23.505862,Desayunos · Sánduches,Danilo Colombia,15600,3300,18900
17348,17349,21-10-2020 15:56:23.658533,Desayunos · Panadería,El Pan de Phillippe,23000,4600,27600
17349,17350,21-10-2020 15:56:23.861289,Italiana,Bocatto Di Passo,24200,5000,29200
17350,17351,21-10-2020 15:56:24.164147,Pizza,Pastas Laurentina,12500,4800,17300
17351,17352,21-10-2020 15:56:24.417799,Postres · Desayunos,Cosmo Cookies,53900,5900,59800
17352,17353,21-10-2020 15:56:24.820779,Jugos y Batidos,Pomponio,11870,3600,15470
17353,17354,21-10-2020 15:56:25.072921,Pollo · Desayunos,Abasto,29500,3600,33100
17354,17355,21-10-2020 15:56:25.426276,Desayunos · Sánduches,Danilo Colombia,37900,3300,41200
17355,17356,21-10-2020 15:56:25.730058,Desayunos · Típica,D´Porco,27800,3900,31700
17356,17357,21-10-2020 15:56:25.934033,Típica,Sabrosito,24300,4000,28300
17357,17358,21-10-2020 15:56:26.238164,Parrilla,Arepaisa de Medellín,45800,5600,51400
17358,17359,21-10-2020 15:56:26.442137,Saludable,Puro Verde,7500,5700,13200
17359,17360,21-10-2020 15:56:26.594466,Típica,Cabrito Santandereano,39700,6600,46300
17360,17361,21-10-2020 15:56:26.897151,Desayunos,Fratelli - Desayunos,34500,4600,39100
17361,17362,21-10-2020 15:56:27.049658,Pescados y Mariscos,La Gran Cazuela,17800,3200,21000
17362,17363,21-10-2020 15:56:27.202202,Perros Calientes,Dog Shop - Rapida,34500,4900,39400
17363,17364,21-10-2020 15:56:27.505705,Pollo · China,China Tao,65000,3500,68500
17364,17365,21-10-2020 15:56:27.708395,Desayunos,Don Leo,15600,6000,21600
17365,17366,21-10-2020 15:56:27.961582,Sushi,Kim Pop,39700,5400,45100
17366,17367,21-10-2020 15:56:28.214489,Desayunos · Empanadas,Mis Delicias,12500,3200,15700
17367,17368,21-10-2020 15:56:28.618582,Parrilla,Parrilla Pimentón,13000,3400,16400
17368,17369,21-10-2020 15:56:28.871262,Pescados y Mariscos,Fish Place - Del Mar,12500,5400,17900
17369,17370,21-10-2020 15:56:29.224506,Parrilla,OAK Ahumado y Brebajes,24300,6000,30300
17370,17371,21-10-2020 15:56:29.577416,Internacional,Rio Sabores y Experiencias,23000,4100,27100
17371,17372,21-10-2020 15:56:29.730102,Internacional,Rio Sabores y Experiencias,12500,4100,16600
17372,17373,21-10-2020 15:56:30.032401,Desayunos,Cafetería el Kippe,37900,3200,41100
17373,17374,21-10-2020 15:56:30.284982,Pollo,Heart & Cooking,35000,5000,40000
17374,17375,21-10-2020 15:56:30.637936,Pizza · Parrilla,Urban Lunch,15600,4000,19600
17375,17376,21-10-2020 15:56:31.040973,Saludable,Puro Verde,45800,5700,51500
17376,17377,21-10-2020 15:56:31.343462,Helados,Buon Gelato,23000,4400,27400
17377,17378,21-10-2020 15:56:31.546001,Postres · Desayunos,KOKOA & co.,31800,4700,36500
17378,17379,21-10-2020 15:56:31.798311,Hamburguesas · Panadería,NYC Burgers,18900,6200,25100
17379,17380,21-10-2020 15:56:32.000473,Saludable,MIMA,29500,3700,33200
17380,17381,21-10-2020 15:56:32.403394,Pollo · Saludable,Gratina,18900,4200,23100
17381,17382,21-10-2020 15:56:32.756552,Desayunos · Parrilla,Mi Patria,23000,4600,27600
17382,17383,21-10-2020 15:56:33.159291,Postres · Desayunos,BagBog Bagels,11870,6400,18270
17383,17384,21-10-2020 15:56:33.361877,Parrilla,El Tambor,13600,6800,20400
17384,17385,21-10-2020 15:56:33.564210,Desayunos · Jugos y Batidos,Dont Be Hungry,35000,5600,40600
17385,17386,21-10-2020 15:56:33.817684,Típica · Parrilla,El Portal de la Antigua,10700,5600,16300
17386,17387,21-10-2020 15:56:34.070116,Pescados y Mariscos,Pescadero Héroes del Mar,13000,6600,19600
17387,17388,21-10-2020 15:56:34.473924,Postres · Panadería,RIGHT AWAY FOODS,10700,6600,17300
17388,17389,21-10-2020 15:56:34.726380,Desayunos · Helados,San Giorgio Gelateria,27800,3100,30900
17389,17390,21-10-2020 15:56:34.979206,Parrilla,Arroces Maria Paula,23000,6800,29800
17390,17391,21-10-2020 15:56:35.181979,Parrilla · Café,Figaro Café/ Restaurante Argentino,35000,5800,40800
17391,17392,21-10-2020 15:56:35.584761,Postres · Desayunos,Amelie Helados,15000,6400,21400
17392,17393,21-10-2020 15:56:35.737056,Desayunos · Típica,Fogón Sangileño,48750,5000,53750
17393,17394,21-10-2020 15:56:35.989821,Crepes,La Chabatta,39700,5900,45600
17394,17395,21-10-2020 15:56:36.242136,Hamburguesas,Burger Society,23000,4100,27100
17395,17396,21-10-2020 15:56:36.544380,Pescados y Mariscos,Fish Place - Del Mar,12500,5400,17900
17396,17397,21-10-2020 15:56:36.897175,Perros Calientes,Dog Shop - Rapida,53400,4900,58300
17397,17398,21-10-2020 15:56:37.300324,Típica · Pescados y Mariscos,La Vitualla,8900,6300,15200
17398,17399,21-10-2020 15:56:37.453432,Postres · Desayunos,Restaurante Cornelia,15600,5500,21100
17399,17400,21-10-2020 15:56:37.706484,Saludable · Desayunos,Distrito Gourmet,18900,3700,22600
17400,17401,21-10-2020 15:56:38.109670,Sánduches · China,Peru Mix,23000,5900,28900
17401,17402,21-10-2020 15:56:38.262763,Desayunos · Café,El Gualilo,15000,6200,21200
17402,17403,21-10-2020 15:56:38.516060,Desayunos · Típica,La Parrilla Dorada Polo,15000,6600,21600
17403,17404,21-10-2020 15:56:38.669075,Desayunos,Desayunos en Bogotá,29500,3400,32900
17404,17405,21-10-2020 15:56:38.922771,Postres · Desayunos,Maltihelado,18900,4500,23400
17405,17406,21-10-2020 15:56:39.175914,Pescados y Mariscos,Fish Place - Del Mar,37900,5400,43300
17406,17407,21-10-2020 15:56:39.379065,Desayunos · Jugos y Batidos,Frutiwow,10700,4100,14800
17407,17408,21-10-2020 15:56:39.631972,Postres,Beiked,27800,4000,31800
17408,17409,21-10-2020 15:56:39.934476,Postres,Levelma,9000,6200,15200
17409,17410,21-10-2020 15:56:40.287609,Saludable · Parrilla,The Angels Grill and Drinks,31800,6200,38000
17410,17411,21-10-2020 15:56:40.490132,Típica,La Cocina,11870,4600,16470
17411,17412,21-10-2020 15:56:40.792979,Pollo · Saludable,Yerbabuena,24200,3900,28100
17412,17413,21-10-2020 15:56:41.095694,Típica · Parrilla,Mi Ranchito Parrilla,23000,4400,27400
17413,17414,21-10-2020 15:56:41.348536,Saludable,MIMA,7500,3700,11200
17414,17415,21-10-2020 15:56:41.500955,Internacional,Rio Sabores y Experiencias,8900,4100,13000
17415,17416,21-10-2020 15:56:41.703402,Postres · Desayunos,BagBog Bagels,27800,6400,34200
17416,17417,21-10-2020 15:56:42.106143,Pollo · Típica,Auyama,27800,3900,31700
17417,17418,21-10-2020 15:56:42.508807,Postres · Desayunos,Aury Postres - Comidas & Picadas,34500,4700,39200
17418,17419,21-10-2020 15:56:42.811683,Desayunos · Café,Moramia,37900,4700,42600
17419,17420,21-10-2020 15:56:43.064323,Parrilla,Rústico Picadería,45800,3800,49600
17420,17421,21-10-2020 15:56:43.217013,Típica · Parrilla,Toya,31800,4200,36000
17421,17422,21-10-2020 15:56:43.420199,Pollo · Típica,Auyama,39700,3900,43600
17422,17423,21-10-2020 15:56:43.723482,Postres · Café,Celestino Café,29500,5900,35400
17423,17424,21-10-2020 15:56:43.977449,Desayunos · Panadería,Le Pain Quotidien,17800,3900,21700
17424,17425,21-10-2020 15:56:44.180167,Parrilla,Coquitas,10700,5600,16300
17425,17426,21-10-2020 15:56:44.332440,Saludable,Hanai - Bowls Saludables,37900,5900,43800
17426,17427,21-10-2020 15:56:44.535144,Parrilla,Carnes la Zarza,24200,4900,29100
17427,17428,21-10-2020 15:56:44.837666,Pizza,Pizza Andante,70000,6300,76300
17428,17429,21-10-2020 15:56:45.040080,Típica · Parrilla,El Santandereano,8900,5200,14100
17429,17430,21-10-2020 15:56:45.192635,Saludable · Desayunos,Agua Dulce,24300,3700,28000
17430,17431,21-10-2020 15:56:45.595531,Saludable,Amor Propio saludable,18900,4000,22900
17431,17432,21-10-2020 15:56:45.998073,Típica · Pescados y Mariscos,La Vitualla,12500,6300,18800
17432,17433,21-10-2020 15:56:46.251473,Desayunos,Fratelli - Desayunos,53900,4600,58500
17433,17434,21-10-2020 15:56:46.504398,Alta Cocina · Parrilla,Criterión,12500,6000,18500
17434,17435,21-10-2020 15:56:46.757546,Perros Calientes,Dog Shop - Rapida,37900,4900,42800
17435,17436,21-10-2020 15:56:47.161199,Pollo · Desayunos,Piaf,18900,6500,25400
17436,17437,21-10-2020 15:56:47.364636,Postres · Desayunos,BagBog Bagels,11870,6400,18270
17437,17438,21-10-2020 15:56:47.768718,Desayunos · Típica,Papadió - Colombianas,31800,5700,37500
17438,17439,21-10-2020 15:56:48.171485,Postres · Desayunos,Sharmus,11870,6100,17970
17439,17440,21-10-2020 15:56:48.574466,Saludable · Jugos y Batidos,Berdes Drinks & Salads,31800,3500,35300
17440,17441,21-10-2020 15:56:48.727247,Típica,Sopitas y Más,34500,4200,38700
17441,17442,21-10-2020 15:56:49.131756,Postres · Desayunos,KOKOA & co.,12500,4700,17200
17442,17443,21-10-2020 15:56:49.435312,Desayunos · Sánduches,Garnish,29500,5200,34700
17443,17444,21-10-2020 15:56:49.789094,Desayunos · Italiana,Rceta By Rausch,15000,3600,18600
17444,17445,21-10-2020 15:56:49.992158,Sánduches · Pescados y Mariscos,Pacific Comida de Mar,15600,4000,19600
17445,17446,21-10-2020 15:56:50.195014,Sánduches · Pescados y Mariscos,Pacific Comida de Mar,29500,4000,33500
17446,17447,21-10-2020 15:56:50.598609,Mexicana,La leyenda mexican kitchen,53400,3200,56600
17447,17448,21-10-2020 15:56:50.901982,Desayunos · Mexicana,La Mera Mera - Mexicana,35000,3100,38100
17448,17449,21-10-2020 15:56:51.105592,Saludable,Ventura Soup y Salad,23000,3800,26800
17449,17450,21-10-2020 15:56:51.358831,Parrilla,Arepaisa de Medellín,11870,5600,17470
17450,17451,21-10-2020 15:56:51.762288,Parrilla,OAK Ahumado y Brebajes,29500,6000,35500
17451,17452,21-10-2020 15:56:52.065562,Saludable · Desayunos,Básico y elemental,53400,5000,58400
17452,17453,21-10-2020 15:56:52.469414,Postres · Desayunos,Restaurante Cornelia,35000,5500,40500
17453,17454,21-10-2020 15:56:52.722545,Parrilla,El Tambor,70000,6800,76800
17454,17455,21-10-2020 15:56:53.125905,Desayunos · Helados,San Giorgio Gelateria,29500,3100,32600
17455,17456,21-10-2020 15:56:53.479242,Típica,Juan Chorizo,53900,3900,57800
17456,17457,21-10-2020 15:56:53.882734,Pizza,Pastas Laurentina,8900,4800,13700
17457,17458,21-10-2020 15:56:54.137149,Pollo · Saludable,Gratina,45800,4200,50000
17458,17459,21-10-2020 15:56:54.490388,Típica,El Mondongo y Mucho Mas,9000,5600,14600
17459,17460,21-10-2020 15:56:54.793476,Desayunos · Sánduches,Danilo Colombia,24200,3300,27500
17460,17461,21-10-2020 15:56:55.046532,Sánduches · Pescados y Mariscos,Pacific Comida de Mar,45800,4000,49800
17461,17462,21-10-2020 15:56:55.300111,Parrilla · Internacional,Taperia de la Plaza,15000,5700,20700
17462,17463,21-10-2020 15:56:55.653539,Hamburguesas · Saludable,Restaurant Inn,37900,6100,44000
17463,17464,21-10-2020 15:56:55.906613,Sánduches · China,Peru Mix,13600,5900,19500
17464,17465,21-10-2020 15:56:56.259851,Típica,Sopitas y Más,45800,4200,50000
17465,17466,21-10-2020 15:56:56.613625,Helados,Orso To Go,39700,6800,46500
17466,17467,21-10-2020 15:56:57.017445,Panadería,Boul,7500,3100,10600
17467,17468,21-10-2020 15:56:57.170641,Desayunos,Sr Buñuelo,12500,6400,18900
17468,17469,21-10-2020 15:56:57.573761,Desayunos · Típica,Peninsula Calentados y Parrilla,17800,3400,21200
17469,17470,21-10-2020 15:56:57.926474,Sánduches · Pescados y Mariscos,Pacific Comida de Mar,35000,4000,39000
17470,17471,21-10-2020 15:56:58.329535,Postres · Desayunos,KOKOA & co.,65000,4700,69700
17471,17472,21-10-2020 15:56:58.732648,Saludable,The Good Rice Bowls,27800,3500,31300
17472,17473,21-10-2020 15:56:59.085491,Parrilla,OAK Ahumado y Brebajes,24300,6000,30300
17473,17474,21-10-2020 15:56:59.489500,Pollo · Pescados y Mariscos,Bang Bang Rice,31800,3400,35200
17474,17475,21-10-2020 15:56:59.792796,Desayunos · Típica,Parrilla Farandula Típico,31800,5900,37700
17475,17476,21-10-2020 15:57:00.095967,Parrilla,Parrilla Pimentón,8900,3400,12300
17476,17477,21-10-2020 15:57:00.348863,Sánduches · Pescados y Mariscos,Pacific Comida de Mar,18900,4000,22900
17477,17478,21-10-2020 15:57:00.652399,Típica · Parrilla,Mi Ranchito Parrilla,29500,4400,33900
17478,17479,21-10-2020 15:57:00.855367,Típica · Parrilla,Mi Ranchito Parrilla,15600,4400,20000
17479,17480,21-10-2020 15:57:01.108384,Comida Rápida,Fiesta Digital Andrés,29500,3100,32600
17480,17481,21-10-2020 15:57:01.361050,Desayunos,Butter,13600,6700,20300
17481,17482,21-10-2020 15:57:01.614177,Pollo,Señor Fantástico,13000,4700,17700
17482,17483,21-10-2020 15:57:01.867601,Desayunos · Sánduches,Garnish,9000,5200,14200
17483,17484,21-10-2020 15:57:02.120771,Pollo · Saludable,Gratina,34500,4200,38700
17484,17485,21-10-2020 15:57:02.473978,Típica,Carbón & Mondongos,48750,6400,55150
17485,17486,21-10-2020 15:57:02.776639,Parrilla,Beraca Parrilla Bbq,8900,5600,14500
17486,17487,21-10-2020 15:57:03.180094,Saludable · Desayunos,Distrito Gourmet,13600,3700,17300
17487,17488,21-10-2020 15:57:03.533346,Pollo · China,China Tao,27800,3500,31300
17488,17489,21-10-2020 15:57:03.886846,Desayunos · Típica,D'Porco - Lechona,31800,6300,38100
17489,17490,21-10-2020 15:57:04.290182,Saludable,The Good Rice Bowls,18900,3500,22400
17490,17491,21-10-2020 15:57:04.594411,Desayunos · Típica,90 Calentados,35000,3700,38700
17491,17492,21-10-2020 15:57:04.947379,Desayunos,Butter,70000,6700,76700
17492,17493,21-10-2020 15:57:05.150724,Postres,Beiked,45800,4000,49800
17493,17494,21-10-2020 15:57:05.553945,Típica,Lo Nuestro,31800,3100,34900
17494,17495,21-10-2020 15:57:05.957302,Desayunos · Empanadas,Mis Delicias,53400,3200,56600
17495,17496,21-10-2020 15:57:06.210532,Pollo · Saludable,Yerbabuena,17800,3900,21700
17496,17497,21-10-2020 15:57:06.563888,Postres,La Galeta,24300,3000,27300
17497,17498,21-10-2020 15:57:06.866823,Desayunos,Cafetería el Kippe,24200,3200,27400
17498,17499,21-10-2020 15:57:07.170298,Desayunos,Butter,70000,6700,76700
17499,17500,21-10-2020 15:57:07.573513,Típica,Juan Chorizo,10700,3900,14600
17500,17501,21-10-2020 15:57:07.977032,Asiática,Thai Station,7500,6000,13500
17501,17502,21-10-2020 15:57:08.380767,Pollo · Saludable,Yerbabuena,17800,3900,21700
17502,17503,21-10-2020 15:57:08.634505,Desayunos · Típica,Criollomania,70000,5200,75200
17503,17504,21-10-2020 15:57:08.987770,Desayunos · Pescados y Mariscos,Gypsy Bistro,10700,4500,15200
17504,17505,21-10-2020 15:57:09.340912,Parrilla,El Tambor,15600,6800,22400
17505,17506,21-10-2020 15:57:09.645090,Pollo,Señor Fantástico,23000,4700,27700
17506,17507,21-10-2020 15:57:09.947941,Saludable · Desayunos,Malú,11870,3700,15570
17507,17508,21-10-2020 15:57:10.150818,Desayunos · Panadería,Santa Juana Food Bar,53900,5900,59800
17508,17509,21-10-2020 15:57:10.553688,Desayunos · Panadería,Le Pain Quotidien,23000,3900,26900
17509,17510,21-10-2020 15:57:10.956645,Peruana · Internacional,La Chifería,37900,6600,44500
17510,17511,21-10-2020 15:57:11.310165,Peruana,Masivo,15000,5800,20800
17511,17512,21-10-2020 15:57:11.663525,Desayunos · Mexicana,La Mera Mera - Mexicana,37900,3100,41000
17512,17513,21-10-2020 15:57:12.016915,Pollo,Señor Fantástico,24300,4700,29000
17513,17514,21-10-2020 15:57:12.420381,Típica · Pescados y Mariscos,La Vitualla,15000,6300,21300
17514,17515,21-10-2020 15:57:12.573227,Desayunos,Fratelli - Desayunos,31800,4600,36400
17515,17516,21-10-2020 15:57:12.776197,Típica,Sopitas y Más,11870,4200,16070
17516,17517,21-10-2020 15:57:13.029229,Peruana,Uma Cantina Peruana,7500,3200,10700
17517,17518,21-10-2020 15:57:13.433574,Postres · Desayunos,Buñuelos nacho,35000,6600,41600
17518,17519,21-10-2020 15:57:13.586498,Desayunos · Internacional,Camilia,48750,3900,52650
17519,17520,21-10-2020 15:57:13.889521,Pollo · Saludable,Yerbabuena,65000,3900,68900
17520,17521,21-10-2020 15:57:14.042575,Desayunos · Típica,90 Calentados,39700,3700,43400
17521,17522,21-10-2020 15:57:14.245841,Saludable · Desayunos,Re.al Alimentos Reales,48750,4000,52750
17522,17523,21-10-2020 15:57:14.399352,Típica,Bendita S,13600,4600,18200
17523,17524,21-10-2020 15:57:14.653466,Típica,Juan Chorizo,15000,3900,18900
17524,17525,21-10-2020 15:57:14.856208,Típica,La Herencia,35000,5900,40900
17525,17526,21-10-2020 15:57:15.159107,Típica,Sabrosito,12500,4000,16500
17526,17527,21-10-2020 15:57:15.462570,Desayunos · Típica,Parrilla Farandula Típico,24200,5900,30100
17527,17528,21-10-2020 15:57:15.615734,Típica · Pescados y Mariscos,Arroces Mrg,35000,4300,39300
17528,17529,21-10-2020 15:57:16.019499,Italiana,F*cking Good Pizza,65000,4200,69200
17529,17530,21-10-2020 15:57:16.172426,Desayunos · Panadería,Artesanos,39700,4300,44000
17530,17531,21-10-2020 15:57:16.525767,Postres · Desayunos,Sweet Tale,39700,5800,45500
17531,17532,21-10-2020 15:57:16.829008,Postres · Desayunos,Protein Bakes,23000,5900,28900
17532,17533,21-10-2020 15:57:17.082135,Jugos y Batidos,Pomponio,45800,3600,49400
17533,17534,21-10-2020 15:57:17.435698,Desayunos · Típica,D'Porco - Lechona,13000,6300,19300
17534,17535,21-10-2020 15:57:17.788993,Parrilla,Coquitas,17800,5600,23400
17535,17536,21-10-2020 15:57:17.992179,Típica · Parrilla,El Portal de la Antigua,65000,5600,70600
17536,17537,21-10-2020 15:57:18.245242,Postres · Desayunos,Restaurante Cornelia,35000,5500,40500
17537,17538,21-10-2020 15:57:18.498370,Desayunos,Jacinta Arepas de Huevo,23000,4000,27000
17538,17539,21-10-2020 15:57:18.751296,Pollo · Saludable,Tremenda Sal y Dulce,17800,6500,24300
17539,17540,21-10-2020 15:57:19.004602,Desayunos,Don Leo,13600,6000,19600
17540,17541,21-10-2020 15:57:19.408007,Desayunos,Archies Desayunos,48750,3100,51850
17541,17542,21-10-2020 15:57:19.662235,Postres · Saludable,Ana Rebana,29500,6300,35800
17542,17543,21-10-2020 15:57:19.815501,Saludable,Puro Verde,48750,5700,54450
17543,17544,21-10-2020 15:57:20.018738,Saludable · Desayunos,Raices Bienestar Gourmet,53400,6600,60000
17544,17545,21-10-2020 15:57:20.172693,Típica,Salsig,53400,5600,59000
17545,17546,21-10-2020 15:57:20.376361,Pollo · Desayunos,Abasto,70000,3600,73600
17546,17547,21-10-2020 15:57:20.730198,Sushi,Umi,8900,5600,14500
17547,17548,21-10-2020 15:57:21.084096,Saludable · Desayunos,La Cesta,8900,4700,13600
17548,17549,21-10-2020 15:57:21.438836,Desayunos · Típica,90 Calentados,24200,3700,27900
17549,17550,21-10-2020 15:57:21.842945,Típica,Sopitas y Más,9000,4200,13200
17550,17551,21-10-2020 15:57:21.997032,Crepes,La Chabatta,13000,5900,18900
17551,17552,21-10-2020 15:57:22.351468,Postres · Desayunos,La Folie - Postres,31800,3300,35100
17552,17553,21-10-2020 15:57:22.755539,Hamburguesas,Bendito Cordero,35000,5800,40800
17553,17554,21-10-2020 15:57:22.959238,Saludable · Parrilla,Box,12500,3700,16200
17554,17555,21-10-2020 15:57:23.163056,Desayunos,Bagel Shop,70000,3200,73200
17555,17556,21-10-2020 15:57:23.316456,Italiana,F*cking Good Pizza,7500,4200,11700
17556,17557,21-10-2020 15:57:23.470644,Perros Calientes,Dog Shop - Rapida,70000,4900,74900
17557,17558,21-10-2020 15:57:23.775162,Saludable,Hanai - Bowls Saludables,18900,5900,24800
17558,17559,21-10-2020 15:57:24.179872,Típica,El Mondongo y Mucho Mas,34500,5600,40100
17559,17560,21-10-2020 15:57:24.434180,Peruana,Uma Cantina Peruana,12500,3200,15700
17560,17561,21-10-2020 15:57:24.840161,Desayunos · Típica,La Parrilla Dorada Polo,9000,6600,15600
17561,17562,21-10-2020 15:57:25.193743,Parrilla,Beraca Parrilla Bbq,7500,5600,13100
17562,17563,21-10-2020 15:57:25.547480,Mexicana,Cantina La 15,37900,4300,42200
17563,17564,21-10-2020 15:57:25.850984,Hamburguesas · Saludable,Restaurant Inn,12500,6100,18600
17564,17565,21-10-2020 15:57:26.204051,Desayunos · Panadería,El Pan de Phillippe,65000,4600,69600
17565,17566,21-10-2020 15:57:26.357024,Pizza · Italiana,Piatto - Pizza,37900,6600,44500
17566,17567,21-10-2020 15:57:26.610013,Pollo · Desayunos,Workzone,13000,3100,16100
17567,17568,21-10-2020 15:57:26.863546,Desayunos · Internacional,Camilia,13600,3900,17500
17568,17569,21-10-2020 15:57:27.017290,Hamburguesas,Burger Society,48750,4100,52850
17569,17570,21-10-2020 15:57:27.221758,Saludable · Desayunos,Maracuyá,23000,6700,29700
17570,17571,21-10-2020 15:57:27.576156,Desayunos · Panadería,Choclofee,23000,4700,27700
17571,17572,21-10-2020 15:57:27.979587,Parrilla,Arroces Maria Paula,53900,6800,60700
17572,17573,21-10-2020 15:57:28.133019,Parrilla,El Tambor,53900,6800,60700
17573,17574,21-10-2020 15:57:28.286103,Saludable · Desayunos,Guadalupe - Fruteria,35000,5900,40900
17574,17575,21-10-2020 15:57:28.689695,Saludable · Desayunos,Guadalupe - Fruteria,23000,5900,28900
17575,17576,21-10-2020 15:57:28.843408,Típica,Bandejas Mrg,15000,3800,18800
17576,17577,21-10-2020 15:57:29.196843,Típica,Bandejas Mrg,29500,3800,33300
17577,17578,21-10-2020 15:57:29.450284,Perros Calientes,Dog Shop - Rapida,29500,4900,34400
17578,17579,21-10-2020 15:57:29.753542,Pollo · Desayunos,Piaf,29500,6500,36000
17579,17580,21-10-2020 15:57:30.157662,Italiana,F*cking Good Pizza,35000,4200,39200
17580,17581,21-10-2020 15:57:30.461317,Hamburguesas,Burger Society,31800,4100,35900
17581,17582,21-10-2020 15:57:30.715361,Saludable,The Good Rice Bowls,27800,3500,31300
17582,17583,21-10-2020 15:57:30.868525,Internacional,La Esquina con Sabor Parrilla,39700,3000,42700
17583,17584,21-10-2020 15:57:31.071822,Típica,Sabrosito,29500,4000,33500
17584,17585,21-10-2020 15:57:31.325303,Desayunos · Típica,Fogón Sangileño,15600,5000,20600
17585,17586,21-10-2020 15:57:31.729037,Saludable · Desayunos,Básico y Elemental,15600,5900,21500
17586,17587,21-10-2020 15:57:31.881995,Parrilla,Carnes la Zarza,45800,4900,50700
17587,17588,21-10-2020 15:57:32.185647,Parrilla,Campocina,45800,4600,50400
17588,17589,21-10-2020 15:57:32.338999,Pizza · Italiana,Piatto - Pizza,11870,6600,18470
17589,17590,21-10-2020 15:57:32.542169,Parrilla,Arepaisa de Medellín,9000,5600,14600
17590,17591,21-10-2020 15:57:32.845408,Italiana,Bocatto Di Passo,12500,5000,17500
17591,17592,21-10-2020 15:57:33.099144,Postres · Saludable,Ana Rebana,13600,6300,19900
17592,17593,21-10-2020 15:57:33.352518,Desayunos · Parrilla,Mi Patria,18900,4600,23500
17593,17594,21-10-2020 15:57:33.756724,Desayunos · Típica,Rojo Gourmet,53900,4700,58600
17594,17595,21-10-2020 15:57:34.010015,Hamburguesas,Burger Society,8900,4100,13000
17595,17596,21-10-2020 15:57:34.414084,Parrilla,Arepaisa de Medellín,23000,5600,28600
17596,17597,21-10-2020 15:57:34.617431,Desayunos · Típica,Fogón Sangileño,15600,5000,20600
17597,17598,21-10-2020 15:57:34.921032,Desayunos · Típica,Fogón Sangileño,15000,5000,20000
17598,17599,21-10-2020 15:57:35.074399,Saludable,Puro Verde,13000,5700,18700
17599,17600,21-10-2020 15:57:35.479202,Peruana,Uma Cantina Peruana,45800,3200,49000
17600,17601,21-10-2020 15:57:35.832628,Parrilla,Restaurante Bar Mi Ranchito,10700,5200,15900
17601,17602,21-10-2020 15:57:36.136453,Parrilla,Antojo a Domicilio,53400,5000,58400
17602,17603,21-10-2020 15:57:36.290342,Postres · Helados,Mahé,31800,6000,37800
17603,17604,21-10-2020 15:57:36.693722,Típica,El Cucharón - Tipica,39700,4400,44100
17604,17605,21-10-2020 15:57:36.846848,Hamburguesas · Saludable,Restaurant Inn,9000,6100,15100
17605,17606,21-10-2020 15:57:37.000097,Hamburguesas,Gofi Burger,23000,5100,28100
17606,17607,21-10-2020 15:57:37.403451,Desayunos · Típica,Criollomania,35000,5200,40200
17607,17608,21-10-2020 15:57:37.657256,Saludable · Desayunos,Maracuyá,23000,6700,29700
17608,17609,21-10-2020 15:57:37.810709,Postres · Desayunos,Gelateria Da Favola,31800,6500,38300
17609,17610,21-10-2020 15:57:38.164580,Desayunos · Café,vereda central calle 99,12500,5700,18200
17610,17611,21-10-2020 15:57:38.518764,Postres · Desayunos,Maltihelados,7500,6200,13700
17611,17612,21-10-2020 15:57:38.672730,Típica,Sabores De Mi Tierra,23000,5400,28400
17612,17613,21-10-2020 15:57:38.926404,Desayunos · Café,El Gualilo,35000,6200,41200
17613,17614,21-10-2020 15:57:39.281316,Desayunos · Árabe,Boniato Sabores Vivos,35000,5300,40300
17614,17615,21-10-2020 15:57:39.485256,Hamburguesas · Panadería,NYC Burgers,31800,6200,38000
17615,17616,21-10-2020 15:57:39.688969,Desayunos · Italiana,Rceta By Rausch,23000,3600,26600
17616,17617,21-10-2020 15:57:39.891852,Peruana · Internacional,La Chifería,23000,6600,29600
17617,17618,21-10-2020 15:57:40.045021,Parrilla · Café,Figaro Café/ Restaurante Argentino,53900,5800,59700
17618,17619,21-10-2020 15:57:40.448529,Desayunos · Pescados y Mariscos,Luzí­a - Mediterranea,24200,5700,29900
17619,17620,21-10-2020 15:57:40.853153,Saludable · Desayunos,Fresh Co,34500,5600,40100
17620,17621,21-10-2020 15:57:41.056398,Desayunos · Típica,Parrilla Farandula Típico,27800,5900,33700
17621,17622,21-10-2020 15:57:41.259349,Desayunos · Helados,San Giorgio Gelateria,12500,3100,15600
17622,17623,21-10-2020 15:57:41.462521,Parrilla · Internacional,Taperia de la Plaza,23000,5700,28700
17623,17624,21-10-2020 15:57:41.666152,Pizza · Italiana,Piatto - Pizza,23000,6600,29600
17624,17625,21-10-2020 15:57:41.868890,Desayunos · Típica,Alce,53400,4900,58300
17625,17626,21-10-2020 15:57:42.222406,Desayunos · Sánduches,Frutos del Bosque,65000,3500,68500
17626,17627,21-10-2020 15:57:42.475513,Desayunos · Panadería,Le Pain Quotidien,11870,3900,15770
17627,17628,21-10-2020 15:57:42.779141,Hamburguesas,Gofi Burger,48750,5100,53850
17628,17629,21-10-2020 15:57:43.082121,Sushi · Desayunos,Maki Roll,15000,4300,19300
17629,17630,21-10-2020 15:57:43.485752,Hamburguesas · Alitas,Beer,53900,6600,60500
17630,17631,21-10-2020 15:57:43.738507,Parrilla,Campocina,15000,4600,19600
17631,17632,21-10-2020 15:57:43.891410,Sushi · Desayunos,Maki Roll,13600,4300,17900
17632,17633,21-10-2020 15:57:44.244518,Típica · Parrilla,El Santandereano,24200,5200,29400
17633,17634,21-10-2020 15:57:44.448447,Desayunos · Panadería,Artesanos,13600,4300,17900
17634,17635,21-10-2020 15:57:44.852645,Saludable,The Good Rice Bowls,48750,3500,52250
17635,17636,21-10-2020 15:57:45.106295,Desayunos · Típica,D'Porco - Lechona,34500,6300,40800
17636,17637,21-10-2020 15:57:45.310008,Postres · Café,Loló Coffee & Snacks,53900,4600,58500
17637,17638,21-10-2020 15:57:45.713958,Desayunos · Comida Rápida,Chocolatto,70000,3400,73400
17638,17639,21-10-2020 15:57:45.917858,Desayunos · Árabe,Boniato Sabores Vivos,65000,5300,70300
17639,17640,21-10-2020 15:57:46.222109,Típica,Sopitas y Más,35000,4200,39200
17640,17641,21-10-2020 15:57:46.377676,Parrilla,Rústico Picadería,11870,3800,15670
17641,17642,21-10-2020 15:57:46.731997,Hamburguesas · Pescados y Mariscos,El Velero,65000,6500,71500
17642,17643,21-10-2020 15:57:46.885967,Desayunos · Café,Frambas,65000,3400,68400
17643,17644,21-10-2020 15:57:47.089390,Peruana · Internacional,La Chifería,45800,6600,52400
17644,17645,21-10-2020 15:57:47.493240,Desayunos · Típica,La Parrilla Dorada Polo,17800,6600,24400
17645,17646,21-10-2020 15:57:47.646688,Desayunos · Típica,Cochon,23000,3300,26300
17646,17647,21-10-2020 15:57:47.800357,Saludable · Desayunos,Malú,39700,3700,43400
17647,17648,21-10-2020 15:57:47.953970,Típica,Salsig,18900,5600,24500
17648,17649,21-10-2020 15:57:48.307740,Desayunos,Sunny Breakfast Brunch,15000,4300,19300
17649,17650,21-10-2020 15:57:48.511181,Desayunos,Desayunos en Bogotá,31800,3400,35200
17650,17651,21-10-2020 15:57:48.765813,Internacional,La Esquina con Sabor Parrilla,17800,3000,20800
17651,17652,21-10-2020 15:57:48.919223,Saludable,The Good Rice Bowls,18900,3500,22400
17652,17653,21-10-2020 15:57:49.072739,Pollo · Desayunos,Piaf,7500,6500,14000
17653,17654,21-10-2020 15:57:49.226330,Postres · Desayunos,Cosmo Cookies,53900,5900,59800
17654,17655,21-10-2020 15:57:49.529632,Desayunos · Mexicana,La Mera Mera - Mexicana,29500,3100,32600
17655,17656,21-10-2020 15:57:49.833453,Parrilla,Coquitas,34500,5600,40100
17656,17657,21-10-2020 15:57:50.187165,Saludable · Desayunos,La Cesta,65000,4700,69700
17657,17658,21-10-2020 15:57:50.590743,Peruana,Masivo,48750,5800,54550
17658,17659,21-10-2020 15:57:50.845180,Desayunos,El Corral - Desayunos,15000,5000,20000
17659,17660,21-10-2020 15:57:51.149295,Sushi · Asiática,Tu Sushi,34500,6400,40900
17660,17661,21-10-2020 15:57:51.502828,Pollo · Saludable,Gratina,24200,4200,28400
17661,17662,21-10-2020 15:57:51.656838,Italiana,F*cking Good Pizza,10700,4200,14900
17662,17663,21-10-2020 15:57:52.010408,Pollo · Saludable,Tremenda Sal y Dulce,35000,6500,41500
17663,17664,21-10-2020 15:57:52.214196,Parrilla,Antojo a Domicilio,37900,5000,42900
17664,17665,21-10-2020 15:57:52.367445,Sushi · Desayunos,Maki Roll,10700,4300,15000
17665,17666,21-10-2020 15:57:52.621193,Pizza · Italiana,Piatto - Pizza,17800,6600,24400
17666,17667,21-10-2020 15:57:53.024283,Desayunos · Mexicana,La Mera Mera - Mexicana,17800,3100,20900
17667,17668,21-10-2020 15:57:53.277627,Helados,Orso To Go,27800,6800,34600
17668,17669,21-10-2020 15:57:53.680704,Desayunos,Sr Buñuelo,24300,6400,30700
17669,17670,21-10-2020 15:57:53.983783,Pescados y Mariscos,La Gran Cazuela,65000,3200,68200
17670,17671,21-10-2020 15:57:54.237104,Alta Cocina · Parrilla,Criterión,35000,6000,41000
17671,17672,21-10-2020 15:57:54.590728,Desayunos · Típica,Alce,23000,4900,27900
17672,17673,21-10-2020 15:57:54.944177,Desayunos · Café,El Gualilo,27800,6200,34000
17673,17674,21-10-2020 15:57:55.097205,Italiana,F*cking Good Pizza,24200,4200,28400
17674,17675,21-10-2020 15:57:55.500482,Típica · Parrilla,Mi Ranchito Parrilla,24200,4400,28600
17675,17676,21-10-2020 15:57:55.653862,Saludable · Parrilla,Box,27800,3700,31500
17676,17677,21-10-2020 15:57:56.057057,Helados,Buon Gelato,27800,4400,32200
17677,17678,21-10-2020 15:57:56.262072,Pollo · Desayunos,Caserito Gourmet,15000,6700,21700
17678,17679,21-10-2020 15:57:56.666036,Postres · Desayunos,Sweet Tale,65000,5800,70800
17679,17680,21-10-2020 15:57:56.819581,Postres · Desayunos,Maltihelado,34500,4500,39000
17680,17681,21-10-2020 15:57:57.123047,Pizza,Pastas Laurentina,23000,4800,27800
17681,17682,21-10-2020 15:57:57.477115,Típica,Campo Victoria,13000,3000,16000
17682,17683,21-10-2020 15:57:57.630563,Desayunos · Sánduches,Garnish,9000,5200,14200
17683,17684,21-10-2020 15:57:57.833592,Pollo · Saludable,Tremenda Sal y Dulce,12500,6500,19000
17684,17685,21-10-2020 15:57:58.086357,Mexicana,Cantina La 15,23000,4300,27300
17685,17686,21-10-2020 15:57:58.390429,Saludable · Desayunos,Básico y elemental,37900,5000,42900
17686,17687,21-10-2020 15:57:58.644701,Desayunos · Panadería,Limarys,35000,6500,41500
17687,17688,21-10-2020 15:57:58.897981,Desayunos · Panadería,El Pan de Phillippe,15600,4600,20200
17688,17689,21-10-2020 15:57:59.301646,Postres · Desayunos,BagBog Bagels,15600,6400,22000
17689,17690,21-10-2020 15:57:59.454770,Postres,Levelma,48750,6200,54950
17690,17691,21-10-2020 15:57:59.657987,Italiana,Bocatto Di Passo,11870,5000,16870
17691,17692,21-10-2020 15:57:59.961336,Saludable · Parrilla,Box,13000,3700,16700
17692,17693,21-10-2020 15:58:00.165064,Desayunos · Típica,Papadió - Colombianas,13000,5700,18700
17693,17694,21-10-2020 15:58:00.518805,Desayunos · Panadería,Limarys,12500,6500,19000
17694,17695,21-10-2020 15:58:00.922561,Pizza · Parrilla,Urban Lunch,65000,4000,69000
17695,17696,21-10-2020 15:58:01.277836,Sushi,Canoa To Go,24300,5900,30200
17696,17697,21-10-2020 15:58:01.631895,Internacional,Rio Sabores y Experiencias,11870,4100,15970
17697,17698,21-10-2020 15:58:01.835740,Desayunos · Café,Matchacha,70000,5900,75900
17698,17699,21-10-2020 15:58:02.089813,Típica · Parrilla,El Portal de la Antigua,13600,5600,19200
17699,17700,21-10-2020 15:58:02.244315,Crepes,San Crepes,13600,4900,18500
17700,17701,21-10-2020 15:58:02.448556,Saludable · Desayunos,Bawana - Sandwich,18900,3400,22300
17701,17702,21-10-2020 15:58:02.602692,Desayunos,Señor Desayuno,53900,6800,60700
17702,17703,21-10-2020 15:58:02.757648,Pollo · Desayunos,Caserito Gourmet,31800,6700,38500
17703,17704,21-10-2020 15:58:02.961766,Desayunos · Jugos y Batidos,Frutiwow,13600,4100,17700
17704,17705,21-10-2020 15:58:03.115461,Desayunos · Jugos y Batidos,Kuriwaji,24300,6300,30600
17705,17706,21-10-2020 15:58:03.369371,Desayunos · Panadería,Pasteleite,53400,5900,59300
17706,17707,21-10-2020 15:58:03.723967,Desayunos · Típica,Parrilla Farandula Típico,70000,5900,75900
17707,17708,21-10-2020 15:58:04.128236,Típica · Pescados y Mariscos,La Vitualla,37900,6300,44200
17708,17709,21-10-2020 15:58:04.381895,Pollo · Desayunos,Caserito Gourmet,17800,6700,24500
17709,17710,21-10-2020 15:58:04.585311,Desayunos · Internacional,Camilia,13000,3900,16900
17710,17711,21-10-2020 15:58:04.839260,Desayunos · Árabe,Boniato Sabores Vivos,24200,5300,29500
17711,17712,21-10-2020 15:58:05.092705,Postres,Levelma,23000,6200,29200
17712,17713,21-10-2020 15:58:05.346203,Saludable,Amor Propio saludable,35000,4000,39000
17713,17714,21-10-2020 15:58:05.499696,Asiática,TeT,27800,5900,33700
17714,17715,21-10-2020 15:58:05.703366,Saludable · Desayunos,Agua Dulce,8900,3700,12600
17715,17716,21-10-2020 15:58:06.057023,Típica,El Cucharón - Tipica,35000,4400,39400
17716,17717,21-10-2020 15:58:06.210580,Desayunos · Panadería,El Pan de Phillippe,23000,4600,27600
17717,17718,21-10-2020 15:58:06.565332,Sánduches · China,Peru Mix,34500,5900,40400
17718,17719,21-10-2020 15:58:06.918935,Desayunos · Típica,Desayunadero de la 42,29500,5900,35400
17719,17720,21-10-2020 15:58:07.123312,Desayunos · Comida Rápida,Chocolatto,23000,3400,26400
17720,17721,21-10-2020 15:58:07.377629,Desayunos · Típica,La Parrilla Dorada Polo,70000,6600,76600
17721,17722,21-10-2020 15:58:07.782058,Postres · Desayunos,Maria Luisa - Postres,15600,4300,19900
17722,17723,21-10-2020 15:58:07.986359,Pollo · Típica,Auyama,23000,3900,26900
17723,17724,21-10-2020 15:58:08.391361,Típica · Parrilla,Mi Ranchito Parrilla,23000,4400,27400
17724,17725,21-10-2020 15:58:08.645872,Crepes,San Crepes,8900,4900,13800
17725,17726,21-10-2020 15:58:09.049697,Desayunos · Típica,Parrilla Farandula Típico,7500,5900,13400
17726,17727,21-10-2020 15:58:09.403829,Saludable,MIMA,65000,3700,68700
17727,17728,21-10-2020 15:58:09.758248,Postres · Café,Celestino Café,53400,5900,59300
17728,17729,21-10-2020 15:58:10.111982,Saludable · Parrilla,Box,24300,3700,28000
17729,17730,21-10-2020 15:58:10.315361,Postres · Café,Celestino Café,24200,5900,30100
17730,17731,21-10-2020 15:58:10.668982,Desayunos · Típica,Alce,11870,4900,16770
17731,17732,21-10-2020 15:58:10.872706,Típica · Parrilla,La Parilla de David,8900,3100,12000
17732,17733,21-10-2020 15:58:11.126320,Pollo,Heart & Cooking,7500,5000,12500
17733,17734,21-10-2020 15:58:11.279999,Saludable,Puro Verde,35000,5700,40700
17734,17735,21-10-2020 15:58:11.685357,Desayunos · Jugos y Batidos,Dont Be Hungry,53900,5600,59500
17735,17736,21-10-2020 15:58:11.838673,Alta Cocina · Postres,La Pinta,35000,4500,39500
17736,17737,21-10-2020 15:58:11.992273,Típica · Pescados y Mariscos,Arroces Mrg,48750,4300,53050
17737,17738,21-10-2020 15:58:12.145826,Desayunos · Típica,Alce,23000,4900,27900
17738,17739,21-10-2020 15:58:12.449924,Saludable · Desayunos,Bon Eat - Saludable,13000,4800,17800
17739,17740,21-10-2020 15:58:12.703922,Pizza · Parrilla,Urban Lunch,53400,4000,57400
17740,17741,21-10-2020 15:58:12.957338,Postres · Desayunos,Sweet Tale,35000,5800,40800
17741,17742,21-10-2020 15:58:13.160962,Parrilla,Antojo a Domicilio,15600,5000,20600
17742,17743,21-10-2020 15:58:13.364405,Desayunos,El Fogón Castellano,70000,3200,73200
17743,17744,21-10-2020 15:58:13.768639,Pollo,Chicken House,39700,4200,43900
17744,17745,21-10-2020 15:58:14.122677,Típica · Parrilla,El Santandereano,23000,5200,28200
17745,17746,21-10-2020 15:58:14.376782,Saludable,Amor Propio saludable,34500,4000,38500
17746,17747,21-10-2020 15:58:14.631282,Saludable,The Good Rice Bowls,24300,3500,27800
17747,17748,21-10-2020 15:58:14.835071,Desayunos · Internacional,Camilia,24300,3900,28200
17748,17749,21-10-2020 15:58:15.038496,Saludable · Desayunos,Básico y elemental,8900,5000,13900
17749,17750,21-10-2020 15:58:15.442476,Peruana,Uma Cantina Peruana,45800,3200,49000
17750,17751,21-10-2020 15:58:15.696231,Sushi,Umi,11870,5600,17470
17751,17752,21-10-2020 15:58:15.850048,Desayunos · Panadería,Limarys,10700,6500,17200
17752,17753,21-10-2020 15:58:16.053845,Desayunos · Típica,Casa Vieja,10700,6000,16700
17753,17754,21-10-2020 15:58:16.408490,Típica,Sabrosito,23000,4000,27000
17754,17755,21-10-2020 15:58:16.713464,Típica,Carbón & Mondongos,27800,6400,34200
17755,17756,21-10-2020 15:58:17.068186,Desayunos · Típica,90 Calentados,13000,3700,16700
17756,17757,21-10-2020 15:58:17.422130,Típica,Juan Chorizo,10700,3900,14600
17757,17758,21-10-2020 15:58:17.626166,Desayunos · Típica,Alce,70000,4900,74900
17758,17759,21-10-2020 15:58:17.930120,Desayunos · Café,Moramia,24300,4700,29000
17759,17760,21-10-2020 15:58:18.334233,Helados,Orso To Go,24300,6800,31100
17760,17761,21-10-2020 15:58:18.487478,Postres · Desayunos,Buñuelos nacho,24300,6600,30900
17761,17762,21-10-2020 15:58:18.691086,Típica · Parrilla,La Parilla de David,23000,3100,26100
17762,17763,21-10-2020 15:58:19.044491,Postres,La Galeta,15600,3000,18600
17763,17764,21-10-2020 15:58:19.248204,Mexicana,Cantina La 15,23000,4300,27300
17764,17765,21-10-2020 15:58:19.652281,Saludable,Puro Verde,17800,5700,23500
17765,17766,21-10-2020 15:58:20.056020,Parrilla,Carnes la Zarza,7500,4900,12400
17766,17767,21-10-2020 15:58:20.209988,Típica,Lo Nuestro,13000,3100,16100
17767,17768,21-10-2020 15:58:20.363562,Desayunos · Típica,Rojo Gourmet,15600,4700,20300
17768,17769,21-10-2020 15:58:20.667181,Desayunos · Panadería,Choclofee,65000,4700,69700
17769,17770,21-10-2020 15:58:21.020822,Saludable,Puro Verde,65000,5700,70700
17770,17771,21-10-2020 15:58:21.224549,Saludable · Parrilla,The Angels Grill and Drinks,24200,6200,30400
17771,17772,21-10-2020 15:58:21.378006,Postres · Panadería,RIGHT AWAY FOODS,53900,6600,60500
17772,17773,21-10-2020 15:58:21.581039,Asiática,TeT,11870,5900,17770
17773,17774,21-10-2020 15:58:21.735764,Italiana,Bocatto Di Passo,24300,5000,29300
17774,17775,21-10-2020 15:58:22.139524,Peruana,Masivo,53900,5800,59700
17775,17776,21-10-2020 15:58:22.343463,Desayunos,Sr Buñuelo,35000,6400,41400
17776,17777,21-10-2020 15:58:22.647559,Desayunos · Pescados y Mariscos,Gypsy Bistro,12500,4500,17000
17777,17778,21-10-2020 15:58:23.001394,Poke,Poke Go,11870,4600,16470
17778,17779,21-10-2020 15:58:23.305333,Hamburguesas · Saludable,Restaurant Inn,17800,6100,23900
17779,17780,21-10-2020 15:58:23.709279,Desayunos · Panadería,Artesanos,18900,4300,23200
17780,17781,21-10-2020 15:58:24.012813,Italiana,F*cking Good Pizza,53400,4200,57600
17781,17782,21-10-2020 15:58:24.367108,Postres · Desayunos,BagBog Bagels,17800,6400,24200
17782,17783,21-10-2020 15:58:24.670700,Desayunos · Café,El Gualilo,7500,6200,13700
17783,17784,21-10-2020 15:58:24.974121,Mexicana,Cantina La 15,31800,4300,36100
17784,17785,21-10-2020 15:58:25.278522,Desayunos · Panadería,Le Pain Quotidien,18900,3900,22800
17785,17786,21-10-2020 15:58:25.433224,Sushi,Canoa To Go,24200,5900,30100
17786,17787,21-10-2020 15:58:25.737539,Mexicana,Cantina La 15,17800,4300,22100
17787,17788,21-10-2020 15:58:25.941370,Desayunos,Señor Desayuno,53900,6800,60700
17788,17789,21-10-2020 15:58:26.345223,Típica,Carbón & Mondongos,39700,6400,46100
17789,17790,21-10-2020 15:58:26.750767,Parrilla,Arroces Maria Paula,10700,6800,17500
17790,17791,21-10-2020 15:58:27.156079,Pizza · Parrilla,Urban Lunch,10700,4000,14700
17791,17792,21-10-2020 15:58:27.560396,Saludable · Desayunos,Re.al Alimentos Reales,12500,4000,16500
17792,17793,21-10-2020 15:58:27.713884,Pollo,Heart & Cooking,31800,5000,36800
17793,17794,21-10-2020 15:58:28.017608,Italiana,Bocatto Di Passo,10700,5000,15700
17794,17795,21-10-2020 15:58:28.271764,Desayunos · Café,vereda central calle 99,27800,5700,33500
17795,17796,21-10-2020 15:58:28.477287,Saludable · Parrilla,The Angels Grill and Drinks,34500,6200,40700
17796,17797,21-10-2020 15:58:28.881463,Desayunos · Sánduches,Frutos del Bosque,27800,3500,31300
17797,17798,21-10-2020 15:58:29.235466,Peruana,Masivo,45800,5800,51600
17798,17799,21-10-2020 15:58:29.388918,Desayunos · Panadería,Pasteleite,48750,5900,54650
17799,17800,21-10-2020 15:58:29.593499,Desayunos · Panadería,Choclofee,45800,4700,50500
17800,17801,21-10-2020 15:58:29.747181,Mexicana,Hidalgo Taquería,24300,4900,29200
17801,17802,21-10-2020 15:58:29.900812,Desayunos · Panadería,Juliana Restaurante,7500,6100,13600
17802,17803,21-10-2020 15:58:30.256335,Postres · Desayunos,Protein Bakes,70000,5900,75900
17803,17804,21-10-2020 15:58:30.610296,Pescados y Mariscos,Fish Place - Del Mar,34500,5400,39900
17804,17805,21-10-2020 15:58:30.963828,Desayunos · Parrilla,Mi Patria,15000,4600,19600
17805,17806,21-10-2020 15:58:31.267894,Pollo,Chicken House,27800,4200,32000
17806,17807,21-10-2020 15:58:31.621915,Desayunos · Típica,Rojo Gourmet,39700,4700,44400
17807,17808,21-10-2020 15:58:31.926355,Pizza · Italiana,Pisapore - Pizza,18900,6600,25500
17808,17809,21-10-2020 15:58:32.180258,Postres · Desayunos,Restaurante Cornelia,27800,5500,33300
17809,17810,21-10-2020 15:58:32.584604,Saludable · Parrilla,The Angels Grill and Drinks,7500,6200,13700
17810,17811,21-10-2020 15:58:32.888024,Postres · Desayunos,Gelateria Da Favola,15600,6500,22100
17811,17812,21-10-2020 15:58:33.091458,Desayunos · Café,El Gualilo,15600,6200,21800
17812,17813,21-10-2020 15:58:33.495770,Sushi · Asiática,Tu Sushi,12500,6400,18900
17813,17814,21-10-2020 15:58:33.849501,Sánduches,Submarin,11870,3800,15670
17814,17815,21-10-2020 15:58:34.002754,Alta Cocina · Italiana,Trattoria de la Plaza,24300,6000,30300
17815,17816,21-10-2020 15:58:34.156728,Típica · Parrilla,Typykos,13000,6000,19000
17816,17817,21-10-2020 15:58:34.410758,Desayunos · Típica,90 Calentados,17800,3700,21500
17817,17818,21-10-2020 15:58:34.714875,Pollo · China,China Tao,35000,3500,38500
17818,17819,21-10-2020 15:58:34.918292,Peruana,Masivo,24200,5800,30000
17819,17820,21-10-2020 15:58:35.321839,Típica,Lo Nuestro,15600,3100,18700
17820,17821,21-10-2020 15:58:35.525166,Desayunos · Típica,Calentao Express,53900,6000,59900
17821,17822,21-10-2020 15:58:35.728649,Pollo · Sánduches,Pollos Century,15600,3000,18600
17822,17823,21-10-2020 15:58:35.931815,Internacional,Rio Sabores y Experiencias,34500,4100,38600
17823,17824,21-10-2020 15:58:36.286188,Saludable · Desayunos,Distrito Gourmet,31800,3700,35500
17824,17825,21-10-2020 15:58:36.540200,Pescados y Mariscos,Fish Place - Del Mar,45800,5400,51200
17825,17826,21-10-2020 15:58:36.793584,Saludable,A2manos,29500,4200,33700
17826,17827,21-10-2020 15:58:37.148416,Parrilla,Beraca Parrilla Bbq,29500,5600,35100
17827,17828,21-10-2020 15:58:37.452165,Desayunos · Típica,Rojo Gourmet,53400,4700,58100
17828,17829,21-10-2020 15:58:37.706082,Desayunos · Café,Moramia,39700,4700,44400
17829,17830,21-10-2020 15:58:38.110319,Saludable,Hanai - Bowls Saludables,48750,5900,54650
17830,17831,21-10-2020 15:58:38.514447,Desayunos · Panadería,Limarys,15600,6500,22100
17831,17832,21-10-2020 15:58:38.767991,Postres · Desayunos,Maria Luisa - Postres,31800,4300,36100
17832,17833,21-10-2020 15:58:39.021723,Desayunos · Parrilla,Mi Patria,10700,4600,15300
17833,17834,21-10-2020 15:58:39.325787,Desayunos · Comida Rápida,La Veneca,65000,6300,71300
17834,17835,21-10-2020 15:58:39.580075,Postres · Desayunos,Café Quindio,11870,5700,17570
17835,17836,21-10-2020 15:58:39.733966,Desayunos · Sánduches,Frutos del Bosque,13000,3500,16500
17836,17837,21-10-2020 15:58:39.987396,Desayunos · Empanadas,Mis Delicias,27800,3200,31000
17837,17838,21-10-2020 15:58:40.140999,Pizza · Italiana,Pisapore - Pizza,24300,6600,30900
17838,17839,21-10-2020 15:58:40.394777,Desayunos,Señor Desayuno,53900,6800,60700
17839,17840,21-10-2020 15:58:40.598932,Desayunos,Bagel Shop,34500,3200,37700
17840,17841,21-10-2020 15:58:41.002491,Desayunos · Internacional,Camilia,18900,3900,22800
17841,17842,21-10-2020 15:58:41.206578,Típica,Cabrito Santandereano,37900,6600,44500
17842,17843,21-10-2020 15:58:41.510689,Parrilla,Rústico Picadería,23000,3800,26800
17843,17844,21-10-2020 15:58:41.864424,Pescados y Mariscos,Pescadero Héroes del Mar,17800,6600,24400
17844,17845,21-10-2020 15:58:42.118704,Desayunos · Café,Aromacafé el Placer de Compartir,17800,5000,22800
17845,17846,21-10-2020 15:58:42.523970,Sushi,Umi,65000,5600,70600
17846,17847,21-10-2020 15:58:42.928017,Postres · Desayunos,Aury Postres - Comidas & Picadas,24300,4700,29000
17847,17848,21-10-2020 15:58:43.182092,Helados,Orso To Go,18900,6800,25700
17848,17849,21-10-2020 15:58:43.336191,Postres · Desayunos,Maltihelado,15000,4500,19500
17849,17850,21-10-2020 15:58:43.740267,Postres · Desayunos,La Folie - Postres,10700,3300,14000
17850,17851,21-10-2020 15:58:44.044284,Parrilla · Internacional,Taperia de la Plaza,39700,5700,45400
17851,17852,21-10-2020 15:58:44.248261,Típica,Salsig,35000,5600,40600
17852,17853,21-10-2020 15:58:44.452646,Italiana,F*cking Good Pizza,65000,4200,69200
17853,17854,21-10-2020 15:58:44.606658,Postres · Desayunos,Maltihelado,39700,4500,44200
17854,17855,21-10-2020 15:58:44.860604,Pollo · Típica,Auyama,53400,3900,57300
17855,17856,21-10-2020 15:58:45.064932,Desayunos · Panadería,Choclofee,13600,4700,18300
17856,17857,21-10-2020 15:58:45.218857,Postres · Desayunos,Cosmo Cookies,24300,5900,30200
17857,17858,21-10-2020 15:58:45.373015,Helados,Orso To Go,70000,6800,76800
17858,17859,21-10-2020 15:58:45.526856,Desayunos · Panadería,Premium Break Bakery,39700,3700,43400
17859,17860,21-10-2020 15:58:45.780752,Típica · Parrilla,El Santandereano,18900,5200,24100
17860,17861,21-10-2020 15:58:46.034576,Parrilla,El Tambor,34500,6800,41300
17861,17862,21-10-2020 15:58:46.188269,Postres,La Galeta,45800,3000,48800
17862,17863,21-10-2020 15:58:46.592691,Pizza · Italiana,Piatto - Pizza,45800,6600,52400
17863,17864,21-10-2020 15:58:46.846735,Pollo · Desayunos,Caserito Gourmet,13000,6700,19700
17864,17865,21-10-2020 15:58:47.200671,Desayunos · Parrilla,Mi Patria,37900,4600,42500
17865,17866,21-10-2020 15:58:47.605451,Desayunos · Pescados y Mariscos,Luzí­a - Mediterranea,53900,5700,59600
17866,17867,21-10-2020 15:58:47.859040,Desayunos · Jugos y Batidos,Dont Be Hungry,37900,5600,43500
17867,17868,21-10-2020 15:58:48.062718,Parrilla,Parrilla Pimentón,48750,3400,52150
17868,17869,21-10-2020 15:58:48.266471,Típica · Parrilla,El Portal de la Antigua,18900,5600,24500
17869,17870,21-10-2020 15:58:48.570213,Hamburguesas · Saludable,Restaurant Inn,37900,6100,44000
17870,17871,21-10-2020 15:58:48.873855,Asiática,TeT,7500,5900,13400
17871,17872,21-10-2020 15:58:49.277926,Típica · Pescados y Mariscos,La Vitualla,11870,6300,18170
17872,17873,21-10-2020 15:58:49.531878,Postres · Desayunos,Protein Bakes,7500,5900,13400
17873,17874,21-10-2020 15:58:49.786276,Parrilla,Parrilla Pimentón,15600,3400,19000
17874,17875,21-10-2020 15:58:49.940491,Desayunos · Árabe,Boniato Sabores Vivos,65000,5300,70300
17875,17876,21-10-2020 15:58:50.245193,Jugos y Batidos,Pomponio,9000,3600,12600
17876,17877,21-10-2020 15:58:50.498758,Postres · Desayunos,La Folie - Postres,15000,3300,18300
17877,17878,21-10-2020 15:58:50.702554,Típica,Cazuelitas 93,70000,3900,73900
17878,17879,21-10-2020 15:58:50.956488,Hamburguesas · Alitas,Beer,13600,6600,20200
17879,17880,21-10-2020 15:58:51.311108,Café · Helados,Sofia heladería y café,53400,5800,59200
17880,17881,21-10-2020 15:58:51.615485,Saludable,MIMA,8900,3700,12600
17881,17882,21-10-2020 15:58:51.819587,Saludable,Hanai - Bowls Saludables,35000,5900,40900
17882,17883,21-10-2020 15:58:52.224353,Desayunos,Cafetería el Kippe,34500,3200,37700
17883,17884,21-10-2020 15:58:52.378533,Postres · Desayunos,Vivalight Market.,23000,6500,29500
17884,17885,21-10-2020 15:58:52.684229,Desayunos,Bagel Shop,70000,3200,73200
17885,17886,21-10-2020 15:58:52.988689,Postres · Desayunos,Maltihelado,23000,4500,27500
17886,17887,21-10-2020 15:58:53.393219,Saludable · Desayunos,La Estampilla,70000,6000,76000
17887,17888,21-10-2020 15:58:53.547040,Parrilla · Internacional,Taperia de la Plaza,37900,5700,43600
17888,17889,21-10-2020 15:58:53.951054,Italiana,Bocatto Di Passo,35000,5000,40000
17889,17890,21-10-2020 15:58:54.305313,Peruana,Uma Cantina Peruana,45800,3200,49000
17890,17891,21-10-2020 15:58:54.709177,Típica,Bendita S,15600,4600,20200
17891,17892,21-10-2020 15:58:55.113283,Postres,Levelma,15000,6200,21200
17892,17893,21-10-2020 15:58:55.267026,Típica · Parrilla,La Parilla de David,9000,3100,12100
17893,17894,21-10-2020 15:58:55.521103,Típica · Parrilla,El Santandereano,53400,5200,58600
17894,17895,21-10-2020 15:58:55.725230,Desayunos · Panadería,Premium Break Bakery,31800,3700,35500
17895,17896,21-10-2020 15:58:55.979685,Postres · Desayunos,La Folie - Postres,8900,3300,12200
17896,17897,21-10-2020 15:58:56.333922,Desayunos · Sánduches,Danilo Colombia,24300,3300,27600
17897,17898,21-10-2020 15:58:56.688334,Hamburguesas · Saludable,Restaurant Inn,37900,6100,44000
17898,17899,21-10-2020 15:58:57.042544,Café · Helados,Sofia heladería y café,12500,5800,18300
17899,17900,21-10-2020 15:58:57.346539,Sushi · Asiática,Arigato,15600,5300,20900
17900,17901,21-10-2020 15:58:57.550328,Saludable · Típica,Saludable Mrg,23000,5800,28800
17901,17902,21-10-2020 15:58:57.806013,Desayunos · Café,Moramia,15000,4700,19700
17902,17903,21-10-2020 15:58:58.160633,Postres · Desayunos,Amelie Helados,45800,6400,52200
17903,17904,21-10-2020 15:58:58.415411,Típica · Parrilla,Mi Ranchito Parrilla,29500,4400,33900
17904,17905,21-10-2020 15:58:58.619834,Saludable · Desayunos,Malú,65000,3700,68700
17905,17906,21-10-2020 15:58:58.773557,Pollo · Saludable,Gratina,29500,4200,33700
17906,17907,21-10-2020 15:58:59.077447,Desayunos · Panadería,Juliana Restaurante,13000,6100,19100
17907,17908,21-10-2020 15:58:59.432303,Pollo · Saludable,Yerbabuena,13600,3900,17500
17908,17909,21-10-2020 15:58:59.636676,Saludable · Jugos y Batidos,Berdes Drinks & Salads,17800,3500,21300
17909,17910,21-10-2020 15:58:59.890647,Pizza,Pizza Andante,10700,6300,17000
17910,17911,21-10-2020 15:59:00.245411,Desayunos · Típica,La Frijolada,15600,4500,20100
17911,17912,21-10-2020 15:59:00.449566,Desayunos · Café,Aromacafé el Placer de Compartir,29500,5000,34500
17912,17913,21-10-2020 15:59:00.703828,Desayunos,Sunny Breakfast Brunch,48750,4300,53050
17913,17914,21-10-2020 15:59:01.108049,Parrilla,Beraca Parrilla Bbq,37900,5600,43500
17914,17915,21-10-2020 15:59:01.362426,Postres · Saludable,Ana Rebana,53900,6300,60200
17915,17916,21-10-2020 15:59:01.766442,Saludable,A2manos,35000,4200,39200
17916,17917,21-10-2020 15:59:01.920186,Parrilla,Coquitas,8900,5600,14500
17917,17918,21-10-2020 15:59:02.074111,Hamburguesas · Pescados y Mariscos,El Velero,45800,6500,52300
17918,17919,21-10-2020 15:59:02.377848,Crepes,La Chabatta,45800,5900,51700
17919,17920,21-10-2020 15:59:02.681892,Sushi,Sushi Reel,11870,4700,16570
17920,17921,21-10-2020 15:59:02.836310,Mexicana,Hidalgo Taquería,29500,4900,34400
17921,17922,21-10-2020 15:59:03.240401,Desayunos,Sunny Breakfast Brunch,11870,4300,16170
17922,17923,21-10-2020 15:59:03.594670,Desayunos · Café,Frambas,12500,3400,15900
17923,17924,21-10-2020 15:59:03.898697,Saludable · Desayunos,Libre de Culpa,13600,4000,17600
17924,17925,21-10-2020 15:59:04.152577,Desayunos · Típica,Alce,53900,4900,58800
17925,17926,21-10-2020 15:59:04.356471,Saludable · Desayunos,La Cesta,18900,4700,23600
17926,17927,21-10-2020 15:59:04.761345,Desayunos · Panadería,Decofruta,15000,4700,19700
17927,17928,21-10-2020 15:59:05.065501,Panadería,Boul,23000,3100,26100
17928,17929,21-10-2020 15:59:05.470279,Postres,Toledo Pastelería,37900,6800,44700
17929,17930,21-10-2020 15:59:05.774485,Desayunos · Típica,Parrilla Farandula Típico,29500,5900,35400
17930,17931,21-10-2020 15:59:05.928025,Saludable · Desayunos,Bawana - Sandwich,23000,3400,26400
17931,17932,21-10-2020 15:59:06.333093,Desayunos · Típica,Criollomania,24200,5200,29400
17932,17933,21-10-2020 15:59:06.637196,Hamburguesas,Monchis - Hamburguesa,53900,4300,58200
17933,17934,21-10-2020 15:59:06.891050,Típica,Cabrito Santandereano,8900,6600,15500
17934,17935,21-10-2020 15:59:07.195410,Saludable,Amor Propio saludable,70000,4000,74000
17935,17936,21-10-2020 15:59:07.449751,Parrilla,Arroces Maria Paula,23000,6800,29800
17936,17937,21-10-2020 15:59:07.804502,Café · Helados,Sofia heladería y café,13600,5800,19400
17937,17938,21-10-2020 15:59:08.009773,Típica,Cazuelitas 93,24300,3900,28200
17938,17939,21-10-2020 15:59:08.263884,Desayunos · Típica,D'Porco - Lechona,8900,6300,15200
17939,17940,21-10-2020 15:59:08.468626,Desayunos · Típica,Cochon,13600,3300,16900
17940,17941,21-10-2020 15:59:08.672707,Típica,Carbón & Mondongos,29500,6400,35900
17941,17942,21-10-2020 15:59:08.876946,Postres · Desayunos,Restaurante Cornelia,11870,5500,17370
17942,17943,21-10-2020 15:59:09.081079,Desayunos · Jugos y Batidos,Frutiwow,7500,4100,11600
17943,17944,21-10-2020 15:59:09.385352,Desayunos · Empanadas,Mis Delicias,45800,3200,49000
17944,17945,21-10-2020 15:59:09.689731,Postres · Desayunos,Restaurante Cornelia,70000,5500,75500
17945,17946,21-10-2020 15:59:10.093874,Peruana,Masivo,37900,5800,43700
17946,17947,21-10-2020 15:59:10.398471,Parrilla,Carnes la Zarza,23000,4900,27900
17947,17948,21-10-2020 15:59:10.803045,Desayunos · Café,Frambas,53900,3400,57300
17948,17949,21-10-2020 15:59:11.157267,Saludable · Desayunos,Básico y Elemental,9000,5900,14900
17949,17950,21-10-2020 15:59:11.311612,Saludable · Desayunos,Distrito Gourmet,15600,3700,19300
17950,17951,21-10-2020 15:59:11.615954,Hamburguesas,Burger Society,10700,4100,14800
17951,17952,21-10-2020 15:59:11.820307,Típica,Sopitas y Más,53900,4200,58100
17952,17953,21-10-2020 15:59:12.024715,Pizza,pizza andante,23000,4200,27200
17953,17954,21-10-2020 15:59:12.278855,Peruana,Masivo,27800,5800,33600
17954,17955,21-10-2020 15:59:12.434124,Saludable · Desayunos,Bon Eat - Saludable,15000,4800,19800
17955,17956,21-10-2020 15:59:12.838476,Desayunos · Panadería,Pasteleite,39700,5900,45600
17956,17957,21-10-2020 15:59:13.093840,Pollo,Señor Fantástico,31800,4700,36500
17957,17958,21-10-2020 15:59:13.248408,Parrilla,Carnes la Zarza,17800,4900,22700
17958,17959,21-10-2020 15:59:13.553275,Sushi,Umi,18900,5600,24500
17959,17960,21-10-2020 15:59:13.807562,Desayunos · Sánduches,Garnish,70000,5200,75200
17960,17961,21-10-2020 15:59:14.061277,Saludable,The Good Rice Bowls,65000,3500,68500
17961,17962,21-10-2020 15:59:14.416273,Pescados y Mariscos,La Gran Cazuela,27800,3200,31000
17962,17963,21-10-2020 15:59:14.570875,Desayunos · Panadería,Ficchi Panadería,17800,3100,20900
17963,17964,21-10-2020 15:59:14.725332,Postres · Desayunos,La Folie - Postres,15600,3300,18900
17964,17965,21-10-2020 15:59:15.080000,Pizza,pizza andante,15600,4200,19800
17965,17966,21-10-2020 15:59:15.484890,Café · Helados,Sofia heladería y café,17800,5800,23600
17966,17967,21-10-2020 15:59:15.639178,Pollo,Chicken House,35000,4200,39200
17967,17968,21-10-2020 15:59:15.894011,Saludable · Típica,Saludable Mrg,13600,5800,19400
17968,17969,21-10-2020 15:59:16.249065,Desayunos · Pescados y Mariscos,Gypsy Bistro,34500,4500,39000
17969,17970,21-10-2020 15:59:16.604110,Desayunos,Desayunos en Bogotá,39700,3400,43100
17970,17971,21-10-2020 15:59:16.758645,Desayunos · Jugos y Batidos,Kuriwaji,10700,6300,17000
17971,17972,21-10-2020 15:59:17.013612,Alta Cocina · Postres,La Pinta,15000,4500,19500
17972,17973,21-10-2020 15:59:17.318087,Pizza,Pizza Andante,53400,6300,59700
17973,17974,21-10-2020 15:59:17.573042,Desayunos · Café,vereda central calle 99,24300,5700,30000
17974,17975,21-10-2020 15:59:17.777831,Típica,Cabrito Santandereano,9000,6600,15600
17975,17976,21-10-2020 15:59:17.982477,Desayunos · Típica,Parrilla Farandula Típico,24200,5900,30100
17976,17977,21-10-2020 15:59:18.138183,Postres,Beiked,17800,4000,21800
17977,17978,21-10-2020 15:59:18.444048,Saludable,Puro Verde,13600,5700,19300
17978,17979,21-10-2020 15:59:18.749342,Típica · Parrilla,Typykos,31800,6000,37800
17979,17980,21-10-2020 15:59:19.154471,Postres,La Galeta,15000,3000,18000
17980,17981,21-10-2020 15:59:19.509675,Saludable,Puro Verde,7500,5700,13200
17981,17982,21-10-2020 15:59:19.714370,Desayunos · Comida Rápida,La Veneca,53900,6300,60200
17982,17983,21-10-2020 15:59:19.869006,Típica,Bandejas Mrg,70000,3800,73800
17983,17984,21-10-2020 15:59:20.023956,Saludable · Desayunos,Bon Eat - Saludable,29500,4800,34300
17984,17985,21-10-2020 15:59:20.228806,Italiana,Bocatto Di Passo,53900,5000,58900
17985,17986,21-10-2020 15:59:20.483703,Hamburguesas,Gofi Burger,7500,5100,12600
17986,17987,21-10-2020 15:59:20.689080,Saludable,The Good Rice Bowls,10700,3500,14200
17987,17988,21-10-2020 15:59:20.894203,Saludable · Desayunos,Libre de Culpa,9000,4000,13000
17988,17989,21-10-2020 15:59:21.249852,Desayunos · Empanadas,Mis Delicias,24300,3200,27500
17989,17990,21-10-2020 15:59:21.656300,Pollo,Señor Fantástico,34500,4700,39200
17990,17991,21-10-2020 15:59:21.963662,Crepes,San Crepes,65000,4900,69900
17991,17992,21-10-2020 15:59:22.270246,Típica,El Mondongo y Mucho Mas,48750,5600,54350
17992,17993,21-10-2020 15:59:22.426349,Desayunos · Panadería,Choclofee,24200,4700,28900
17993,17994,21-10-2020 15:59:22.831967,Saludable · Desayunos,Agua Dulce,45800,3700,49500
17994,17995,21-10-2020 15:59:23.086797,Postres · Panadería,RIGHT AWAY FOODS,18900,6600,25500
17995,17996,21-10-2020 15:59:23.243084,Parrilla,Arroces Maria Paula,45800,6800,52600
17996,17997,21-10-2020 15:59:23.500918,Saludable · Desayunos,Bawana - Sandwich,48750,3400,52150
17997,17998,21-10-2020 15:59:23.706590,Internacional,La Esquina con Sabor Parrilla,15600,3000,18600
17998,17999,21-10-2020 15:59:24.011321,Desayunos · Sánduches,Frutos del Bosque,11870,3500,15370
17999,18000,21-10-2020 15:59:24.166914,Parrilla · Café,Figaro Café/ Restaurante Argentino,11870,5800,17670
18000,18001,21-10-2020 15:59:24.422716,Postres · Desayunos,Cosmo Cookies,17800,5900,23700
18001,18002,21-10-2020 15:59:24.828209,Desayunos · Típica,Parrilla Farandula Típico,12500,5900,18400
18002,18003,21-10-2020 15:59:24.983327,Pizza,Pastas Laurentina,13000,4800,17800
18003,18004,21-10-2020 15:59:25.138774,Desayunos · Típica,90 Calentados,24300,3700,28000
18004,18005,21-10-2020 15:59:25.494053,Pescados y Mariscos,Pescadero Héroes del Mar,35000,6600,41600
18005,18006,21-10-2020 15:59:25.749767,Pollo · Típica,Auyama,7500,3900,11400
18006,18007,21-10-2020 15:59:26.054624,Parrilla,Carnes la Zarza,65000,4900,69900
18007,18008,21-10-2020 15:59:26.460161,Desayunos · Café,Norma's Ice Cream Café,15600,6300,21900
18008,18009,21-10-2020 15:59:26.814755,Desayunos · Típica,Casa Vieja,39700,6000,45700
18009,18010,21-10-2020 15:59:27.170114,Postres · Desayunos,Restaurante Cornelia,23000,5500,28500
18010,18011,21-10-2020 15:59:27.574889,Desayunos · Jugos y Batidos,Dont Be Hungry,24300,5600,29900
18011,18012,21-10-2020 15:59:27.731031,Saludable · Desayunos,Libre de Culpa,34500,4000,38500
18012,18013,21-10-2020 15:59:28.137515,Sushi · Asiática,Arigato,35000,5300,40300
18013,18014,21-10-2020 15:59:28.444268,Pizza · Italiana,Pisapore - Pizza,48750,6600,55350
18014,18015,21-10-2020 15:59:28.849651,Típica,Bendita S,18900,4600,23500
18015,18016,21-10-2020 15:59:29.054129,Típica,Campo Victoria,13600,3000,16600
18016,18017,21-10-2020 15:59:29.308700,Postres · Desayunos,Gelateria Da Favola,15000,6500,21500
18017,18018,21-10-2020 15:59:29.512950,Postres,Beiked,31800,4000,35800
18018,18019,21-10-2020 15:59:29.867449,Postres · Panadería,RIGHT AWAY FOODS,11870,6600,18470
18019,18020,21-10-2020 15:59:30.072164,Desayunos · Café,Frambas,15600,3400,19000
18020,18021,21-10-2020 15:59:30.477000,Parrilla,Arepaisa de Medellín,27800,5600,33400
18021,18022,21-10-2020 15:59:30.632186,Pollo · Desayunos,Caserito Gourmet,12500,6700,19200
18022,18023,21-10-2020 15:59:31.038162,Desayunos · Pescados y Mariscos,Luzí­a - Mediterranea,12500,5700,18200
18023,18024,21-10-2020 15:59:31.342617,Desayunos · Panadería,Premium Break Bakery,24300,3700,28000
18024,18025,21-10-2020 15:59:31.697327,Parrilla,Arepaisa de Medellín,13000,5600,18600
18025,18026,21-10-2020 15:59:32.051864,Desayunos · Pescados y Mariscos,Gypsy Bistro,31800,4500,36300
18026,18027,21-10-2020 15:59:32.456725,Postres · Desayunos,La Folie - Postres,24200,3300,27500
18027,18028,21-10-2020 15:59:32.761861,Desayunos · Café,Norma's Ice Cream Café,31800,6300,38100
18028,18029,21-10-2020 15:59:33.168265,Desayunos · Empanadas,Mis Delicias,17800,3200,21000
18029,18030,21-10-2020 15:59:33.524774,Pollo · Desayunos,Abasto,39700,3600,43300
18030,18031,21-10-2020 15:59:33.679281,Desayunos · Típica,Casa Vieja,17800,6000,23800
18031,18032,21-10-2020 15:59:33.933707,Desayunos · Típica,Papadió - Colombianas,34500,5700,40200
18032,18033,21-10-2020 15:59:34.338564,Postres,La Galeta,12500,3000,15500
18033,18034,21-10-2020 15:59:34.493201,Desayunos · Típica,Fogón Sangileño,34500,5000,39500
18034,18035,21-10-2020 15:59:34.897566,Postres · Desayunos,Sweet Tale,27800,5800,33600
18035,18036,21-10-2020 15:59:35.252977,Desayunos · Típica,Peninsula Calentados y Parrilla,15000,3400,18400
18036,18037,21-10-2020 15:59:35.607514,Postres,La Tertulia,37900,3400,41300
18037,18038,21-10-2020 15:59:35.761517,Postres,Levelma,12500,6200,18700
18038,18039,21-10-2020 15:59:35.966230,Desayunos · Parrilla,Mi Patria,35000,4600,39600
18039,18040,21-10-2020 15:59:36.121506,Pizza · Italiana,Pisapore - Pizza,35000,6600,41600
18040,18041,21-10-2020 15:59:36.376122,Peruana,Uma Cantina Peruana,18900,3200,22100
18041,18042,21-10-2020 15:59:36.631129,Parrilla,Carnes la Zarza,24200,4900,29100
18042,18043,21-10-2020 15:59:36.935321,Desayunos · Típica,Fogón Sangileño,24200,5000,29200
18043,18044,21-10-2020 15:59:37.290308,Desayunos · Café,Moramia,24300,4700,29000
18044,18045,21-10-2020 15:59:37.594950,Típica,Carbón & Mondongos,70000,6400,76400
18045,18046,21-10-2020 15:59:37.899564,Desayunos,Señor Desayuno,27800,6800,34600
18046,18047,21-10-2020 15:59:38.104123,Desayunos · Café,vereda central calle 99,65000,5700,70700
18047,18048,21-10-2020 15:59:38.459300,Hamburguesas · Saludable,Restaurant Inn,23000,6100,29100
18048,18049,21-10-2020 15:59:38.614720,Desayunos · Panadería,Pasteleite,27800,5900,33700
18049,18050,21-10-2020 15:59:38.969625,Típica,El Cucharón - Tipica,7500,4400,11900
18050,18051,21-10-2020 15:59:39.125019,Saludable · Parrilla,Box,53400,3700,57100
18051,18052,21-10-2020 15:59:39.430818,Desayunos · Empanadas,Empanadas Doraditas.com,45800,3000,48800
18052,18053,21-10-2020 15:59:39.586470,Mexicana,La leyenda mexican kitchen,12500,3200,15700
18053,18054,21-10-2020 15:59:39.941395,Desayunos · Típica,Fogón Sangileño,29500,5000,34500
18054,18055,21-10-2020 15:59:40.296601,Típica · Parrilla,La Parilla de David,8900,3100,12000
18055,18056,21-10-2020 15:59:40.601411,Parrilla,Coquitas,12500,5600,18100
18056,18057,21-10-2020 15:59:41.006107,Sushi · Asiática,Arigato,18900,5300,24200
18057,18058,21-10-2020 15:59:41.411054,Desayunos · Típica,Rojo Gourmet,70000,4700,74700
18058,18059,21-10-2020 15:59:41.615718,Típica · Pescados y Mariscos,La Vitualla,31800,6300,38100
18059,18060,21-10-2020 15:59:41.920231,Italiana,Bocatto Di Passo,27800,5000,32800
18060,18061,21-10-2020 15:59:42.324768,Pizza,Pastas Laurentina,27800,4800,32600
18061,18062,21-10-2020 15:59:42.630468,Mexicana,Hidalgo Taquería,23000,4900,27900
18062,18063,21-10-2020 15:59:42.885084,Desayunos · Parrilla,Mi Patria,34500,4600,39100
18063,18064,21-10-2020 15:59:43.140342,Pollo · Saludable,Gratina,29500,4200,33700
18064,18065,21-10-2020 15:59:43.344875,Pollo · Pescados y Mariscos,Bang Bang Rice,8900,3400,12300
18065,18066,21-10-2020 15:59:43.549538,Pollo,Señor Fantástico,48750,4700,53450
18066,18067,21-10-2020 15:59:43.905041,Parrilla,Restaurante Bar Mi Ranchito,11870,5200,17070
18067,18068,21-10-2020 15:59:44.159602,Pollo · Desayunos,Abasto,39700,3600,43300
18068,18069,21-10-2020 15:59:44.363862,Postres · Helados,Mahé,39700,6000,45700
18069,18070,21-10-2020 15:59:44.568466,Desayunos · Panadería,Siena Café,10700,3700,14400
18070,18071,21-10-2020 15:59:44.873435,Postres · Desayunos,Sweet Tale,65000,5800,70800
18071,18072,21-10-2020 15:59:45.078211,Postres · Desayunos,Maltihelado,39700,4500,44200
18072,18073,21-10-2020 15:59:45.382986,Desayunos · Panadería,Le Pain Quotidien,13000,3900,16900
18073,18074,21-10-2020 15:59:45.788218,Típica,El Mondongo y Mucho Mas,29500,5600,35100
18074,18075,21-10-2020 15:59:46.043331,Típica · Parrilla,Parrilla Farandula Gourmet,11870,5100,16970
18075,18076,21-10-2020 15:59:46.398854,Pollo · Típica,Auyama,8900,3900,12800
18076,18077,21-10-2020 15:59:46.803756,Hamburguesas,Monchis - Hamburguesa,13000,4300,17300
18077,18078,21-10-2020 15:59:46.957792,Típica,Carbón & Mondongos,53900,6400,60300
18078,18079,21-10-2020 15:59:47.263891,Postres · Desayunos,Maltihelado,70000,4500,74500
18079,18080,21-10-2020 15:59:47.619030,Postres · Desayunos,Maria Luisa - Postres,24200,4300,28500
18080,18081,21-10-2020 15:59:47.874237,Pollo · Típica,Auyama,37900,3900,41800
18081,18082,21-10-2020 15:59:48.278702,Desayunos · Café,Norma's Ice Cream Café,18900,6300,25200
18082,18083,21-10-2020 15:59:48.484070,Peruana,Masivo,70000,5800,75800
18083,18084,21-10-2020 15:59:48.838511,Desayunos · Típica,Peninsula Calentados y Parrilla,7500,3400,10900
18084,18085,21-10-2020 15:59:49.093884,Italiana,F*cking Good Pizza,17800,4200,22000
18085,18086,21-10-2020 15:59:49.499193,Pizza · Italiana,Piatto - Pizza,65000,6600,71600
18086,18087,21-10-2020 15:59:49.903626,Típica,Carbón & Mondongos,18900,6400,25300
18087,18088,21-10-2020 15:59:50.108200,Típica,Bendita S,53900,4600,58500
18088,18089,21-10-2020 15:59:50.463298,Desayunos · Típica,D'Porco - Lechona,9000,6300,15300
18089,18090,21-10-2020 15:59:50.867775,Hamburguesas · Pescados y Mariscos,El Velero,27800,6500,34300
18090,18091,21-10-2020 15:59:51.222640,Desayunos · Panadería,Decofruta,53900,4700,58600
18091,18092,21-10-2020 15:59:51.627706,China,China Food Col,10700,3600,14300
18092,18093,21-10-2020 15:59:51.982287,Desayunos · Panadería,Santa Juana Food Bar,65000,5900,70900
18093,18094,21-10-2020 15:59:52.336857,Sushi · Desayunos,Maki Roll,24200,4300,28500
18094,18095,21-10-2020 15:59:52.641663,Típica · Parrilla,Mi Ranchito Parrilla,35000,4400,39400
18095,18096,21-10-2020 15:59:52.946125,Pollo · China,China Tao,24200,3500,27700
18096,18097,21-10-2020 15:59:53.300850,Parrilla · Café,Gaira Café,34500,4400,38900
18097,18098,21-10-2020 15:59:53.455579,Postres · Desayunos,Sweet Tale,11870,5800,17670
18098,18099,21-10-2020 15:59:53.660482,Pollo · Saludable,Gratina,53900,4200,58100
18099,18100,21-10-2020 15:59:53.815382,Saludable,A2manos,29500,4200,33700
18100,18101,21-10-2020 15:59:53.970225,Postres · Café,Loló Coffee & Snacks,11870,4600,16470
18101,18102,21-10-2020 15:59:54.376584,Típica · Parrilla,Mi Ranchito Parrilla,10700,4400,15100
18102,18103,21-10-2020 15:59:54.731515,Postres · Desayunos,Café Quindio,70000,5700,75700
18103,18104,21-10-2020 15:59:55.036174,Típica · Parrilla,Toya,11870,4200,16070
18104,18105,21-10-2020 15:59:55.190746,Desayunos · Típica,Rojo Gourmet,35000,4700,39700
18105,18106,21-10-2020 15:59:55.395474,Desayunos,Butter,15600,6700,22300
18106,18107,21-10-2020 15:59:55.800546,Pollo · Saludable,Tremenda Sal y Dulce,39700,6500,46200
18107,18108,21-10-2020 15:59:56.155554,Típica · Pescados y Mariscos,Arroces Mrg,23000,4300,27300
18108,18109,21-10-2020 15:59:56.560369,Desayunos,Cafetería el Kippe,9000,3200,12200
18109,18110,21-10-2020 15:59:56.714936,Postres · Desayunos,Jacques Pastelería,23000,5900,28900
18110,18111,21-10-2020 15:59:57.119901,Desayunos · Café,Norma's Ice Cream Café,15600,6300,21900
18111,18112,21-10-2020 15:59:57.274255,Postres · Desayunos,Restaurante Cornelia,35000,5500,40500
18112,18113,21-10-2020 15:59:57.578945,Saludable · Desayunos,Fresh Co,24300,5600,29900
18113,18114,21-10-2020 15:59:57.983448,Típica,Cabrito Santandereano,15600,6600,22200
18114,18115,21-10-2020 15:59:58.338275,Postres · Desayunos,Restaurante Cornelia,17800,5500,23300
18115,18116,21-10-2020 15:59:58.643221,Helados,Buon Gelato,12500,4400,16900
18116,18117,21-10-2020 15:59:58.847540,Desayunos · Panadería,Pasteleite,39700,5900,45600
18117,18118,21-10-2020 15:59:59.052074,Comida Rápida,Fiesta Digital Andrés,18900,3100,22000
18118,18119,21-10-2020 15:59:59.206284,Pizza,18 Scalini,10700,4300,15000
18119,18120,21-10-2020 15:59:59.613813,Desayunos · Típica,Papadió - Colombianas,53400,5700,59100
18120,18121,21-10-2020 15:59:59.818954,Peruana,Uma Cantina Peruana,9000,3200,12200
18121,18122,21-10-2020 16:00:00.023394,Saludable,Hanai - Bowls Saludables,37900,5900,43800
18122,18123,21-10-2020 16:00:00.377895,Sánduches · Pescados y Mariscos,Pacific Comida de Mar,27800,4000,31800
18123,18124,21-10-2020 16:00:00.632732,Desayunos,Bagel Shop,12500,3200,15700
18124,18125,21-10-2020 16:00:00.887070,Saludable · Desayunos,Distrito Gourmet,12500,3700,16200
18125,18126,21-10-2020 16:00:01.091645,Postres,Levelma,18900,6200,25100
18126,18127,21-10-2020 16:00:01.246758,Postres · Desayunos,Cosmo Cookies,11870,5900,17770
18127,18128,21-10-2020 16:00:01.501321,Postres · Desayunos,Sweet Tale,23000,5800,28800
18128,18129,21-10-2020 16:00:01.805956,Desayunos,Bagel Shop,23000,3200,26200
18129,18130,21-10-2020 16:00:01.960466,Desayunos,Sunny Breakfast Brunch,18900,4300,23200
18130,18131,21-10-2020 16:00:02.365055,Postres,Beiked,10700,4000,14700
18131,18132,21-10-2020 16:00:02.670111,Pollo,Chicken House,18900,4200,23100
18132,18133,21-10-2020 16:00:02.974485,Desayunos · Jugos y Batidos,Frutiwow,48750,4100,52850
18133,18134,21-10-2020 16:00:03.229273,Parrilla,Parrilla Pimentón,35000,3400,38400
18134,18135,21-10-2020 16:00:03.534004,Postres · Desayunos,Aury Postres - Comidas & Picadas,31800,4700,36500
18135,18136,21-10-2020 16:00:03.738372,Saludable · Desayunos,Básico y elemental,15000,5000,20000
18136,18137,21-10-2020 16:00:04.042864,Desayunos · Comida Rápida,La Veneca,53400,6300,59700
18137,18138,21-10-2020 16:00:04.247638,Desayunos · Panadería,Artesanos,65000,4300,69300
18138,18139,21-10-2020 16:00:04.602061,Parrilla · Café,Gaira Café,23000,4400,27400
18139,18140,21-10-2020 16:00:04.757238,Saludable · Desayunos,La Cesta,48750,4700,53450
18140,18141,21-10-2020 16:00:04.911028,Saludable · Desayunos,Guadalupe - Fruteria,53900,5900,59800
18141,18142,21-10-2020 16:00:05.166086,Típica,Sabrosito,39700,4000,43700
18142,18143,21-10-2020 16:00:05.320129,Desayunos · Típica,D'Porco - Lechona,23000,6300,29300
18143,18144,21-10-2020 16:00:05.674741,Postres · Desayunos,Amelie Helados,45800,6400,52200
18144,18145,21-10-2020 16:00:05.979408,Desayunos · Panadería,Ficchi Panadería,12500,3100,15600
18145,18146,21-10-2020 16:00:06.333957,Panadería,Boul,34500,3100,37600
18146,18147,21-10-2020 16:00:06.688819,Desayunos · Parrilla,Mi Patria,31800,4600,36400
18147,18148,21-10-2020 16:00:07.093397,Postres · Desayunos,Sharmus,23000,6100,29100
18148,18149,21-10-2020 16:00:07.298125,Crepes,San Crepes,45800,4900,50700
18149,18150,21-10-2020 16:00:07.553106,Desayunos,Cafetería el Kippe,13600,3200,16800
18150,18151,21-10-2020 16:00:07.907703,Pollo · Desayunos,Caserito Gourmet,24200,6700,30900
18151,18152,21-10-2020 16:00:08.212958,Saludable · Desayunos,Guadalupe - Fruteria,17800,5900,23700
18152,18153,21-10-2020 16:00:08.469428,Helados,Buon Gelato,13600,4400,18000
18153,18154,21-10-2020 16:00:08.674631,Típica,Sopitas y Más,53900,4200,58100
18154,18155,21-10-2020 16:00:08.879378,Sushi,Kim Pop,23000,5400,28400
18155,18156,21-10-2020 16:00:09.234604,Pizza,pizza andante,18900,4200,23100
18156,18157,21-10-2020 16:00:09.640074,Postres · Desayunos,Vivalight Market.,24300,6500,30800
18157,18158,21-10-2020 16:00:09.895637,Postres · Saludable,Ana Rebana,18900,6300,25200
18158,18159,21-10-2020 16:00:10.150724,Postres · Desayunos,Cosmo Cookies,31800,5900,37700
18159,18160,21-10-2020 16:00:10.555771,Pizza · Italiana,Pisapore - Pizza,24300,6600,30900
18160,18161,21-10-2020 16:00:10.860532,Crepes,San Crepes,45800,4900,50700
18161,18162,21-10-2020 16:00:11.015476,Sushi,Kim Pop,15000,5400,20400
18162,18163,21-10-2020 16:00:11.320013,Desayunos · Panadería,Choclofee,48750,4700,53450
18163,18164,21-10-2020 16:00:11.625251,Desayunos · Italiana,Rceta By Rausch,37900,3600,41500
18164,18165,21-10-2020 16:00:11.880007,Saludable,Ventura Soup y Salad,70000,3800,73800
18165,18166,21-10-2020 16:00:12.034595,Típica,Salsig,12500,5600,18100
18166,18167,21-10-2020 16:00:12.339162,Desayunos · Panadería,Premium Break Bakery,9000,3700,12700
18167,18168,21-10-2020 16:00:12.644261,Crepes,San Crepes,48750,4900,53650
18168,18169,21-10-2020 16:00:12.899622,Desayunos · Típica,Cochon,39700,3300,43000
18169,18170,21-10-2020 16:00:13.054758,Pollo · Saludable,Yerbabuena,17800,3900,21700
18170,18171,21-10-2020 16:00:13.359631,Postres · Desayunos,Cosmo Cookies,9000,5900,14900
18171,18172,21-10-2020 16:00:13.714603,Desayunos · Jugos y Batidos,Kuriwaji,15600,6300,21900
18172,18173,21-10-2020 16:00:14.069204,Desayunos · Jugos y Batidos,Dont Be Hungry,48750,5600,54350
18173,18174,21-10-2020 16:00:14.324268,Peruana · Internacional,La Chifería,23000,6600,29600
18174,18175,21-10-2020 16:00:14.729773,Pizza · Italiana,Piatto - Pizza,45800,6600,52400
18175,18176,21-10-2020 16:00:14.884182,Típica · Parrilla,Typykos,7500,6000,13500
18176,18177,21-10-2020 16:00:15.139750,Desayunos · Panadería,Choclofee,35000,4700,39700
18177,18178,21-10-2020 16:00:15.344279,Pollo,Chicken House,9000,4200,13200
18178,18179,21-10-2020 16:00:15.499154,Desayunos · Internacional,Camilia,29500,3900,33400
18179,18180,21-10-2020 16:00:15.654161,Pescados y Mariscos,Fish Place - Del Mar,39700,5400,45100
18180,18181,21-10-2020 16:00:15.809218,Parrilla,Arepaisa de Medellín,12500,5600,18100
18181,18182,21-10-2020 16:00:16.114112,Postres · Desayunos,Maria Luisa - Postres,11870,4300,16170
18182,18183,21-10-2020 16:00:16.519000,Desayunos · Típica,Peninsula Calentados y Parrilla,18900,3400,22300
18183,18184,21-10-2020 16:00:16.873961,Postres · Desayunos,KOKOA & co.,31800,4700,36500
18184,18185,21-10-2020 16:00:17.028932,Típica,Juan Chorizo,31800,3900,35700
18185,18186,21-10-2020 16:00:17.434668,Desayunos,Butter,45800,6700,52500
18186,18187,21-10-2020 16:00:17.839920,Desayunos · Sánduches,Garnish,7500,5200,12700
18187,18188,21-10-2020 16:00:17.995079,Desayunos,Butter,70000,6700,76700
18188,18189,21-10-2020 16:00:18.149606,Postres · Desayunos,Vivalight Market.,23000,6500,29500
18189,18190,21-10-2020 16:00:18.304377,Sushi · Desayunos,Maki Roll,10700,4300,15000
18190,18191,21-10-2020 16:00:18.709446,Postres · Café,Celestino Café,15600,5900,21500
18191,18192,21-10-2020 16:00:18.914080,Postres · Helados,Mahé,45800,6000,51800
18192,18193,21-10-2020 16:00:19.268840,Postres · Desayunos,Buñuelos nacho,9000,6600,15600
18193,18194,21-10-2020 16:00:19.424505,Desayunos · Sánduches,Garnish,24300,5200,29500
18194,18195,21-10-2020 16:00:19.579794,Alta Cocina · Postres,La Pinta,10700,4500,15200
18195,18196,21-10-2020 16:00:19.884746,Pollo · China,China Tao,24200,3500,27700
18196,18197,21-10-2020 16:00:20.089701,Desayunos · Típica,Calentao Express,13600,6000,19600
18197,18198,21-10-2020 16:00:20.496048,Desayunos,Jacinta Arepas de Huevo,53400,4000,57400
18198,18199,21-10-2020 16:00:20.700680,Mexicana,La leyenda mexican kitchen,37900,3200,41100
18199,18200,21-10-2020 16:00:20.955724,Asiática,Thai Station,7500,6000,13500
18200,18201,21-10-2020 16:00:21.110634,Desayunos · Pescados y Mariscos,Gypsy Bistro,13000,4500,17500
18201,18202,21-10-2020 16:00:21.366164,Postres · Desayunos,Aury Postres - Comidas & Picadas,23000,4700,27700
18202,18203,21-10-2020 16:00:21.721833,Saludable · Parrilla,Box,65000,3700,68700
18203,18204,21-10-2020 16:00:21.977193,Desayunos · Típica,Cochon,24300,3300,27600
18204,18205,21-10-2020 16:00:22.282781,Hamburguesas · Desayunos,El Inglés Gastro Pub,7500,6600,14100
18205,18206,21-10-2020 16:00:22.538157,Desayunos,Cafetería el Kippe,39700,3200,42900
18206,18207,21-10-2020 16:00:22.793191,Sánduches,Submarin,11870,3800,15670
18207,18208,21-10-2020 16:00:23.098207,Pollo · Desayunos,Piaf,24300,6500,30800
18208,18209,21-10-2020 16:00:23.504121,Sushi,Umi,65000,5600,70600
18209,18210,21-10-2020 16:00:23.759578,Desayunos · Jugos y Batidos,Kuriwaji,12500,6300,18800
18210,18211,21-10-2020 16:00:23.965105,Desayunos · Típica,Peninsula Calentados y Parrilla,17800,3400,21200
18211,18212,21-10-2020 16:00:24.370483,Parrilla,Carnes la Zarza,35000,4900,39900
18212,18213,21-10-2020 16:00:24.775447,Desayunos · Panadería,Limarys,8900,6500,15400
18213,18214,21-10-2020 16:00:25.131166,China,China Food Col,13000,3600,16600
18214,18215,21-10-2020 16:00:25.538112,Crepes,La Chabatta,11870,5900,17770
18215,18216,21-10-2020 16:00:25.693254,Pollo · Saludable,Gratina,39700,4200,43900
18216,18217,21-10-2020 16:00:25.998235,Pollo,Señor Fantástico,8900,4700,13600
18217,18218,21-10-2020 16:00:26.202760,Pollo · Desayunos,Candelina,27800,5300,33100
18218,18219,21-10-2020 16:00:26.507943,Internacional,Rio Sabores y Experiencias,7500,4100,11600
18219,18220,21-10-2020 16:00:26.712896,Saludable,Ventura Soup y Salad,27800,3800,31600
18220,18221,21-10-2020 16:00:26.967512,Desayunos,El Corral - Desayunos,10700,5000,15700
18221,18222,21-10-2020 16:00:27.122388,Desayunos · Típica,Papadió - Colombianas,53400,5700,59100
18222,18223,21-10-2020 16:00:27.478198,Postres · Desayunos,Sweet Tale,23000,5800,28800
18223,18224,21-10-2020 16:00:27.683948,Desayunos,Bagel Shop,34500,3200,37700
18224,18225,21-10-2020 16:00:27.839618,Internacional,La Esquina con Sabor Parrilla,53400,3000,56400
18225,18226,21-10-2020 16:00:28.094686,Desayunos,El Corral - Desayunos,24200,5000,29200
18226,18227,21-10-2020 16:00:28.399678,Sushi · Desayunos,Maki Roll,15000,4300,19300
18227,18228,21-10-2020 16:00:28.654783,Saludable,The Good Rice Bowls,27800,3500,31300
18228,18229,21-10-2020 16:00:28.909543,Desayunos · Café,El Gualilo,8900,6200,15100
18229,18230,21-10-2020 16:00:29.164846,Postres,Toledo Pastelería,15000,6800,21800
18230,18231,21-10-2020 16:00:29.369362,Saludable · Desayunos,Básico y elemental,53900,5000,58900
18231,18232,21-10-2020 16:00:29.579119,Desayunos · Típica,Criollomania,53400,5200,58600
18232,18233,21-10-2020 16:00:29.834686,Saludable · Desayunos,Agua Dulce,53900,3700,57600
18233,18234,21-10-2020 16:00:30.139758,Panadería,Boul,15600,3100,18700
18234,18235,21-10-2020 16:00:30.394753,Hamburguesas · Desayunos,El Inglés Gastro Pub,11870,6600,18470
18235,18236,21-10-2020 16:00:30.701358,Postres,La Tertulia,15600,3400,19000
18236,18237,21-10-2020 16:00:30.955640,Desayunos · Café,Libertario Coffee Roasters,12500,4600,17100
18237,18238,21-10-2020 16:00:31.160788,Postres,La Tertulia,31800,3400,35200
18238,18239,21-10-2020 16:00:31.466074,Postres · Desayunos,Protein Bakes,65000,5900,70900
18239,18240,21-10-2020 16:00:31.620968,Típica,Cazuelitas 93,11870,3900,15770
18240,18241,21-10-2020 16:00:31.925742,Desayunos · Típica,90 Calentados,35000,3700,38700
18241,18242,21-10-2020 16:00:32.281087,Típica,Cabrito Santandereano,13000,6600,19600
18242,18243,21-10-2020 16:00:32.586144,Pollo · Desayunos,Candelina,31800,5300,37100
18243,18244,21-10-2020 16:00:32.791373,Postres · Desayunos,BagBog Bagels,29500,6400,35900
18244,18245,21-10-2020 16:00:33.097922,Desayunos · Panadería,Premium Break Bakery,31800,3700,35500
18245,18246,21-10-2020 16:00:33.503871,Alta Cocina · Postres,La Pinta,23000,4500,27500
18246,18247,21-10-2020 16:00:33.659197,Desayunos · Típica,Rojo Gourmet,15000,4700,19700
18247,18248,21-10-2020 16:00:33.864072,Típica · Parrilla,El Portal de la Antigua,7500,5600,13100
18248,18249,21-10-2020 16:00:34.018851,Desayunos,Butter,48750,6700,55450
18249,18250,21-10-2020 16:00:34.174497,Pizza · Parrilla,Urban Lunch,53400,4000,57400
18250,18251,21-10-2020 16:00:34.330195,Desayunos · Jugos y Batidos,Frutiwow,48750,4100,52850
18251,18252,21-10-2020 16:00:34.585904,Saludable · Desayunos,Copacabana Açai Bowls,13600,3000,16600
18252,18253,21-10-2020 16:00:34.891667,Parrilla · Internacional,Taperia de la Plaza,27800,5700,33500
18253,18254,21-10-2020 16:00:35.196994,Comida Rápida,Fiesta Digital Andrés,11870,3100,14970
18254,18255,21-10-2020 16:00:35.402271,Desayunos · Árabe,Boniato Sabores Vivos,53900,5300,59200
18255,18256,21-10-2020 16:00:35.657663,Típica,Cabrito Santandereano,65000,6600,71600
18256,18257,21-10-2020 16:00:35.914002,Parrilla,El Tambor,7500,6800,14300
18257,18258,21-10-2020 16:00:36.169344,Desayunos · Italiana,Rceta By Rausch,34500,3600,38100
18258,18259,21-10-2020 16:00:36.524313,Desayunos · Típica,Criollomania,9000,5200,14200
18259,18260,21-10-2020 16:00:36.679350,Desayunos · Panadería,Santa Juana Food Bar,15000,5900,20900
18260,18261,21-10-2020 16:00:36.984378,Jugos y Batidos,Pomponio,7500,3600,11100
18261,18262,21-10-2020 16:00:37.290244,Desayunos,Cafetería el Kippe,24200,3200,27400
18262,18263,21-10-2020 16:00:37.695972,Poke,Poke Go,27800,4600,32400
18263,18264,21-10-2020 16:00:37.950748,Desayunos · Panadería,Premium Break Bakery,9000,3700,12700
18264,18265,21-10-2020 16:00:38.156240,Típica,La Olla de Barro,7500,5300,12800
18265,18266,21-10-2020 16:00:38.411632,Postres · Café,Loló Coffee & Snacks,35000,4600,39600
18266,18267,21-10-2020 16:00:38.766682,Desayunos · Típica,90 Calentados,10700,3700,14400
18267,18268,21-10-2020 16:00:39.071664,Desayunos · Típica,Calentao Express,23000,6000,29000
18268,18269,21-10-2020 16:00:39.377162,Desayunos · Panadería,Choclofee,53400,4700,58100
18269,18270,21-10-2020 16:00:39.733008,Desayunos · Típica,90 Calentados,45800,3700,49500
18270,18271,21-10-2020 16:00:39.988313,Postres,Beiked,13600,4000,17600
18271,18272,21-10-2020 16:00:40.293673,Parrilla,Campocina,37900,4600,42500
18272,18273,21-10-2020 16:00:40.449950,Desayunos,El Corral - Desayunos,23000,5000,28000
18273,18274,21-10-2020 16:00:40.854779,Desayunos,Desayunos en Bogotá,15600,3400,19000
18274,18275,21-10-2020 16:00:41.209667,Desayunos · Jugos y Batidos,Kuriwaji,70000,6300,76300
18275,18276,21-10-2020 16:00:41.514661,Típica,Salsig,65000,5600,70600
18276,18277,21-10-2020 16:00:41.669787,Desayunos · Parrilla,Mi Patria,13000,4600,17600
18277,18278,21-10-2020 16:00:42.074667,Desayunos · Típica,Casa Vieja,12500,6000,18500
18278,18279,21-10-2020 16:00:42.480045,Saludable,Hanai - Bowls Saludables,23000,5900,28900
18279,18280,21-10-2020 16:00:42.835261,Hamburguesas,Monchis - Hamburguesa,45800,4300,50100
18280,18281,21-10-2020 16:00:43.240801,Pizza · Italiana,Pisapore - Pizza,13600,6600,20200
18281,18282,21-10-2020 16:00:43.595789,Típica,El Mondongo y Mucho Mas,15600,5600,21200
18282,18283,21-10-2020 16:00:43.750544,Saludable · Jugos y Batidos,Berdes Drinks & Salads,15000,3500,18500
18283,18284,21-10-2020 16:00:44.005226,Pescados y Mariscos,La Gran Cazuela,10700,3200,13900
18284,18285,21-10-2020 16:00:44.160189,Postres · Desayunos,Amelie Helados,10700,6400,17100
18285,18286,21-10-2020 16:00:44.416073,Desayunos · Pescados y Mariscos,Luzí­a - Mediterranea,27800,5700,33500
18286,18287,21-10-2020 16:00:44.821595,Postres · Desayunos,Jacques Pastelería,35000,5900,40900
18287,18288,21-10-2020 16:00:45.176779,Pizza,Pastas Laurentina,35000,4800,39800
18288,18289,21-10-2020 16:00:45.331517,Típica,La Cocina,12500,4600,17100
18289,18290,21-10-2020 16:00:45.637265,Postres,Beiked,12500,4000,16500
18290,18291,21-10-2020 16:00:45.892473,Típica · Pescados y Mariscos,Arroces Mrg,31800,4300,36100
18291,18292,21-10-2020 16:00:46.148121,Desayunos · Típica,Casa Vieja,10700,6000,16700
18292,18293,21-10-2020 16:00:46.404325,Desayunos,Archies Desayunos,10700,3100,13800
18293,18294,21-10-2020 16:00:46.660202,Sushi,Umi,18900,5600,24500
18294,18295,21-10-2020 16:00:47.065577,Desayunos · Típica,D´Porco,37900,3900,41800
18295,18296,21-10-2020 16:00:47.470985,Típica,Salsig,34500,5600,40100
18296,18297,21-10-2020 16:00:47.726755,Helados,Orso To Go,24300,6800,31100
18297,18298,21-10-2020 16:00:48.083603,Hamburguesas · Panadería,NYC Burgers,53900,6200,60100
18298,18299,21-10-2020 16:00:48.290807,Pollo · Sánduches,Pollos Century,13000,3000,16000
18299,18300,21-10-2020 16:00:48.548125,Postres · Desayunos,KOKOA & co.,15000,4700,19700
18300,18301,21-10-2020 16:00:48.905640,Saludable · Desayunos,Bawana - Sandwich,65000,3400,68400
18301,18302,21-10-2020 16:00:49.213416,Saludable · Desayunos,Raices Bienestar Gourmet,24200,6600,30800
18302,18303,21-10-2020 16:00:49.521066,Típica,Salsig,15600,5600,21200
18303,18304,21-10-2020 16:00:49.828209,Hamburguesas,Monchis - Hamburguesa,48750,4300,53050
18304,18305,21-10-2020 16:00:49.985017,Pizza · Italiana,Piatto - Pizza,17800,6600,24400
18305,18306,21-10-2020 16:00:50.291522,Postres · Desayunos,Gelateria Da Favola,17800,6500,24300
18306,18307,21-10-2020 16:00:50.498275,Saludable,Puro Verde,27800,5700,33500
18307,18308,21-10-2020 16:00:50.706154,Típica,Lo Nuestro,12500,3100,15600
18308,18309,21-10-2020 16:00:50.862388,Típica · Parrilla,El Santandereano,12500,5200,17700
18309,18310,21-10-2020 16:00:51.069438,Desayunos · Típica,Cochon,9000,3300,12300
18310,18311,21-10-2020 16:00:51.226786,Hamburguesas,Bendito Cordero,23000,5800,28800
18311,18312,21-10-2020 16:00:51.534321,Postres · Desayunos,Sharmus,27800,6100,33900
18312,18313,21-10-2020 16:00:51.941255,Pollo · Desayunos,Workzone,48750,3100,51850
18313,18314,21-10-2020 16:00:52.298727,Típica · Parrilla,La Parilla de David,11870,3100,14970
18314,18315,21-10-2020 16:00:52.455689,Desayunos · Italiana,Rceta By Rausch,13000,3600,16600
18315,18316,21-10-2020 16:00:52.762317,Parrilla · Internacional,Taperia de la Plaza,23000,5700,28700
18316,18317,21-10-2020 16:00:53.019201,Postres · Desayunos,Jacques Pastelería,13600,5900,19500
18317,18318,21-10-2020 16:00:53.276669,Desayunos,Cafetería el Kippe,9000,3200,12200
18318,18319,21-10-2020 16:00:53.584164,Pollo · Sánduches,Pollos Century,35000,3000,38000
18319,18320,21-10-2020 16:00:53.992083,Pizza,pizza andante,11870,4200,16070
18320,18321,21-10-2020 16:00:54.299423,Pollo · Desayunos,Candelina,35000,5300,40300
18321,18322,21-10-2020 16:00:54.656792,Saludable · Desayunos,La Cesta,7500,4700,12200
18322,18323,21-10-2020 16:00:55.013395,Postres · Desayunos,Maltihelados,27800,6200,34000
18323,18324,21-10-2020 16:00:55.319561,Postres · Desayunos,Maltihelados,13000,6200,19200
18324,18325,21-10-2020 16:00:55.627066,Desayunos · Típica,D´Porco,34500,3900,38400
18325,18326,21-10-2020 16:00:55.883398,Postres · Desayunos,Maria Luisa - Postres,37900,4300,42200
18326,18327,21-10-2020 16:00:56.140538,Sushi,Sushi Reel,11870,4700,16570
18327,18328,21-10-2020 16:00:56.498031,Postres · Desayunos,Sweet Tale,17800,5800,23600
18328,18329,21-10-2020 16:00:56.856667,Crepes,La Chabatta,53400,5900,59300
18329,18330,21-10-2020 16:00:57.014353,Pollo,Chicken House,24200,4200,28400
18330,18331,21-10-2020 16:00:57.422273,Hamburguesas · Alitas,Beer,18900,6600,25500
18331,18332,21-10-2020 16:00:57.579483,Desayunos · Café,Matchacha,8900,5900,14800
18332,18333,21-10-2020 16:00:57.835904,Parrilla,Coquitas,10700,5600,16300
18333,18334,21-10-2020 16:00:58.243186,Saludable · Desayunos,Fresh Co,11870,5600,17470
18334,18335,21-10-2020 16:00:58.550366,Saludable · Desayunos,Bawana - Sandwich,11870,3400,15270
18335,18336,21-10-2020 16:00:58.958165,Saludable · Jugos y Batidos,Berdes Drinks & Salads,7500,3500,11000
18336,18337,21-10-2020 16:00:59.265343,Típica,La Cocina,18900,4600,23500
18337,18338,21-10-2020 16:00:59.673106,Pollo · China,China Tao,8900,3500,12400
18338,18339,21-10-2020 16:00:59.830418,Desayunos · Mexicana,La Mera Mera - Mexicana,9000,3100,12100
18339,18340,21-10-2020 16:01:00.138209,Saludable · Jugos y Batidos,Berdes Drinks & Salads,11870,3500,15370
18340,18341,21-10-2020 16:01:00.495727,Desayunos · Panadería,Limarys,12500,6500,19000
18341,18342,21-10-2020 16:01:00.852196,Desayunos · Típica,Cochon,10700,3300,14000
18342,18343,21-10-2020 16:01:01.059346,Desayunos · Café,El Gualilo,53900,6200,60100
18343,18344,21-10-2020 16:01:01.467385,Comida Rápida,Fiesta Digital Andrés,17800,3100,20900
18344,18345,21-10-2020 16:01:01.675028,Típica,Bendita S,23000,4600,27600
18345,18346,21-10-2020 16:01:01.983008,Saludable,Puro Verde,48750,5700,54450
18346,18347,21-10-2020 16:01:02.340813,Comida Rápida,Fiesta Digital Andrés,53900,3100,57000
18347,18348,21-10-2020 16:01:02.698494,Típica · Parrilla,Typykos,34500,6000,40500
18348,18349,21-10-2020 16:01:02.905222,Hamburguesas,Gofi Burger,70000,5100,75100
18349,18350,21-10-2020 16:01:03.212311,Comida Rápida · Perros Calientes,Similoa - Comida Rapida,9000,3700,12700
18350,18351,21-10-2020 16:01:03.519698,Saludable · Desayunos,La Cesta,15000,4700,19700
18351,18352,21-10-2020 16:01:03.676854,Desayunos · Típica,Alce,53900,4900,58800
18352,18353,21-10-2020 16:01:03.983910,Desayunos · Sánduches,Danilo Colombia,53400,3300,56700
18353,18354,21-10-2020 16:01:04.290474,Parrilla,Parrilla Pimentón,17800,3400,21200
18354,18355,21-10-2020 16:01:04.698781,Postres · Desayunos,Maltihelados,29500,6200,35700
18355,18356,21-10-2020 16:01:04.856423,Café · Helados,Sofia heladería y café,24300,5800,30100
18356,18357,21-10-2020 16:01:05.264001,Desayunos · Comida Rápida,Chocolatto,17800,3400,21200
18357,18358,21-10-2020 16:01:05.472134,Saludable · Desayunos,Guadalupe - Fruteria,31800,5900,37700
18358,18359,21-10-2020 16:01:05.828730,Saludable · Parrilla,The Angels Grill and Drinks,9000,6200,15200
18359,18360,21-10-2020 16:01:06.185674,Sánduches,Submarin,39700,3800,43500
18360,18361,21-10-2020 16:01:06.342030,Peruana,Uma Cantina Peruana,39700,3200,42900
18361,18362,21-10-2020 16:01:06.698630,China,China Food Col,29500,3600,33100
18362,18363,21-10-2020 16:01:07.007012,Desayunos,Archies Desayunos,24300,3100,27400
18363,18364,21-10-2020 16:01:07.366157,Desayunos · Panadería,Juliana Restaurante,31800,6100,37900
18364,18365,21-10-2020 16:01:07.724015,Postres · Desayunos,Protein Bakes,27800,5900,33700
18365,18366,21-10-2020 16:01:08.081758,Desayunos · Comida Rápida,Chocolatto,29500,3400,32900
18366,18367,21-10-2020 16:01:08.289853,Postres · Desayunos,Restaurante Cornelia,24300,5500,29800
18367,18368,21-10-2020 16:01:08.596921,Desayunos · Panadería,Decofruta,7500,4700,12200
18368,18369,21-10-2020 16:01:08.852932,Postres,Beiked,70000,4000,74000
18369,18370,21-10-2020 16:01:09.060575,Internacional,La Esquina con Sabor Parrilla,12500,3000,15500
18370,18371,21-10-2020 16:01:09.418498,Saludable,Amor Propio saludable,10700,4000,14700
18371,18372,21-10-2020 16:01:09.626703,Postres · Desayunos,La Folie - Postres,65000,3300,68300
18372,18373,21-10-2020 16:01:09.884024,Pollo · Desayunos,Caserito Gourmet,34500,6700,41200
18373,18374,21-10-2020 16:01:10.140783,Italiana,Bocatto Di Passo,34500,5000,39500
18374,18375,21-10-2020 16:01:10.448762,Hamburguesas · Alitas,Beer,45800,6600,52400
18375,18376,21-10-2020 16:01:10.656962,Sushi,Sushi Reel,8900,4700,13600
18376,18377,21-10-2020 16:01:10.963920,Postres · Desayunos,KOKOA & co.,48750,4700,53450
18377,18378,21-10-2020 16:01:11.121604,Pizza · Italiana,Pisapore - Pizza,7500,6600,14100
18378,18379,21-10-2020 16:01:11.279286,Desayunos · Café,El Gualilo,18900,6200,25100
18379,18380,21-10-2020 16:01:11.536017,Postres · Desayunos,Gelateria Da Favola,29500,6500,36000
18380,18381,21-10-2020 16:01:11.794004,Desayunos · Panadería,Artesanos,53900,4300,58200
18381,18382,21-10-2020 16:01:12.001050,Postres,La Galeta,13600,3000,16600
18382,18383,21-10-2020 16:01:12.357997,Postres · Panadería,RIGHT AWAY FOODS,15000,6600,21600
18383,18384,21-10-2020 16:01:12.665733,Saludable,Hanai - Bowls Saludables,34500,5900,40400
18384,18385,21-10-2020 16:01:12.872817,Mexicana,Hidalgo Taquería,23000,4900,27900
18385,18386,21-10-2020 16:01:13.080418,Saludable · Desayunos,La Cesta,7500,4700,12200
18386,18387,21-10-2020 16:01:13.338259,Asiática,TeT,10700,5900,16600
18387,18388,21-10-2020 16:01:13.746947,Saludable,The Good Rice Bowls,23000,3500,26500
18388,18389,21-10-2020 16:01:13.954315,Desayunos,Jacinta Arepas de Huevo,17800,4000,21800
18389,18390,21-10-2020 16:01:14.112211,Desayunos · Panadería,Juliana Restaurante,24300,6100,30400
18390,18391,21-10-2020 16:01:14.270639,Desayunos · Pescados y Mariscos,Gypsy Bistro,53400,4500,57900
18391,18392,21-10-2020 16:01:14.578909,Postres · Saludable,Ana Rebana,65000,6300,71300
18392,18393,21-10-2020 16:01:14.935565,Italiana,Bocatto Di Passo,15600,5000,20600
18393,18394,21-10-2020 16:01:15.342612,Pollo · Desayunos,Caserito Gourmet,24300,6700,31000
18394,18395,21-10-2020 16:01:15.699251,Desayunos · Típica,Calentao Express,35000,6000,41000
18395,18396,21-10-2020 16:01:15.956239,Desayunos · Típica,90 Calentados,29500,3700,33200
18396,18397,21-10-2020 16:01:16.213956,Pollo · Desayunos,Abasto,34500,3600,38100
18397,18398,21-10-2020 16:01:16.521807,Desayunos · Pescados y Mariscos,Luzí­a - Mediterranea,10700,5700,16400
18398,18399,21-10-2020 16:01:16.878754,Desayunos · Panadería,Juliana Restaurante,35000,6100,41100
18399,18400,21-10-2020 16:01:17.237345,Panadería,Boul,70000,3100,73100
18400,18401,21-10-2020 16:01:17.646709,Pollo · Desayunos,Caserito Gourmet,15000,6700,21700
18401,18402,21-10-2020 16:01:17.904784,Desayunos · Panadería,Pasteleite,23000,5900,28900
18402,18403,21-10-2020 16:01:18.162434,Postres · Desayunos,Café Quindio,24200,5700,29900
18403,18404,21-10-2020 16:01:18.369671,Saludable · Desayunos,La Estampilla,31800,6000,37800
18404,18405,21-10-2020 16:01:18.627180,Saludable · Desayunos,Fresh Co,39700,5600,45300
18405,18406,21-10-2020 16:01:18.984780,Desayunos · Café,Moramia,45800,4700,50500
18406,18407,21-10-2020 16:01:19.143222,Saludable,MIMA,65000,3700,68700
18407,18408,21-10-2020 16:01:19.450997,Postres · Desayunos,Restaurante Cornelia,23000,5500,28500
18408,18409,21-10-2020 16:01:19.759494,Hamburguesas · Saludable,Restaurant Inn,35000,6100,41100
18409,18410,21-10-2020 16:01:20.016766,Típica,Sopitas y Más,13600,4200,17800
18410,18411,21-10-2020 16:01:20.324476,Desayunos,Desayunos en Bogotá,24300,3400,27700
18411,18412,21-10-2020 16:01:20.582105,Parrilla,Antojo a Domicilio,53400,5000,58400
18412,18413,21-10-2020 16:01:20.990288,Parrilla,Arepaisa de Medellín,37900,5600,43500
18413,18414,21-10-2020 16:01:21.148212,Saludable · Parrilla,The Angels Grill and Drinks,17800,6200,24000
18414,18415,21-10-2020 16:01:21.305888,Desayunos · Típica,D'Porco - Lechona,29500,6300,35800
18415,18416,21-10-2020 16:01:21.463559,Postres · Desayunos,Vivalight Market.,39700,6500,46200
18416,18417,21-10-2020 16:01:21.820475,Postres · Desayunos,Gelateria Da Favola,48750,6500,55250
18417,18418,21-10-2020 16:01:22.128268,Desayunos · Comida Rápida,Chocolatto,65000,3400,68400
18418,18419,21-10-2020 16:01:22.335244,Postres · Desayunos,Amelie Helados,35000,6400,41400
18419,18420,21-10-2020 16:01:22.542660,Parrilla,Restaurante Bar Mi Ranchito,18900,5200,24100
18420,18421,21-10-2020 16:01:22.700311,Desayunos · Café,Frambas,35000,3400,38400
18421,18422,21-10-2020 16:01:23.058013,Desayunos · Panadería,Siena Café,18900,3700,22600
18422,18423,21-10-2020 16:01:23.366336,Típica,Sabores De Mi Tierra,37900,5400,43300
18423,18424,21-10-2020 16:01:23.774777,Perros Calientes,Dog Shop - Rapida,15000,4900,19900
18424,18425,21-10-2020 16:01:24.132778,Desayunos · Café,Libertario Coffee Roasters,24300,4600,28900
18425,18426,21-10-2020 16:01:24.540952,Desayunos · Panadería,El Pan de Phillippe,45800,4600,50400
18426,18427,21-10-2020 16:01:24.848446,Típica,Carbón & Mondongos,11870,6400,18270
18427,18428,21-10-2020 16:01:25.206489,Típica · Parrilla,Typykos,18900,6000,24900
18428,18429,21-10-2020 16:01:25.514810,Típica,Sabores De Mi Tierra,13000,5400,18400
18429,18430,21-10-2020 16:01:25.821678,Desayunos · Árabe,Boniato Sabores Vivos,53400,5300,58700
18430,18431,21-10-2020 16:01:26.079334,Típica · Parrilla,Parrilla Farandula Gourmet,18900,5100,24000
18431,18432,21-10-2020 16:01:26.437114,Típica,Sopitas y Más,8900,4200,13100
18432,18433,21-10-2020 16:01:26.645353,Postres · Desayunos,Cosmo Cookies,39700,5900,45600
18433,18434,21-10-2020 16:01:27.052642,Desayunos · Café,Norma's Ice Cream Café,15000,6300,21300
18434,18435,21-10-2020 16:01:27.310217,Postres · Desayunos,BagBog Bagels,12500,6400,18900
18435,18436,21-10-2020 16:01:27.467730,Típica,La Herencia,15600,5900,21500
18436,18437,21-10-2020 16:01:27.875631,Desayunos · Panadería,Pasteleite,8900,5900,14800
18437,18438,21-10-2020 16:01:28.032231,Desayunos · Sánduches,Garnish,17800,5200,23000
18438,18439,21-10-2020 16:01:28.239866,Saludable · Desayunos,Copacabana Açai Bowls,15600,3000,18600
18439,18440,21-10-2020 16:01:28.647830,Saludable · Desayunos,Libre de Culpa,35000,4000,39000
18440,18441,21-10-2020 16:01:29.004995,Sushi,Umi,24200,5600,29800
18441,18442,21-10-2020 16:01:29.162374,Desayunos,Fratelli - Desayunos,17800,4600,22400
18442,18443,21-10-2020 16:01:29.370201,Postres · Desayunos,Maltihelado,18900,4500,23400
18443,18444,21-10-2020 16:01:29.577410,Desayunos · Panadería,Premium Break Bakery,24300,3700,28000
18444,18445,21-10-2020 16:01:29.735411,Desayunos,La Frijolada Desayunos,34500,4400,38900
18445,18446,21-10-2020 16:01:30.143433,Postres · Desayunos,BagBog Bagels,37900,6400,44300
18446,18447,21-10-2020 16:01:30.452131,Desayunos · Típica,La Frijolada,48750,4500,53250
18447,18448,21-10-2020 16:01:30.758889,Sushi,Sushi Reel,37900,4700,42600
18448,18449,21-10-2020 16:01:31.117734,Desayunos · Típica,Papadió - Colombianas,35000,5700,40700
18449,18450,21-10-2020 16:01:31.275483,Italiana,F*cking Good Pizza,35000,4200,39200
18450,18451,21-10-2020 16:01:31.434217,Helados,Buon Gelato,23000,4400,27400
18451,18452,21-10-2020 16:01:31.841759,Desayunos · Típica,Parrilla Farandula Típico,39700,5900,45600
18452,18453,21-10-2020 16:01:32.000276,Pollo · Desayunos,Caserito Gourmet,35000,6700,41700
18453,18454,21-10-2020 16:01:32.208108,Panadería,Boul,15600,3100,18700
18454,18455,21-10-2020 16:01:32.415834,Crepes,San Crepes,11870,4900,16770
18455,18456,21-10-2020 16:01:32.723538,Desayunos · Panadería,Choclofee,17800,4700,22500
18456,18457,21-10-2020 16:01:33.032015,Sánduches,Submarin,17800,3800,21600
18457,18458,21-10-2020 16:01:33.340321,Saludable · Desayunos,La Cesta,34500,4700,39200
18458,18459,21-10-2020 16:01:33.648224,Saludable · Desayunos,Re.al Alimentos Reales,24300,4000,28300
18459,18460,21-10-2020 16:01:33.806051,Postres · Panadería,RIGHT AWAY FOODS,39700,6600,46300
18460,18461,21-10-2020 16:01:34.213910,Desayunos · Típica,Calentao Express,13600,6000,19600
18461,18462,21-10-2020 16:01:34.621619,Desayunos · Típica,La Frijolada,39700,4500,44200
18462,18463,21-10-2020 16:01:34.878333,Postres · Desayunos,La Folie - Postres,39700,3300,43000
18463,18464,21-10-2020 16:01:35.285931,Saludable · Desayunos,Fresh Co,45800,5600,51400
18464,18465,21-10-2020 16:01:35.593391,Típica · Parrilla,Mi Ranchito Parrilla,10700,4400,15100
18465,18466,21-10-2020 16:01:35.851326,Parrilla,Coquitas,45800,5600,51400
18466,18467,21-10-2020 16:01:36.159101,Desayunos · Típica,Alce,13600,4900,18500
18467,18468,21-10-2020 16:01:36.417175,Postres · Desayunos,Amelie Helados,23000,6400,29400
18468,18469,21-10-2020 16:01:36.725011,Pizza,Pizza Andante,18900,6300,25200
18469,18470,21-10-2020 16:01:37.033116,Pizza,pizza andante,13600,4200,17800
18470,18471,21-10-2020 16:01:37.391172,Peruana · Internacional,La Chifería,11870,6600,18470
18471,18472,21-10-2020 16:01:37.598159,Desayunos · Café,Norma's Ice Cream Café,11870,6300,18170
18472,18473,21-10-2020 16:01:38.005969,Típica,La Cocina,23000,4600,27600
18473,18474,21-10-2020 16:01:38.364067,Postres · Desayunos,KOKOA & co.,13600,4700,18300
18474,18475,21-10-2020 16:01:38.622483,Peruana,Masivo,15000,5800,20800
18475,18476,21-10-2020 16:01:38.830010,Desayunos · Comida Rápida,Chocolatto,8900,3400,12300
18476,18477,21-10-2020 16:01:39.188028,Pizza · Italiana,Piatto - Pizza,15600,6600,22200
18477,18478,21-10-2020 16:01:39.396013,Desayunos · Típica,La Parrilla Dorada Polo,13600,6600,20200
18478,18479,21-10-2020 16:01:39.653625,Típica,Juan Chorizo,23000,3900,26900
18479,18480,21-10-2020 16:01:39.862035,Saludable · Desayunos,Bon Eat - Saludable,13000,4800,17800
18480,18481,21-10-2020 16:01:40.219863,Alta Cocina · Parrilla,Criterión,34500,6000,40500
18481,18482,21-10-2020 16:01:40.428890,Pizza,Pizza Andante,24300,6300,30600
18482,18483,21-10-2020 16:01:40.686584,China,China Food Col,23000,3600,26600
18483,18484,21-10-2020 16:01:41.095408,Saludable · Desayunos,Libre de Culpa,17800,4000,21800
18484,18485,21-10-2020 16:01:41.353054,Saludable · Desayunos,Distrito Gourmet,9000,3700,12700
18485,18486,21-10-2020 16:01:41.761654,Italiana,F*cking Good Pizza,23000,4200,27200
18486,18487,21-10-2020 16:01:42.069525,Desayunos · Típica,Papadió - Colombianas,31800,5700,37500
18487,18488,21-10-2020 16:01:42.427870,Típica · Parrilla,Toya,35000,4200,39200
18488,18489,21-10-2020 16:01:42.636459,Típica · Parrilla,Parrilla Farandula Gourmet,8900,5100,14000
18489,18490,21-10-2020 16:01:42.844623,Desayunos,La Frijolada Desayunos,53400,4400,57800
18490,18491,21-10-2020 16:01:43.202676,Pizza,Pizza Andante,70000,6300,76300
18491,18492,21-10-2020 16:01:43.611824,Típica · Parrilla,Typykos,15600,6000,21600
18492,18493,21-10-2020 16:01:43.869619,Postres · Desayunos,Maria Luisa - Postres,7500,4300,11800
18493,18494,21-10-2020 16:01:44.278344,Saludable · Jugos y Batidos,Berdes Drinks & Salads,35000,3500,38500
18494,18495,21-10-2020 16:01:44.536169,Desayunos,La Frijolada Desayunos,65000,4400,69400
18495,18496,21-10-2020 16:01:44.844493,Típica,Sabrosito,31800,4000,35800
18496,18497,21-10-2020 16:01:45.201653,Postres · Café,Loló Coffee & Snacks,39700,4600,44300
18497,18498,21-10-2020 16:01:45.460168,Típica,Lo Nuestro,39700,3100,42800
18498,18499,21-10-2020 16:01:45.719172,Parrilla,Coquitas,31800,5600,37400
18499,18500,21-10-2020 16:01:46.078094,Panadería,Boul,45800,3100,48900
18500,18501,21-10-2020 16:01:46.437176,Típica,Carbón & Mondongos,10700,6400,17100
18501,18502,21-10-2020 16:01:46.745567,Parrilla,Arepaisa de Medellín,8900,5600,14500
18502,18503,21-10-2020 16:01:47.003310,Desayunos · Mexicana,La Mera Mera - Mexicana,53400,3100,56500
18503,18504,21-10-2020 16:01:47.310919,Café · Helados,Sofia heladería y café,23000,5800,28800
18504,18505,21-10-2020 16:01:47.468873,Saludable · Desayunos,Fresh Co,27800,5600,33400
18505,18506,21-10-2020 16:01:47.676444,Postres · Café,Loló Coffee & Snacks,39700,4600,44300
18506,18507,21-10-2020 16:01:48.084725,Desayunos · Típica,Papadió - Colombianas,17800,5700,23500
18507,18508,21-10-2020 16:01:48.443676,Internacional,Rio Sabores y Experiencias,31800,4100,35900
18508,18509,21-10-2020 16:01:48.752005,Desayunos · Típica,D´Porco,24300,3900,28200
18509,18510,21-10-2020 16:01:48.909186,Pollo · Sánduches,Pollos Century,15000,3000,18000
18510,18511,21-10-2020 16:01:49.066335,Desayunos,Jacinta Arepas de Huevo,18900,4000,22900
18511,18512,21-10-2020 16:01:49.223958,Saludable · Desayunos,Raices Bienestar Gourmet,15000,6600,21600
18512,18513,21-10-2020 16:01:49.532112,Parrilla,Restaurante Bar Mi Ranchito,65000,5200,70200
18513,18514,21-10-2020 16:01:49.741415,Típica,Bendita S,13600,4600,18200
18514,18515,21-10-2020 16:01:50.150084,Hamburguesas · Alitas,Beer,31800,6600,38400
18515,18516,21-10-2020 16:01:50.558247,Saludable · Desayunos,Bon Eat - Saludable,53400,4800,58200
18516,18517,21-10-2020 16:01:50.916288,Típica,Carbón & Mondongos,27800,6400,34200
18517,18518,21-10-2020 16:01:51.174600,Postres · Helados,Mahé,48750,6000,54750
18518,18519,21-10-2020 16:01:51.532806,Pollo · Desayunos,Abasto,37900,3600,41500
18519,18520,21-10-2020 16:01:51.841624,Parrilla,Arroces Maria Paula,10700,6800,17500
18520,18521,21-10-2020 16:01:52.200087,Desayunos · Sánduches,Garnish,29500,5200,34700
18521,18522,21-10-2020 16:01:52.458272,Postres · Desayunos,Vivalight Market.,48750,6500,55250
18522,18523,21-10-2020 16:01:52.665555,Postres · Desayunos,Café Quindio,35000,5700,40700
18523,18524,21-10-2020 16:01:52.973361,Desayunos · Panadería,Le Pain Quotidien,48750,3900,52650
18524,18525,21-10-2020 16:01:53.231600,Desayunos,Sr Buñuelo,48750,6400,55150
18525,18526,21-10-2020 16:01:53.439918,Postres · Desayunos,Café Quindio,12500,5700,18200
18526,18527,21-10-2020 16:01:53.749376,Saludable · Desayunos,Bon Eat - Saludable,27800,4800,32600
18527,18528,21-10-2020 16:01:53.906859,Desayunos,La Frijolada Desayunos,23000,4400,27400
18528,18529,21-10-2020 16:01:54.114761,Crepes,San Crepes,15600,4900,20500
18529,18530,21-10-2020 16:01:54.322089,Desayunos · Panadería,El Pan de Phillippe,8900,4600,13500
18530,18531,21-10-2020 16:01:54.679323,Desayunos · Típica,La Frijolada,70000,4500,74500
18531,18532,21-10-2020 16:01:54.886385,Asiática,Thai Station,13000,6000,19000
18532,18533,21-10-2020 16:01:55.294759,Típica · Parrilla,Typykos,70000,6000,76000
18533,18534,21-10-2020 16:01:55.503836,Alta Cocina · Postres,La Pinta,65000,4500,69500
18534,18535,21-10-2020 16:01:55.762340,Postres · Desayunos,Aury Postres - Comidas & Picadas,13600,4700,18300
18535,18536,21-10-2020 16:01:55.920787,Desayunos · Típica,Casa Vieja,45800,6000,51800
18536,18537,21-10-2020 16:01:56.279762,Desayunos · Panadería,Limarys,48750,6500,55250
18537,18538,21-10-2020 16:01:56.639670,Desayunos · Empanadas,Empanadas Doraditas.com,24300,3000,27300
18538,18539,21-10-2020 16:01:57.049280,Postres,Levelma,23000,6200,29200
18539,18540,21-10-2020 16:01:57.406688,Desayunos,Señor Desayuno,10700,6800,17500
18540,18541,21-10-2020 16:01:57.715651,Típica · Parrilla,Toya,45800,4200,50000
18541,18542,21-10-2020 16:01:58.022964,Desayunos · Café,Matchacha,23000,5900,28900
18542,18543,21-10-2020 16:01:58.382578,Postres · Desayunos,Gelateria Da Favola,35000,6500,41500
18543,18544,21-10-2020 16:01:58.540249,Típica,El Mondongo y Mucho Mas,24300,5600,29900
18544,18545,21-10-2020 16:01:58.800265,Saludable · Desayunos,Distrito Gourmet,35000,3700,38700
18545,18546,21-10-2020 16:01:58.957076,Postres · Desayunos,Maltihelado,15600,4500,20100
18546,18547,21-10-2020 16:01:59.165401,Perros Calientes,Dog Shop - Rapida,35000,4900,39900
18547,18548,21-10-2020 16:01:59.472945,Saludable,A2manos,15000,4200,19200
18548,18549,21-10-2020 16:01:59.830809,Saludable · Desayunos,Bawana - Sandwich,70000,3400,73400
18549,18550,21-10-2020 16:02:00.139130,Pollo,Chicken House,9000,4200,13200
18550,18551,21-10-2020 16:02:00.397818,Internacional,La Esquina con Sabor Parrilla,65000,3000,68000
18551,18552,21-10-2020 16:02:00.605782,Desayunos · Helados,San Giorgio Gelateria,11870,3100,14970
18552,18553,21-10-2020 16:02:01.014028,Desayunos,Desayunos en Bogotá,35000,3400,38400
18553,18554,21-10-2020 16:02:01.321631,Parrilla,Arepaisa de Medellín,9000,5600,14600
18554,18555,21-10-2020 16:02:01.530090,Hamburguesas,Gofi Burger,53400,5100,58500
18555,18556,21-10-2020 16:02:01.937344,Parrilla,Arepaisa de Medellín,13600,5600,19200
18556,18557,21-10-2020 16:02:02.346266,Saludable · Parrilla,Box,9000,3700,12700
18557,18558,21-10-2020 16:02:02.704399,Desayunos · Típica,Desayunadero de la 42,48750,5900,54650
18558,18559,21-10-2020 16:02:02.962150,Saludable,Hanai - Bowls Saludables,24300,5900,30200
18559,18560,21-10-2020 16:02:03.270162,Postres · Helados,Mahé,13000,6000,19000
18560,18561,21-10-2020 16:02:03.678365,Pollo · Saludable,Yerbabuena,48750,3900,52650
18561,18562,21-10-2020 16:02:03.986757,Desayunos · Panadería,Santa Juana Food Bar,12500,5900,18400
18562,18563,21-10-2020 16:02:04.345342,Típica,Juan Chorizo,15000,3900,18900
18563,18564,21-10-2020 16:02:04.655429,Desayunos,Butter,23000,6700,29700
18564,18565,21-10-2020 16:02:04.813682,Postres,Levelma,23000,6200,29200
18565,18566,21-10-2020 16:02:05.122839,Peruana · Internacional,La Chifería,39700,6600,46300
18566,18567,21-10-2020 16:02:05.381210,Pescados y Mariscos,Pescadero Héroes del Mar,8900,6600,15500
18567,18568,21-10-2020 16:02:05.589386,Pizza,Pastas Laurentina,18900,4800,23700
18568,18569,21-10-2020 16:02:05.947107,Pescados y Mariscos,Pescadero Héroes del Mar,15600,6600,22200
18569,18570,21-10-2020 16:02:06.155046,Italiana,F*cking Good Pizza,45800,4200,50000
18570,18571,21-10-2020 16:02:06.463819,Postres,Levelma,18900,6200,25100
18571,18572,21-10-2020 16:02:06.772259,Hamburguesas,Gofi Burger,11870,5100,16970
18572,18573,21-10-2020 16:02:06.980494,Desayunos · Panadería,Ficchi Panadería,18900,3100,22000
18573,18574,21-10-2020 16:02:07.338270,Parrilla · Café,Gaira Café,24200,4400,28600
18574,18575,21-10-2020 16:02:07.696438,Postres · Desayunos,Café Quindio,23000,5700,28700
18575,18576,21-10-2020 16:02:08.104806,Postres · Desayunos,Buñuelos nacho,35000,6600,41600
18576,18577,21-10-2020 16:02:08.513446,Desayunos · Típica,Calentao Express,15000,6000,21000
18577,18578,21-10-2020 16:02:08.871424,Típica,El Mondongo y Mucho Mas,29500,5600,35100
18578,18579,21-10-2020 16:02:09.130358,Pollo · Saludable,Yerbabuena,12500,3900,16400
18579,18580,21-10-2020 16:02:09.438845,Saludable,MIMA,27800,3700,31500
18580,18581,21-10-2020 16:02:09.697236,Típica,Lo Nuestro,53900,3100,57000
18581,18582,21-10-2020 16:02:09.854662,Postres · Café,Loló Coffee & Snacks,15600,4600,20200
18582,18583,21-10-2020 16:02:10.112474,Saludable · Desayunos,Copacabana Açai Bowls,23000,3000,26000
18583,18584,21-10-2020 16:02:10.470327,Desayunos · Café,Norma's Ice Cream Café,17800,6300,24100
18584,18585,21-10-2020 16:02:10.777495,Hamburguesas,Monchis - Hamburguesa,53400,4300,57700
18585,18586,21-10-2020 16:02:11.135747,Café · Helados,Sofia heladería y café,31800,5800,37600
18586,18587,21-10-2020 16:02:11.493400,Desayunos · Empanadas,Empanadas Doraditas.com,10700,3000,13700
18587,18588,21-10-2020 16:02:11.850195,Desayunos · Panadería,Ficchi Panadería,24200,3100,27300
18588,18589,21-10-2020 16:02:12.058022,Mexicana,Cantina La 15,70000,4300,74300
18589,18590,21-10-2020 16:02:12.466051,Postres · Desayunos,Jacques Pastelería,10700,5900,16600
18590,18591,21-10-2020 16:02:12.674215,Postres,Levelma,24300,6200,30500
18591,18592,21-10-2020 16:02:12.981631,Típica,Sabrosito,23000,4000,27000
18592,18593,21-10-2020 16:02:13.388761,Mexicana,Cantina La 15,9000,4300,13300
18593,18594,21-10-2020 16:02:13.796667,Típica,Carbón & Mondongos,37900,6400,44300
18594,18595,21-10-2020 16:02:14.054541,Pollo · Saludable,Yerbabuena,10700,3900,14600
18595,18596,21-10-2020 16:02:14.363409,Hamburguesas · Alitas,Beer,39700,6600,46300
18596,18597,21-10-2020 16:02:14.570775,Pizza,18 Scalini,34500,4300,38800
18597,18598,21-10-2020 16:02:14.778699,Internacional,La Esquina con Sabor Parrilla,13600,3000,16600
18598,18599,21-10-2020 16:02:14.985630,Pollo · Saludable,Tremenda Sal y Dulce,65000,6500,71500
18599,18600,21-10-2020 16:02:15.393653,Típica · Parrilla,Toya,18900,4200,23100
18600,18601,21-10-2020 16:02:15.552226,Saludable,Amor Propio saludable,29500,4000,33500
18601,18602,21-10-2020 16:02:15.710341,Perros Calientes,Dog Shop - Rapida,48750,4900,53650
18602,18603,21-10-2020 16:02:16.019021,Postres · Panadería,RIGHT AWAY FOODS,12500,6600,19100
18603,18604,21-10-2020 16:02:16.327596,Alta Cocina · Italiana,Trattoria de la Plaza,34500,6000,40500
18604,18605,21-10-2020 16:02:16.685096,Sánduches · China,Peru Mix,70000,5900,75900
18605,18606,21-10-2020 16:02:16.993046,Desayunos,Bagel Shop,23000,3200,26200
18606,18607,21-10-2020 16:02:17.351240,Postres · Desayunos,KOKOA & co.,65000,4700,69700
18607,18608,21-10-2020 16:02:17.759126,Mexicana,La leyenda mexican kitchen,10700,3200,13900
18608,18609,21-10-2020 16:02:18.166955,Saludable,Amor Propio saludable,24300,4000,28300
18609,18610,21-10-2020 16:02:18.325462,Desayunos · Café,Norma's Ice Cream Café,37900,6300,44200
18610,18611,21-10-2020 16:02:18.585002,Desayunos,Desayunos en Bogotá,12500,3400,15900
18611,18612,21-10-2020 16:02:18.893153,Saludable · Desayunos,Maracuyá,39700,6700,46400
18612,18613,21-10-2020 16:02:19.151632,Desayunos · Típica,Rojo Gourmet,65000,4700,69700
18613,18614,21-10-2020 16:02:19.310374,Mexicana,Hidalgo Taquería,34500,4900,39400
18614,18615,21-10-2020 16:02:19.569631,Postres · Desayunos,Café Quindio,31800,5700,37500
18615,18616,21-10-2020 16:02:19.778487,Desayunos · Panadería,Premium Break Bakery,13000,3700,16700
18616,18617,21-10-2020 16:02:19.936583,Desayunos · Típica,Desayunadero de la 42,35000,5900,40900
18617,18618,21-10-2020 16:02:20.295313,Desayunos,Fratelli - Desayunos,53900,4600,58500
18618,18619,21-10-2020 16:02:20.553784,Postres,Beiked,65000,4000,69000
18619,18620,21-10-2020 16:02:20.966061,Peruana,Masivo,27800,5800,33600
18620,18621,21-10-2020 16:02:21.174067,Sushi · Desayunos,Maki Roll,31800,4300,36100
18621,18622,21-10-2020 16:02:21.432317,Saludable,MIMA,48750,3700,52450
18622,18623,21-10-2020 16:02:21.740491,Típica,Bendita S,53400,4600,58000
18623,18624,21-10-2020 16:02:22.097980,Mexicana,Hidalgo Taquería,37900,4900,42800
18624,18625,21-10-2020 16:02:22.405757,Saludable · Jugos y Batidos,Berdes Drinks & Salads,48750,3500,52250
18625,18626,21-10-2020 16:02:22.563797,Pizza · Italiana,Piatto - Pizza,27800,6600,34400
18626,18627,21-10-2020 16:02:22.921802,Postres · Desayunos,Gelateria Da Favola,35000,6500,41500
18627,18628,21-10-2020 16:02:23.178695,Pollo,Señor Fantástico,7500,4700,12200
18628,18629,21-10-2020 16:02:23.487275,Típica,Carbón & Mondongos,10700,6400,17100
18629,18630,21-10-2020 16:02:23.795069,Peruana,Uma Cantina Peruana,70000,3200,73200
18630,18631,21-10-2020 16:02:24.053954,Típica · Parrilla,La Parilla de David,18900,3100,22000
18631,18632,21-10-2020 16:02:24.361015,Hamburguesas · Panadería,NYC Burgers,35000,6200,41200
18632,18633,21-10-2020 16:02:24.568124,Desayunos,El Corral - Desayunos,15000,5000,20000
18633,18634,21-10-2020 16:02:24.926797,Sánduches · Pescados y Mariscos,Pacific Comida de Mar,11870,4000,15870
18634,18635,21-10-2020 16:02:25.135080,Postres · Desayunos,Maria Luisa - Postres,24200,4300,28500
18635,18636,21-10-2020 16:02:25.293668,Hamburguesas · Saludable,Restaurant Inn,53900,6100,60000
18636,18637,21-10-2020 16:02:25.501623,Postres · Desayunos,Aury Postres - Comidas & Picadas,15600,4700,20300
18637,18638,21-10-2020 16:02:25.759734,Sushi,Kim Pop,18900,5400,24300
18638,18639,21-10-2020 16:02:26.117825,Desayunos · Café,Matchacha,12500,5900,18400
18639,18640,21-10-2020 16:02:26.325385,Desayunos · Típica,Alce,53900,4900,58800
18640,18641,21-10-2020 16:02:26.634298,Postres · Desayunos,Sharmus,10700,6100,16800
18641,18642,21-10-2020 16:02:26.941746,Desayunos · Típica,Calentao Express,17800,6000,23800
18642,18643,21-10-2020 16:02:27.350878,Desayunos · Pescados y Mariscos,Gypsy Bistro,17800,4500,22300
18643,18644,21-10-2020 16:02:27.759004,Desayunos · Café,Aromacafé el Placer de Compartir,31800,5000,36800
18644,18645,21-10-2020 16:02:27.966741,Desayunos · Típica,Cochon,31800,3300,35100
18645,18646,21-10-2020 16:02:28.174412,Saludable · Desayunos,Distrito Gourmet,39700,3700,43400
18646,18647,21-10-2020 16:02:28.482425,Típica,Bendita S,11870,4600,16470
18647,18648,21-10-2020 16:02:28.689812,Desayunos · Panadería,Ficchi Panadería,24300,3100,27400
18648,18649,21-10-2020 16:02:28.948072,Saludable,Hanai - Bowls Saludables,23000,5900,28900
18649,18650,21-10-2020 16:02:29.155690,Hamburguesas · Pescados y Mariscos,El Velero,48750,6500,55250
18650,18651,21-10-2020 16:02:29.313447,Desayunos · Típica,La Frijolada,15000,4500,19500
18651,18652,21-10-2020 16:02:29.722568,Postres,Beiked,13600,4000,17600
18652,18653,21-10-2020 16:02:29.930065,Saludable,The Good Rice Bowls,15600,3500,19100
18653,18654,21-10-2020 16:02:30.238672,Postres · Desayunos,Gelateria Da Favola,70000,6500,76500
18654,18655,21-10-2020 16:02:30.596477,Postres · Desayunos,Gelateria Da Favola,70000,6500,76500
18655,18656,21-10-2020 16:02:30.803768,Saludable · Desayunos,Básico y elemental,45800,5000,50800
18656,18657,21-10-2020 16:02:31.211333,Sushi · Asiática,Arigato,23000,5300,28300
18657,18658,21-10-2020 16:02:31.419633,Desayunos · Café,Matchacha,18900,5900,24800
18658,18659,21-10-2020 16:02:31.577812,Saludable · Típica,Sopas Mrg,17800,3100,20900
18659,18660,21-10-2020 16:02:31.935828,Mexicana,Mexicanachos,18900,3900,22800
18660,18661,21-10-2020 16:02:32.193324,Desayunos · Café,Aromacafé el Placer de Compartir,18900,5000,23900
18661,18662,21-10-2020 16:02:32.552297,Pollo · Desayunos,Caserito Gourmet,24200,6700,30900
18662,18663,21-10-2020 16:02:32.960338,Pollo · Saludable,Gratina,12500,4200,16700
18663,18664,21-10-2020 16:02:33.167963,Típica,Sopitas y Más,34500,4200,38700
18664,18665,21-10-2020 16:02:33.576494,Hamburguesas · Desayunos,El Inglés Gastro Pub,35000,6600,41600
18665,18666,21-10-2020 16:02:33.884905,Parrilla,El Tambor,12500,6800,19300
18666,18667,21-10-2020 16:02:34.193368,Helados,Buon Gelato,9000,4400,13400
18667,18668,21-10-2020 16:02:34.451699,Típica,Carbón & Mondongos,45800,6400,52200
18668,18669,21-10-2020 16:02:34.661185,Pizza · Italiana,Pisapore - Pizza,13600,6600,20200
18669,18670,21-10-2020 16:02:34.919629,Desayunos · Pescados y Mariscos,Luzí­a - Mediterranea,13000,5700,18700
18670,18671,21-10-2020 16:02:35.127666,Desayunos · Típica,D´Porco,12500,3900,16400
18671,18672,21-10-2020 16:02:35.335609,Desayunos,Butter,23000,6700,29700
18672,18673,21-10-2020 16:02:35.743514,Desayunos · Café,El Gualilo,70000,6200,76200
18673,18674,21-10-2020 16:02:35.900594,Desayunos · Típica,Peninsula Calentados y Parrilla,12500,3400,15900
18674,18675,21-10-2020 16:02:36.057519,Saludable · Jugos y Batidos,Berdes Drinks & Salads,45800,3500,49300
18675,18676,21-10-2020 16:02:36.416627,Postres · Desayunos,Café Quindio,39700,5700,45400
18676,18677,21-10-2020 16:02:36.625472,Mexicana,La leyenda mexican kitchen,31800,3200,35000
18677,18678,21-10-2020 16:02:36.784324,Parrilla · Café,Gaira Café,24300,4400,28700
18678,18679,21-10-2020 16:02:37.193296,Desayunos · Panadería,Le Pain Quotidien,35000,3900,38900
18679,18680,21-10-2020 16:02:37.451039,Desayunos · Panadería,Choclofee,7500,4700,12200
18680,18681,21-10-2020 16:02:37.609632,Desayunos · Típica,Alce,11870,4900,16770
18681,18682,21-10-2020 16:02:37.816636,Desayunos · Típica,D'Porco - Lechona,17800,6300,24100
18682,18683,21-10-2020 16:02:38.124721,Típica · Parrilla,Typykos,9000,6000,15000
18683,18684,21-10-2020 16:02:38.331788,Postres · Desayunos,Protein Bakes,12500,5900,18400
18684,18685,21-10-2020 16:02:38.489090,Desayunos · Comida Rápida,Chocolatto,31800,3400,35200
18685,18686,21-10-2020 16:02:38.797546,Saludable · Desayunos,Agua Dulce,13000,3700,16700
18686,18687,21-10-2020 16:02:39.106450,Desayunos · Panadería,Ficchi Panadería,8900,3100,12000
18687,18688,21-10-2020 16:02:39.414392,Postres · Desayunos,Sharmus,48750,6100,54850
18688,18689,21-10-2020 16:02:39.722920,Desayunos · Panadería,Pasteleite,23000,5900,28900
18689,18690,21-10-2020 16:02:39.932199,Desayunos · Árabe,Boniato Sabores Vivos,31800,5300,37100
18690,18691,21-10-2020 16:02:40.090282,Desayunos,Cafetería el Kippe,24200,3200,27400
18691,18692,21-10-2020 16:02:40.398755,Saludable · Desayunos,Agua Dulce,18900,3700,22600
18692,18693,21-10-2020 16:02:40.756771,Desayunos,Jacinta Arepas de Huevo,45800,4000,49800
18693,18694,21-10-2020 16:02:41.014932,Típica,Cazuelitas 93,23000,3900,26900
18694,18695,21-10-2020 16:02:41.273274,Parrilla,Carnes la Zarza,12500,4900,17400
18695,18696,21-10-2020 16:02:41.531688,Desayunos · Internacional,Camilia,9000,3900,12900
18696,18697,21-10-2020 16:02:41.740118,Saludable,MIMA,15000,3700,18700
18697,18698,21-10-2020 16:02:41.948123,Postres · Desayunos,La Folie - Postres,45800,3300,49100
18698,18699,21-10-2020 16:02:42.104931,Típica · Parrilla,El Santandereano,24300,5200,29500
18699,18700,21-10-2020 16:02:42.414395,Poke,Poke Go,53400,4600,58000
18700,18701,21-10-2020 16:02:42.623089,Postres,Toledo Pastelería,53400,6800,60200
18701,18702,21-10-2020 16:02:42.881310,Desayunos · Típica,La Parrilla Dorada Polo,8900,6600,15500
18702,18703,21-10-2020 16:02:43.290265,Desayunos,Archies Desayunos,37900,3100,41000
18703,18704,21-10-2020 16:02:43.648124,Desayunos,Jacinta Arepas de Huevo,48750,4000,52750
18704,18705,21-10-2020 16:02:44.055717,Saludable · Desayunos,La Cesta,27800,4700,32500
18705,18706,21-10-2020 16:02:44.214007,Helados,Orso To Go,31800,6800,38600
18706,18707,21-10-2020 16:02:44.622542,Desayunos · Parrilla,Mi Patria,27800,4600,32400
18707,18708,21-10-2020 16:02:44.782035,Desayunos · Panadería,Artesanos,23000,4300,27300
18708,18709,21-10-2020 16:02:45.190826,Típica,La Herencia,18900,5900,24800
18709,18710,21-10-2020 16:02:45.548855,Desayunos · Café,Moramia,15600,4700,20300
18710,18711,21-10-2020 16:02:45.759459,Pizza · Italiana,Pisapore - Pizza,27800,6600,34400
18711,18712,21-10-2020 16:02:46.067730,Hamburguesas · Panadería,NYC Burgers,53900,6200,60100
18712,18713,21-10-2020 16:02:46.376147,Típica,Salsig,35000,5600,40600
18713,18714,21-10-2020 16:02:46.635276,Pollo · Desayunos,Candelina,24200,5300,29500
18714,18715,21-10-2020 16:02:46.942979,Postres · Desayunos,Buñuelos nacho,13000,6600,19600
18715,18716,21-10-2020 16:02:47.201355,Saludable,Ventura Soup y Salad,53400,3800,57200
18716,18717,21-10-2020 16:02:47.609788,Desayunos · Típica,Criollomania,48750,5200,53950
18717,18718,21-10-2020 16:02:47.968178,Desayunos · Típica,Casa Vieja,27800,6000,33800
18718,18719,21-10-2020 16:02:48.227139,Hamburguesas,Monchis - Hamburguesa,27800,4300,32100
18719,18720,21-10-2020 16:02:48.486006,Pollo · Saludable,Yerbabuena,7500,3900,11400
18720,18721,21-10-2020 16:02:48.844765,Desayunos · Típica,Calentao Express,13000,6000,19000
18721,18722,21-10-2020 16:02:49.152572,Jugos y Batidos,Pomponio,35000,3600,38600
18722,18723,21-10-2020 16:02:49.560741,Crepes,La Chabatta,23000,5900,28900
18723,18724,21-10-2020 16:02:49.918941,Mexicana,La leyenda mexican kitchen,70000,3200,73200
18724,18725,21-10-2020 16:02:50.077439,Desayunos · Típica,Parrilla Farandula Típico,15000,5900,20900
18725,18726,21-10-2020 16:02:50.388543,Desayunos · Pescados y Mariscos,Luzí­a - Mediterranea,15600,5700,21300
18726,18727,21-10-2020 16:02:50.548727,Italiana,Bocatto Di Passo,29500,5000,34500
18727,18728,21-10-2020 16:02:50.958635,Típica,El Mondongo y Mucho Mas,7500,5600,13100
18728,18729,21-10-2020 16:02:51.168372,Sushi,Canoa To Go,15000,5900,20900
18729,18730,21-10-2020 16:02:51.527857,Hamburguesas,Bendito Cordero,35000,5800,40800
18730,18731,21-10-2020 16:02:51.736675,Típica · Parrilla,Typykos,11870,6000,17870
18731,18732,21-10-2020 16:02:52.095396,Mexicana,Hidalgo Taquería,13600,4900,18500
18732,18733,21-10-2020 16:02:52.503755,Peruana,Masivo,18900,5800,24700
18733,18734,21-10-2020 16:02:52.663504,Típica,Bandejas Mrg,37900,3800,41700
18734,18735,21-10-2020 16:02:53.073079,Saludable · Desayunos,Maracuyá,39700,6700,46400
18735,18736,21-10-2020 16:02:53.433474,Saludable,Hanai - Bowls Saludables,13600,5900,19500
18736,18737,21-10-2020 16:02:53.743171,Postres · Desayunos,Café Quindio,27800,5700,33500
18737,18738,21-10-2020 16:02:53.902503,Pollo · Pescados y Mariscos,Bang Bang Rice,35000,3400,38400
18738,18739,21-10-2020 16:02:54.262275,Típica · Parrilla,Typykos,24300,6000,30300
18739,18740,21-10-2020 16:02:54.471405,Postres,Toledo Pastelería,65000,6800,71800
18740,18741,21-10-2020 16:02:54.680596,Asiática,Thai Station,13600,6000,19600
18741,18742,21-10-2020 16:02:54.989491,Alta Cocina · Italiana,Trattoria de la Plaza,27800,6000,33800
18742,18743,21-10-2020 16:02:55.250182,Desayunos · Típica,Cochon,70000,3300,73300
18743,18744,21-10-2020 16:02:55.459625,Desayunos · Sánduches,Garnish,27800,5200,33000
18744,18745,21-10-2020 16:02:55.718919,Típica,La Olla de Barro,65000,5300,70300
18745,18746,21-10-2020 16:02:56.127261,Desayunos · Panadería,Pasteleite,29500,5900,35400
18746,18747,21-10-2020 16:02:56.336078,Pizza · Parrilla,Urban Lunch,27800,4000,31800
18747,18748,21-10-2020 16:02:56.645606,Saludable · Desayunos,Bon Eat - Saludable,35000,4800,39800
18748,18749,21-10-2020 16:02:56.803690,Desayunos,Cafetería el Kippe,10700,3200,13900
18749,18750,21-10-2020 16:02:57.112461,Postres · Café,Celestino Café,29500,5900,35400
18750,18751,21-10-2020 16:02:57.521778,China,China Food Col,10700,3600,14300
18751,18752,21-10-2020 16:02:57.931312,Desayunos,Jacinta Arepas de Huevo,13000,4000,17000
18752,18753,21-10-2020 16:02:58.341547,Típica,Carbón & Mondongos,23000,6400,29400
18753,18754,21-10-2020 16:02:58.700354,Postres · Desayunos,Aury Postres - Comidas & Picadas,15600,4700,20300
18754,18755,21-10-2020 16:02:58.858820,Típica,La Cocina,31800,4600,36400
18755,18756,21-10-2020 16:02:59.016915,Postres · Desayunos,Protein Bakes,31800,5900,37700
18756,18757,21-10-2020 16:02:59.374310,Saludable,Puro Verde,35000,5700,40700
18757,18758,21-10-2020 16:02:59.683039,Desayunos · Café,El Gualilo,53400,6200,59600
18758,18759,21-10-2020 16:03:00.041796,Saludable · Desayunos,La Estampilla,35000,6000,41000
18759,18760,21-10-2020 16:03:00.451340,Asiática,TeT,24300,5900,30200
18760,18761,21-10-2020 16:03:00.760336,Hamburguesas,Burger Society,39700,4100,43800
18761,18762,21-10-2020 16:03:01.068375,Desayunos · Jugos y Batidos,Kuriwaji,23000,6300,29300
18762,18763,21-10-2020 16:03:01.277868,Comida Rápida,Fiesta Digital Andrés,48750,3100,51850
18763,18764,21-10-2020 16:03:01.486149,Desayunos · Internacional,Camilia,35000,3900,38900
18764,18765,21-10-2020 16:03:01.794502,Postres · Desayunos,La Folie - Postres,35000,3300,38300
18765,18766,21-10-2020 16:03:02.053537,Pollo · Desayunos,Caserito Gourmet,31800,6700,38500
18766,18767,21-10-2020 16:03:02.311462,Desayunos · Helados,San Giorgio Gelateria,13000,3100,16100
18767,18768,21-10-2020 16:03:02.669757,Desayunos,Jacinta Arepas de Huevo,70000,4000,74000
18768,18769,21-10-2020 16:03:03.027781,Perros Calientes,Dog Shop - Rapida,18900,4900,23800
18769,18770,21-10-2020 16:03:03.185523,Postres · Desayunos,Jacques Pastelería,53400,5900,59300
18770,18771,21-10-2020 16:03:03.392410,Internacional,La Esquina con Sabor Parrilla,11870,3000,14870
18771,18772,21-10-2020 16:03:03.550324,Parrilla,Arroces Maria Paula,23000,6800,29800
18772,18773,21-10-2020 16:03:03.909176,Saludable,Amor Propio saludable,35000,4000,39000
18773,18774,21-10-2020 16:03:04.318050,Sushi,Canoa To Go,35000,5900,40900
18774,18775,21-10-2020 16:03:04.525976,Saludable,MIMA,35000,3700,38700
18775,18776,21-10-2020 16:03:04.734381,Saludable · Desayunos,Guadalupe - Fruteria,24200,5900,30100
18776,18777,21-10-2020 16:03:05.142574,Parrilla,Arroces Maria Paula,24200,6800,31000
18777,18778,21-10-2020 16:03:05.501977,Pollo · China,China Tao,11870,3500,15370
18778,18779,21-10-2020 16:03:05.811530,Saludable · Desayunos,Fresh Co,24200,5600,29800
18779,18780,21-10-2020 16:03:06.171340,Desayunos · Café,Moramia,23000,4700,27700
18780,18781,21-10-2020 16:03:06.580369,Desayunos · Pescados y Mariscos,Luzí­a - Mediterranea,65000,5700,70700
18781,18782,21-10-2020 16:03:06.989748,Desayunos,Sunny Breakfast Brunch,13000,4300,17300
18782,18783,21-10-2020 16:03:07.298486,Pollo · Desayunos,Caserito Gourmet,7500,6700,14200
18783,18784,21-10-2020 16:03:07.457386,Pollo · Saludable,Yerbabuena,35000,3900,38900
18784,18785,21-10-2020 16:03:07.716133,Postres,Beiked,35000,4000,39000
18785,18786,21-10-2020 16:03:07.924797,Postres · Desayunos,KOKOA & co.,24300,4700,29000
18786,18787,21-10-2020 16:03:08.283346,Típica,Sabores De Mi Tierra,37900,5400,43300
18787,18788,21-10-2020 16:03:08.692269,Pizza · Italiana,Pisapore - Pizza,31800,6600,38400
18788,18789,21-10-2020 16:03:09.100768,Típica · Parrilla,Parrilla Farandula Gourmet,15000,5100,20100
18789,18790,21-10-2020 16:03:09.509259,Desayunos,Jacinta Arepas de Huevo,27800,4000,31800
18790,18791,21-10-2020 16:03:09.867143,Típica,Cabrito Santandereano,35000,6600,41600
18791,18792,21-10-2020 16:03:10.075382,Crepes,La Chabatta,15000,5900,20900
18792,18793,21-10-2020 16:03:10.483016,Saludable · Desayunos,Copacabana Açai Bowls,23000,3000,26000
18793,18794,21-10-2020 16:03:10.891844,Desayunos,El Fogón Castellano,23000,3200,26200
18794,18795,21-10-2020 16:03:11.300789,Desayunos · Típica,D´Porco,45800,3900,49700
18795,18796,21-10-2020 16:03:11.710084,Desayunos · Mexicana,La Mera Mera - Mexicana,27800,3100,30900
18796,18797,21-10-2020 16:03:12.019077,Saludable · Desayunos,Malú,29500,3700,33200
18797,18798,21-10-2020 16:03:12.178317,Parrilla,Campocina,15600,4600,20200
18798,18799,21-10-2020 16:03:12.437352,Típica · Pescados y Mariscos,Arroces Mrg,53400,4300,57700
18799,18800,21-10-2020 16:03:12.846589,Saludable · Desayunos,Copacabana Açai Bowls,37900,3000,40900
18800,18801,21-10-2020 16:03:13.104999,Desayunos · Típica,D'Porco - Lechona,39700,6300,46000
18801,18802,21-10-2020 16:03:13.514358,Desayunos · Típica,Calentao Express,35000,6000,41000
18802,18803,21-10-2020 16:03:13.723412,Típica,La Herencia,27800,5900,33700
18803,18804,21-10-2020 16:03:13.982235,Pollo · Típica,Auyama,45800,3900,49700
18804,18805,21-10-2020 16:03:14.390163,Pizza · Italiana,Pisapore - Pizza,39700,6600,46300
18805,18806,21-10-2020 16:03:14.548684,Sánduches · Pescados y Mariscos,Pacific Comida de Mar,65000,4000,69000
18806,18807,21-10-2020 16:03:14.857365,Desayunos · Típica,Desayunadero de la 42,53400,5900,59300
18807,18808,21-10-2020 16:03:15.165783,Saludable · Típica,Sopas Mrg,65000,3100,68100
18808,18809,21-10-2020 16:03:15.425346,Saludable · Jugos y Batidos,Berdes Drinks & Salads,48750,3500,52250
18809,18810,21-10-2020 16:03:15.734350,Hamburguesas · Panadería,NYC Burgers,37900,6200,44100
18810,18811,21-10-2020 16:03:15.942703,Típica,La Cocina,8900,4600,13500
18811,18812,21-10-2020 16:03:16.150939,Parrilla,Restaurante Bar Mi Ranchito,53400,5200,58600
18812,18813,21-10-2020 16:03:16.408962,Desayunos · Jugos y Batidos,Kuriwaji,35000,6300,41300
18813,18814,21-10-2020 16:03:16.567551,Típica · Parrilla,Mi Ranchito Parrilla,39700,4400,44100
18814,18815,21-10-2020 16:03:16.876130,Desayunos · Panadería,Premium Break Bakery,15600,3700,19300
18815,18816,21-10-2020 16:03:17.034684,Desayunos · Parrilla,Mi Patria,27800,4600,32400
18816,18817,21-10-2020 16:03:17.443872,Parrilla,Carnes la Zarza,10700,4900,15600
18817,18818,21-10-2020 16:03:17.753061,Desayunos · Panadería,Santa Juana Food Bar,45800,5900,51700
18818,18819,21-10-2020 16:03:18.161950,Desayunos · Café,El Gualilo,8900,6200,15100
18819,18820,21-10-2020 16:03:18.571249,Desayunos · Típica,Peninsula Calentados y Parrilla,45800,3400,49200
18820,18821,21-10-2020 16:03:18.830264,Parrilla · Café,Figaro Café/ Restaurante Argentino,12500,5800,18300
18821,18822,21-10-2020 16:03:19.188913,Internacional,Rio Sabores y Experiencias,12500,4100,16600
18822,18823,21-10-2020 16:03:19.597447,Desayunos · Típica,Calentao Express,11870,6000,17870
18823,18824,21-10-2020 16:03:19.806753,Comida Rápida · Perros Calientes,Similoa - Comida Rapida,24200,3700,27900
18824,18825,21-10-2020 16:03:20.215847,Parrilla,Rústico Picadería,7500,3800,11300
18825,18826,21-10-2020 16:03:20.525349,Desayunos,Fratelli - Desayunos,37900,4600,42500
18826,18827,21-10-2020 16:03:20.684783,Pollo · Pescados y Mariscos,Bang Bang Rice,35000,3400,38400
18827,18828,21-10-2020 16:03:21.043357,Postres · Desayunos,Sweet Tale,37900,5800,43700
18828,18829,21-10-2020 16:03:21.302659,Café · Helados,Sofia heladería y café,29500,5800,35300
18829,18830,21-10-2020 16:03:21.561640,Pollo · Desayunos,Piaf,24300,6500,30800
18830,18831,21-10-2020 16:03:21.771787,Sushi,Sushi Reel,48750,4700,53450
18831,18832,21-10-2020 16:03:22.031456,Desayunos · Típica,Casa Vieja,35000,6000,41000
18832,18833,21-10-2020 16:03:22.240863,Desayunos,Archies Desayunos,23000,3100,26100
18833,18834,21-10-2020 16:03:22.398995,Postres,La Tertulia,35000,3400,38400
18834,18835,21-10-2020 16:03:22.657943,Internacional,La Esquina con Sabor Parrilla,23000,3000,26000
18835,18836,21-10-2020 16:03:22.917431,Postres · Desayunos,Vivalight Market.,48750,6500,55250
18836,18837,21-10-2020 16:03:23.126272,Pollo · Desayunos,Caserito Gourmet,65000,6700,71700
18837,18838,21-10-2020 16:03:23.285021,Desayunos · Comida Rápida,Chocolatto,24300,3400,27700
18838,18839,21-10-2020 16:03:23.544443,Típica,Cabrito Santandereano,15000,6600,21600
18839,18840,21-10-2020 16:03:23.952952,Saludable · Parrilla,Box,27800,3700,31500
18840,18841,21-10-2020 16:03:24.311374,Desayunos,Fratelli - Desayunos,29500,4600,34100
18841,18842,21-10-2020 16:03:24.470645,Desayunos · Empanadas,Empanadas Doraditas.com,13600,3000,16600
18842,18843,21-10-2020 16:03:24.879004,Pollo · Saludable,Gratina,27800,4200,32000
18843,18844,21-10-2020 16:03:25.037521,Desayunos · Italiana,Rceta By Rausch,29500,3600,33100
18844,18845,21-10-2020 16:03:25.446638,Desayunos,Jacinta Arepas de Huevo,53900,4000,57900
18845,18846,21-10-2020 16:03:25.656182,Desayunos · Mexicana,La Mera Mera - Mexicana,11870,3100,14970
18846,18847,21-10-2020 16:03:25.813455,Desayunos,Señor Desayuno,31800,6800,38600
18847,18848,21-10-2020 16:03:26.171731,Desayunos · Típica,Casa Vieja,15600,6000,21600
18848,18849,21-10-2020 16:03:26.380349,Desayunos · Panadería,Le Pain Quotidien,24200,3900,28100
18849,18850,21-10-2020 16:03:26.640253,Pollo · Saludable,Yerbabuena,65000,3900,68900
18850,18851,21-10-2020 16:03:26.900190,Típica,Sabrosito,53900,4000,57900
18851,18852,21-10-2020 16:03:27.159574,Desayunos,Jacinta Arepas de Huevo,13000,4000,17000
18852,18853,21-10-2020 16:03:27.568513,Hamburguesas · Pescados y Mariscos,El Velero,53400,6500,59900
18853,18854,21-10-2020 16:03:27.726841,Saludable · Desayunos,Agua Dulce,10700,3700,14400
18854,18855,21-10-2020 16:03:28.035010,Hamburguesas,Bendito Cordero,24200,5800,30000
18855,18856,21-10-2020 16:03:28.244313,Postres,Levelma,15600,6200,21800
18856,18857,21-10-2020 16:03:28.552358,Típica,Campo Victoria,70000,3000,73000
18857,18858,21-10-2020 16:03:28.861225,Sánduches · Pescados y Mariscos,Pacific Comida de Mar,24300,4000,28300
18858,18859,21-10-2020 16:03:29.070131,Típica · Parrilla,Mi Ranchito Parrilla,23000,4400,27400
18859,18860,21-10-2020 16:03:29.429973,Desayunos · Panadería,Choclofee,24200,4700,28900
18860,18861,21-10-2020 16:03:29.839733,Jugos y Batidos,Pomponio,53400,3600,57000
18861,18862,21-10-2020 16:03:30.148500,Hamburguesas,Gofi Burger,70000,5100,75100
18862,18863,21-10-2020 16:03:30.457822,Postres · Saludable,Ana Rebana,39700,6300,46000
18863,18864,21-10-2020 16:03:30.616485,Desayunos · Helados,San Giorgio Gelateria,27800,3100,30900
18864,18865,21-10-2020 16:03:30.775411,Desayunos · Típica,D'Porco - Lechona,11870,6300,18170
18865,18866,21-10-2020 16:03:30.983768,Desayunos · Típica,Alce,53900,4900,58800
18866,18867,21-10-2020 16:03:31.192554,Típica,El Mondongo y Mucho Mas,65000,5600,70600
18867,18868,21-10-2020 16:03:31.551709,Hamburguesas,Monchis - Hamburguesa,37900,4300,42200
18868,18869,21-10-2020 16:03:31.711328,Parrilla,Arroces Maria Paula,13600,6800,20400
18869,18870,21-10-2020 16:03:32.120547,Saludable · Desayunos,La Cesta,24300,4700,29000
18870,18871,21-10-2020 16:03:32.528906,Desayunos · Panadería,Limarys,7500,6500,14000
18871,18872,21-10-2020 16:03:32.888300,Pizza,Pastas Laurentina,7500,4800,12300
18872,18873,21-10-2020 16:03:33.146248,Desayunos,Don Leo,45800,6000,51800
18873,18874,21-10-2020 16:03:33.304761,Desayunos,Cafetería el Kippe,9000,3200,12200
18874,18875,21-10-2020 16:03:33.664297,Saludable · Desayunos,Re.al Alimentos Reales,7500,4000,11500
18875,18876,21-10-2020 16:03:33.973337,Hamburguesas · Panadería,NYC Burgers,13000,6200,19200
18876,18877,21-10-2020 16:03:34.331452,Saludable,A2manos,24300,4200,28500
18877,18878,21-10-2020 16:03:34.640528,Desayunos · Típica,La Frijolada,15600,4500,20100
18878,18879,21-10-2020 16:03:34.898531,Postres · Café,Loló Coffee & Snacks,12500,4600,17100
18879,18880,21-10-2020 16:03:35.307928,Postres · Helados,Mahé,48750,6000,54750
18880,18881,21-10-2020 16:03:35.666811,Típica,Cabrito Santandereano,29500,6600,36100
18881,18882,21-10-2020 16:03:36.026455,Saludable · Desayunos,Raices Bienestar Gourmet,35000,6600,41600
18882,18883,21-10-2020 16:03:36.335220,Saludable,Hanai - Bowls Saludables,31800,5900,37700
18883,18884,21-10-2020 16:03:36.594944,Típica,Cazuelitas 93,65000,3900,68900
18884,18885,21-10-2020 16:03:36.852464,Desayunos · Típica,Calentao Express,13600,6000,19600
18885,18886,21-10-2020 16:03:37.061283,Desayunos · Panadería,Juliana Restaurante,35000,6100,41100
18886,18887,21-10-2020 16:03:37.420391,Postres · Café,Celestino Café,18900,5900,24800
18887,18888,21-10-2020 16:03:37.729180,Pizza,pizza andante,39700,4200,43900
18888,18889,21-10-2020 16:03:37.986503,Saludable,The Good Rice Bowls,27800,3500,31300
18889,18890,21-10-2020 16:03:38.296184,Desayunos · Panadería,El Pan de Phillippe,29500,4600,34100
18890,18891,21-10-2020 16:03:38.705077,Desayunos · Típica,Cochon,13600,3300,16900
18891,18892,21-10-2020 16:03:39.062937,Típica,Juan Chorizo,7500,3900,11400
18892,18893,21-10-2020 16:03:39.471455,Saludable · Desayunos,Básico y Elemental,34500,5900,40400
18893,18894,21-10-2020 16:03:39.830829,Asiática,TeT,24300,5900,30200
18894,18895,21-10-2020 16:03:40.089767,Sushi · Asiática,Tu Sushi,35000,6400,41400
18895,18896,21-10-2020 16:03:40.399007,Mexicana,Mexicanachos,45800,3900,49700
18896,18897,21-10-2020 16:03:40.557574,Desayunos · Típica,D´Porco,31800,3900,35700
18897,18898,21-10-2020 16:03:40.815779,Postres · Café,Loló Coffee & Snacks,35000,4600,39600
18898,18899,21-10-2020 16:03:41.124380,Desayunos · Parrilla,Mi Patria,24200,4600,28800
18899,18900,21-10-2020 16:03:41.382998,Pollo · Típica,Auyama,70000,3900,73900
18900,18901,21-10-2020 16:03:41.743413,Saludable · Parrilla,Box,53900,3700,57600
18901,18902,21-10-2020 16:03:42.153582,Postres · Desayunos,Cosmo Cookies,10700,5900,16600
18902,18903,21-10-2020 16:03:42.463575,Típica,Cabrito Santandereano,53400,6600,60000
18903,18904,21-10-2020 16:03:42.622047,Postres · Café,Celestino Café,10700,5900,16600
18904,18905,21-10-2020 16:03:42.831451,Hamburguesas,Monchis - Hamburguesa,23000,4300,27300
18905,18906,21-10-2020 16:03:43.039336,Peruana · Internacional,La Chifería,48750,6600,55350
18906,18907,21-10-2020 16:03:43.197783,Desayunos,Bagel Shop,27800,3200,31000
18907,18908,21-10-2020 16:03:43.606331,Panadería,Boul,39700,3100,42800
18908,18909,21-10-2020 16:03:43.865501,Pollo · Saludable,Yerbabuena,70000,3900,73900
18909,18910,21-10-2020 16:03:44.276205,Desayunos · Típica,Desayunadero de la 42,35000,5900,40900
18910,18911,21-10-2020 16:03:44.484763,Postres,Levelma,13600,6200,19800
18911,18912,21-10-2020 16:03:44.894397,Típica,Lo Nuestro,17800,3100,20900
18912,18913,21-10-2020 16:03:45.153274,Típica,Bendita S,35000,4600,39600
18913,18914,21-10-2020 16:03:45.463049,Saludable,Ventura Soup y Salad,39700,3800,43500
18914,18915,21-10-2020 16:03:45.721779,Pollo · Desayunos,Workzone,65000,3100,68100
18915,18916,21-10-2020 16:03:45.980577,Saludable · Desayunos,Libre de Culpa,48750,4000,52750
18916,18917,21-10-2020 16:03:46.189706,Parrilla,Arroces Maria Paula,11870,6800,18670
18917,18918,21-10-2020 16:03:46.348173,Pollo · Saludable,Yerbabuena,27800,3900,31700
18918,18919,21-10-2020 16:03:46.606899,Típica · Parrilla,Typykos,39700,6000,45700
18919,18920,21-10-2020 16:03:47.015303,Desayunos · Panadería,Juliana Restaurante,10700,6100,16800
18920,18921,21-10-2020 16:03:47.174378,Saludable,Ventura Soup y Salad,23000,3800,26800
18921,18922,21-10-2020 16:03:47.485512,Hamburguesas,Burger Society,15600,4100,19700
18922,18923,21-10-2020 16:03:47.694157,Saludable,Hanai - Bowls Saludables,23000,5900,28900
18923,18924,21-10-2020 16:03:47.902948,Saludable · Típica,Saludable Mrg,23000,5800,28800
18924,18925,21-10-2020 16:03:48.312381,Desayunos,Señor Desayuno,53900,6800,60700
18925,18926,21-10-2020 16:03:48.671587,Desayunos · Mexicana,La Mera Mera - Mexicana,24200,3100,27300
18926,18927,21-10-2020 16:03:48.979752,Saludable · Desayunos,Re.al Alimentos Reales,13600,4000,17600
18927,18928,21-10-2020 16:03:49.289394,Desayunos · Panadería,Santa Juana Food Bar,24200,5900,30100
18928,18929,21-10-2020 16:03:49.697061,Saludable,Ventura Soup y Salad,7500,3800,11300
18929,18930,21-10-2020 16:03:50.105559,Desayunos · Sánduches,Frutos del Bosque,29500,3500,33000
18930,18931,21-10-2020 16:03:50.514392,Hamburguesas,Bendito Cordero,48750,5800,54550
18931,18932,21-10-2020 16:03:50.873815,Pollo · Desayunos,Abasto,35000,3600,38600
18932,18933,21-10-2020 16:03:51.282012,Desayunos · Café,Moramia,8900,4700,13600
18933,18934,21-10-2020 16:03:51.491305,Pollo · Desayunos,Abasto,31800,3600,35400
18934,18935,21-10-2020 16:03:51.800270,Desayunos · Helados,San Giorgio Gelateria,24300,3100,27400
18935,18936,21-10-2020 16:03:52.159736,Desayunos · Café,Matchacha,48750,5900,54650
18936,18937,21-10-2020 16:03:52.570062,Desayunos · Jugos y Batidos,Kuriwaji,24300,6300,30600
18937,18938,21-10-2020 16:03:52.729507,Hamburguesas · Alitas,Beer,34500,6600,41100
18938,18939,21-10-2020 16:03:52.887707,Desayunos · Pescados y Mariscos,Gypsy Bistro,35000,4500,39500
18939,18940,21-10-2020 16:03:53.246852,Hamburguesas · Alitas,Beer,8900,6600,15500
18940,18941,21-10-2020 16:03:53.506568,Saludable · Desayunos,Distrito Gourmet,65000,3700,68700
18941,18942,21-10-2020 16:03:53.765517,Desayunos · Comida Rápida,Chocolatto,13000,3400,16400
18942,18943,21-10-2020 16:03:53.923368,Pollo · Típica,Auyama,9000,3900,12900
18943,18944,21-10-2020 16:03:54.281495,Postres · Café,Celestino Café,17800,5900,23700
18944,18945,21-10-2020 16:03:54.540789,Desayunos · Típica,90 Calentados,15600,3700,19300
18945,18946,21-10-2020 16:03:54.800232,Saludable,Ventura Soup y Salad,15600,3800,19400
18946,18947,21-10-2020 16:03:55.208480,Pescados y Mariscos,Pescadero Héroes del Mar,65000,6600,71600
18947,18948,21-10-2020 16:03:55.418248,Helados,Buon Gelato,65000,4400,69400
18948,18949,21-10-2020 16:03:55.727500,Parrilla,OAK Ahumado y Brebajes,15000,6000,21000
18949,18950,21-10-2020 16:03:55.986081,Típica,La Cocina,15600,4600,20200
18950,18951,21-10-2020 16:03:56.395527,Mexicana,Cantina La 15,11870,4300,16170
18951,18952,21-10-2020 16:03:56.555306,Saludable · Desayunos,Raices Bienestar Gourmet,27800,6600,34400
18952,18953,21-10-2020 16:03:56.964153,Saludable · Desayunos,Fresh Co,23000,5600,28600
18953,18954,21-10-2020 16:03:57.123280,Postres · Desayunos,Maria Luisa - Postres,48750,4300,53050
18954,18955,21-10-2020 16:03:57.433357,Típica · Parrilla,Toya,29500,4200,33700
18955,18956,21-10-2020 16:03:57.592922,Postres · Café,Loló Coffee & Snacks,70000,4600,74600
18956,18957,21-10-2020 16:03:57.852355,Desayunos · Café,Aromacafé el Placer de Compartir,31800,5000,36800
18957,18958,21-10-2020 16:03:58.061267,Típica · Pescados y Mariscos,Arroces Mrg,8900,4300,13200
18958,18959,21-10-2020 16:03:58.320548,Desayunos · Panadería,Pasteleite,53900,5900,59800
18959,18960,21-10-2020 16:03:58.530067,Saludable,A2manos,13000,4200,17200
18960,18961,21-10-2020 16:03:58.739443,Jugos y Batidos,Pomponio,8900,3600,12500
18961,18962,21-10-2020 16:03:58.948827,Saludable · Desayunos,La Cesta,65000,4700,69700
18962,18963,21-10-2020 16:03:59.258093,Típica,Sopitas y Más,35000,4200,39200
18963,18964,21-10-2020 16:03:59.417298,Desayunos · Típica,Desayunadero de la 42,24200,5900,30100
18964,18965,21-10-2020 16:03:59.576244,Hamburguesas · Saludable,Restaurant Inn,17800,6100,23900
18965,18966,21-10-2020 16:03:59.885847,Café · Helados,Sofia heladería y café,23000,5800,28800
18966,18967,21-10-2020 16:04:00.195347,Típica,Cabrito Santandereano,37900,6600,44500
18967,18968,21-10-2020 16:04:00.454885,Saludable · Desayunos,Raices Bienestar Gourmet,24200,6600,30800
18968,18969,21-10-2020 16:04:00.664396,Desayunos · Panadería,Santa Juana Food Bar,24200,5900,30100
18969,18970,21-10-2020 16:04:00.923541,Mexicana,Mexicanachos,53900,3900,57800
18970,18971,21-10-2020 16:04:01.281752,Saludable · Desayunos,La Estampilla,27800,6000,33800
18971,18972,21-10-2020 16:04:01.591026,Desayunos · Sánduches,Garnish,35000,5200,40200
18972,18973,21-10-2020 16:04:01.799952,Crepes,San Crepes,34500,4900,39400
18973,18974,21-10-2020 16:04:02.009386,Pollo,Chicken House,29500,4200,33700
18974,18975,21-10-2020 16:04:02.168287,Saludable · Desayunos,Raices Bienestar Gourmet,23000,6600,29600
18975,18976,21-10-2020 16:04:02.526736,Italiana,F*cking Good Pizza,23000,4200,27200
18976,18977,21-10-2020 16:04:02.835603,Desayunos · Típica,Alce,15600,4900,20500
18977,18978,21-10-2020 16:04:03.095334,Desayunos · Italiana,Rceta By Rausch,70000,3600,73600
18978,18979,21-10-2020 16:04:03.354159,Pizza,Pastas Laurentina,23000,4800,27800
18979,18980,21-10-2020 16:04:03.664407,Postres · Café,Loló Coffee & Snacks,9000,4600,13600
18980,18981,21-10-2020 16:04:03.973044,Desayunos · Típica,Desayunadero de la 42,13000,5900,18900
18981,18982,21-10-2020 16:04:04.331953,Postres,La Tertulia,29500,3400,32900
18982,18983,21-10-2020 16:04:04.491517,Típica · Parrilla,El Portal de la Antigua,48750,5600,54350
18983,18984,21-10-2020 16:04:04.751225,Típica,Campo Victoria,13000,3000,16000
18984,18985,21-10-2020 16:04:05.109450,Postres · Desayunos,Amelie Helados,15000,6400,21400
18985,18986,21-10-2020 16:04:05.419300,Saludable · Desayunos,Bon Eat - Saludable,45800,4800,50600
18986,18987,21-10-2020 16:04:05.827943,Saludable · Desayunos,La Estampilla,37900,6000,43900
18987,18988,21-10-2020 16:04:06.137644,Desayunos · Típica,D'Porco - Lechona,35000,6300,41300
18988,18989,21-10-2020 16:04:06.346961,Típica · Parrilla,Mi Ranchito Parrilla,35000,4400,39400
18989,18990,21-10-2020 16:04:06.606594,Desayunos · Jugos y Batidos,Dont Be Hungry,18900,5600,24500
18990,18991,21-10-2020 16:04:06.765661,Mexicana,Hidalgo Taquería,15000,4900,19900
18991,18992,21-10-2020 16:04:06.974229,Desayunos · Italiana,Rceta By Rausch,29500,3600,33100
18992,18993,21-10-2020 16:04:07.233558,Desayunos · Café,Libertario Coffee Roasters,8900,4600,13500
18993,18994,21-10-2020 16:04:07.542372,Saludable · Desayunos,Fresh Co,65000,5600,70600
18994,18995,21-10-2020 16:04:07.701368,Típica,La Cocina,48750,4600,53350
18995,18996,21-10-2020 16:04:08.061538,Desayunos · Típica,Papadió - Colombianas,27800,5700,33500
18996,18997,21-10-2020 16:04:08.471638,Desayunos,Jacinta Arepas de Huevo,39700,4000,43700
18997,18998,21-10-2020 16:04:08.781883,Típica,Carbón & Mondongos,35000,6400,41400
18998,18999,21-10-2020 16:04:09.191539,Postres · Saludable,Ana Rebana,35000,6300,41300
18999,19000,21-10-2020 16:04:09.552359,Saludable · Desayunos,Maracuyá,7500,6700,14200
19000,19001,21-10-2020 16:04:09.961934,Desayunos · Café,Norma's Ice Cream Café,10700,6300,17000
19001,19002,21-10-2020 16:04:10.372300,Saludable · Parrilla,The Angels Grill and Drinks,11870,6200,18070
19002,19003,21-10-2020 16:04:10.732109,Pollo · China,China Tao,27800,3500,31300
19003,19004,21-10-2020 16:04:10.942343,Típica · Pescados y Mariscos,La Vitualla,11870,6300,18170
19004,19005,21-10-2020 16:04:11.252151,Típica,Carbón & Mondongos,65000,6400,71400
19005,19006,21-10-2020 16:04:11.461809,Desayunos · Jugos y Batidos,Kuriwaji,7500,6300,13800
19006,19007,21-10-2020 16:04:11.672571,Parrilla · Internacional,Taperia de la Plaza,24300,5700,30000
19007,19008,21-10-2020 16:04:11.931094,Pizza · Italiana,Pisapore - Pizza,29500,6600,36100
19008,19009,21-10-2020 16:04:12.140353,Sánduches,Submarin,37900,3800,41700
19009,19010,21-10-2020 16:04:12.449258,Saludable,Ventura Soup y Salad,24200,3800,28000
19010,19011,21-10-2020 16:04:12.857448,Postres,La Tertulia,39700,3400,43100
19011,19012,21-10-2020 16:04:13.268591,Parrilla,Parrilla Pimentón,35000,3400,38400
19012,19013,21-10-2020 16:04:13.577498,Desayunos · Italiana,Rceta By Rausch,11870,3600,15470
19013,19014,21-10-2020 16:04:13.885438,Italiana,Bocatto Di Passo,65000,5000,70000
19014,19015,21-10-2020 16:04:14.245107,Sánduches · China,Peru Mix,37900,5900,43800
19015,19016,21-10-2020 16:04:14.405114,Café · Helados,Sofia heladería y café,7500,5800,13300
19016,19017,21-10-2020 16:04:14.713528,Perros Calientes,Dog Shop - Rapida,18900,4900,23800
19017,19018,21-10-2020 16:04:14.972035,Parrilla,Arroces Maria Paula,29500,6800,36300
19018,19019,21-10-2020 16:04:15.231331,Típica,Campo Victoria,39700,3000,42700
19019,19020,21-10-2020 16:04:15.590880,Desayunos · Pescados y Mariscos,Luzí­a - Mediterranea,8900,5700,14600
19020,19021,21-10-2020 16:04:16.000285,Desayunos · Helados,San Giorgio Gelateria,12500,3100,15600
19021,19022,21-10-2020 16:04:16.309580,Parrilla,Beraca Parrilla Bbq,35000,5600,40600
19022,19023,21-10-2020 16:04:16.618590,Hamburguesas · Alitas,Beer,70000,6600,76600
19023,19024,21-10-2020 16:04:16.826821,Postres · Panadería,RIGHT AWAY FOODS,53400,6600,60000
19024,19025,21-10-2020 16:04:17.135895,Postres · Desayunos,Maria Luisa - Postres,53400,4300,57700
19025,19026,21-10-2020 16:04:17.545409,Desayunos,La Frijolada Desayunos,27800,4400,32200
19026,19027,21-10-2020 16:04:17.754129,Jugos y Batidos,Pomponio,8900,3600,12500
19027,19028,21-10-2020 16:04:17.962468,Saludable · Desayunos,Maracuyá,29500,6700,36200
19028,19029,21-10-2020 16:04:18.120637,Desayunos · Comida Rápida,La Veneca,48750,6300,55050
19029,19030,21-10-2020 16:04:18.381282,Parrilla,Campocina,17800,4600,22400
19030,19031,21-10-2020 16:04:18.790439,Desayunos · Panadería,Santa Juana Food Bar,17800,5900,23700
19031,19032,21-10-2020 16:04:18.999471,Desayunos · Típica,90 Calentados,11870,3700,15570
19032,19033,21-10-2020 16:04:19.208811,Típica · Pescados y Mariscos,La Vitualla,12500,6300,18800
19033,19034,21-10-2020 16:04:19.567718,Típica · Parrilla,Mi Ranchito Parrilla,53400,4400,57800
19034,19035,21-10-2020 16:04:19.876219,Pollo · Desayunos,Workzone,24200,3100,27300
19035,19036,21-10-2020 16:04:20.184890,Desayunos,La Frijolada Desayunos,13000,4400,17400
19036,19037,21-10-2020 16:04:20.494286,Desayunos · Típica,Parrilla Farandula Típico,9000,5900,14900
19037,19038,21-10-2020 16:04:20.703776,Sushi · Asiática,Tu Sushi,45800,6400,52200
19038,19039,21-10-2020 16:04:21.062342,Desayunos · Típica,Alce,11870,4900,16770
19039,19040,21-10-2020 16:04:21.321950,Postres · Saludable,Ana Rebana,53900,6300,60200
19040,19041,21-10-2020 16:04:21.731143,Panadería,Boul,15600,3100,18700
19041,19042,21-10-2020 16:04:21.941241,Típica,Salsig,18900,5600,24500
19042,19043,21-10-2020 16:04:22.350169,Saludable · Desayunos,Maracuyá,13000,6700,19700
19043,19044,21-10-2020 16:04:22.709736,Postres · Café,Celestino Café,13000,5900,18900
19044,19045,21-10-2020 16:04:23.119233,Desayunos · Café,Frambas,37900,3400,41300
19045,19046,21-10-2020 16:04:23.378653,Saludable · Desayunos,Básico y elemental,39700,5000,44700
19046,19047,21-10-2020 16:04:23.738430,Pizza,Pizza Andante,17800,6300,24100
19047,19048,21-10-2020 16:04:24.099513,Italiana,F*cking Good Pizza,15000,4200,19200
19048,19049,21-10-2020 16:04:24.259942,Saludable · Desayunos,Copacabana Açai Bowls,24200,3000,27200
19049,19050,21-10-2020 16:04:24.620146,Sushi,Umi,65000,5600,70600
19050,19051,21-10-2020 16:04:24.929394,Parrilla,Rústico Picadería,12500,3800,16300
19051,19052,21-10-2020 16:04:25.139278,Desayunos · Panadería,Santa Juana Food Bar,53900,5900,59800
19052,19053,21-10-2020 16:04:25.499074,Saludable · Parrilla,The Angels Grill and Drinks,8900,6200,15100
19053,19054,21-10-2020 16:04:25.857930,Desayunos · Empanadas,Mis Delicias,8900,3200,12100
19054,19055,21-10-2020 16:04:26.067767,Desayunos · Empanadas,Mis Delicias,24200,3200,27400
19055,19056,21-10-2020 16:04:26.427290,Saludable · Desayunos,Malú,45800,3700,49500
19056,19057,21-10-2020 16:04:26.636430,Desayunos · Panadería,Pasteleite,34500,5900,40400
19057,19058,21-10-2020 16:04:26.846311,Crepes,La Chabatta,27800,5900,33700
19058,19059,21-10-2020 16:04:27.055563,Saludable · Desayunos,Malú,48750,3700,52450
19059,19060,21-10-2020 16:04:27.364506,Perros Calientes,Dog Shop - Rapida,34500,4900,39400
19060,19061,21-10-2020 16:04:27.773180,Típica,Baondish,45800,5800,51600
19061,19062,21-10-2020 16:04:28.182804,Saludable · Desayunos,Agua Dulce,9000,3700,12700
19062,19063,21-10-2020 16:04:28.592561,Postres · Desayunos,Cosmo Cookies,7500,5900,13400
19063,19064,21-10-2020 16:04:28.751275,Postres,Levelma,29500,6200,35700
19064,19065,21-10-2020 16:04:28.961428,Típica,La Olla de Barro,13600,5300,18900
19065,19066,21-10-2020 16:04:29.272536,Desayunos · Típica,D'Porco - Lechona,12500,6300,18800
19066,19067,21-10-2020 16:04:29.682629,Saludable · Desayunos,Básico y Elemental,7500,5900,13400
19067,19068,21-10-2020 16:04:30.093382,Desayunos · Panadería,Limarys,23000,6500,29500
19068,19069,21-10-2020 16:04:30.253643,China,China Food Col,35000,3600,38600
19069,19070,21-10-2020 16:04:30.463845,Desayunos · Café,vereda central calle 99,12500,5700,18200
19070,19071,21-10-2020 16:04:30.773408,Postres · Desayunos,Restaurante Cornelia,24200,5500,29700
19071,19072,21-10-2020 16:04:30.931525,Desayunos · Café,vereda central calle 99,29500,5700,35200
19072,19073,21-10-2020 16:04:31.091096,Pollo · Saludable,Gratina,18900,4200,23100
19073,19074,21-10-2020 16:04:31.501569,Desayunos · Típica,Criollomania,13000,5200,18200
19074,19075,21-10-2020 16:04:31.660567,Pollo · Sánduches,Pollos Century,70000,3000,73000
19075,19076,21-10-2020 16:04:31.920493,Típica · Parrilla,Mi Ranchito Parrilla,23000,4400,27400
19076,19077,21-10-2020 16:04:32.180427,Desayunos · Jugos y Batidos,Kuriwaji,35000,6300,41300
19077,19078,21-10-2020 16:04:32.440206,Parrilla,Restaurante Bar Mi Ranchito,24300,5200,29500
19078,19079,21-10-2020 16:04:32.700420,Sushi,Canoa To Go,11870,5900,17770
19079,19080,21-10-2020 16:04:33.110289,Desayunos · Mexicana,La Mera Mera - Mexicana,17800,3100,20900
19080,19081,21-10-2020 16:04:33.320048,Pizza,18 Scalini,37900,4300,42200
19081,19082,21-10-2020 16:04:33.632135,Pollo,Heart & Cooking,31800,5000,36800
19082,19083,21-10-2020 16:04:33.991596,Desayunos · Típica,Cochon,18900,3300,22200
19083,19084,21-10-2020 16:04:34.401954,Desayunos · Típica,Papadió - Colombianas,70000,5700,75700
19084,19085,21-10-2020 16:04:34.811862,Desayunos,Desayunos en Bogotá,31800,3400,35200
19085,19086,21-10-2020 16:04:34.972381,Postres · Café,Loló Coffee & Snacks,13000,4600,17600
19086,19087,21-10-2020 16:04:35.382339,Saludable · Desayunos,La Cesta,23000,4700,27700
19087,19088,21-10-2020 16:04:35.541816,Parrilla,OAK Ahumado y Brebajes,9000,6000,15000
19088,19089,21-10-2020 16:04:35.700932,Típica · Pescados y Mariscos,Arroces Mrg,8900,4300,13200
19089,19090,21-10-2020 16:04:35.960600,Hamburguesas,Gofi Burger,35000,5100,40100
19090,19091,21-10-2020 16:04:36.369169,Saludable · Desayunos,Re.al Alimentos Reales,9000,4000,13000
19091,19092,21-10-2020 16:04:36.578525,Italiana,F*cking Good Pizza,15600,4200,19800
19092,19093,21-10-2020 16:04:36.988826,Típica,Salsig,13000,5600,18600
19093,19094,21-10-2020 16:04:37.249088,Desayunos · Pescados y Mariscos,Gypsy Bistro,18900,4500,23400
19094,19095,21-10-2020 16:04:37.558342,Saludable · Desayunos,Fresh Co,13000,5600,18600
19095,19096,21-10-2020 16:04:37.967937,Desayunos · Panadería,Pasteleite,15000,5900,20900
19096,19097,21-10-2020 16:04:38.227362,Saludable · Desayunos,Libre de Culpa,35000,4000,39000
19097,19098,21-10-2020 16:04:38.487167,Jugos y Batidos,Pomponio,31800,3600,35400
19098,19099,21-10-2020 16:04:38.747839,Típica,Lo Nuestro,29500,3100,32600
19099,19100,21-10-2020 16:04:39.056974,Desayunos · Panadería,Decofruta,15600,4700,20300
19100,19101,21-10-2020 16:04:39.216397,Sushi · Asiática,Arigato,53900,5300,59200
19101,19102,21-10-2020 16:04:39.476920,Pollo,Señor Fantástico,53400,4700,58100
19102,19103,21-10-2020 16:04:39.637308,Internacional,Rio Sabores y Experiencias,35000,4100,39100
19103,19104,21-10-2020 16:04:39.796549,Sushi,Canoa To Go,24300,5900,30200
19104,19105,21-10-2020 16:04:40.006522,Peruana,Uma Cantina Peruana,45800,3200,49000
19105,19106,21-10-2020 16:04:40.215721,Típica,Carbón & Mondongos,35000,6400,41400
19106,19107,21-10-2020 16:04:40.624505,Típica,Juan Chorizo,45800,3900,49700
19107,19108,21-10-2020 16:04:40.883355,Desayunos,Archies Desayunos,11870,3100,14970
19108,19109,21-10-2020 16:04:41.142766,Sushi,Sushi Reel,13600,4700,18300
19109,19110,21-10-2020 16:04:41.502287,Pollo · Saludable,Gratina,53400,4200,57600
19110,19111,21-10-2020 16:04:41.910893,Desayunos · Sánduches,Danilo Colombia,39700,3300,43000
19111,19112,21-10-2020 16:04:42.220432,Sushi,Sushi Reel,31800,4700,36500
19112,19113,21-10-2020 16:04:42.480652,Postres · Desayunos,KOKOA & co.,8900,4700,13600
19113,19114,21-10-2020 16:04:42.740732,Desayunos · Típica,Fogón Sangileño,53900,5000,58900
19114,19115,21-10-2020 16:04:42.999198,Desayunos,Desayunos en Bogotá,53900,3400,57300
19115,19116,21-10-2020 16:04:43.409069,Postres · Desayunos,Protein Bakes,31800,5900,37700
19116,19117,21-10-2020 16:04:43.718444,Hamburguesas,Gofi Burger,18900,5100,24000
19117,19118,21-10-2020 16:04:44.078752,Parrilla,Carnes la Zarza,23000,4900,27900
19118,19119,21-10-2020 16:04:44.337437,Hamburguesas · Alitas,Beer,35000,6600,41600
19119,19120,21-10-2020 16:04:44.497488,Típica,Lo Nuestro,23000,3100,26100
19120,19121,21-10-2020 16:04:44.706523,Pizza · Italiana,Pisapore - Pizza,15000,6600,21600
19121,19122,21-10-2020 16:04:44.916557,Sánduches · Pescados y Mariscos,Pacific Comida de Mar,48750,4000,52750
19122,19123,21-10-2020 16:04:45.226595,Postres,La Galeta,13600,3000,16600
19123,19124,21-10-2020 16:04:45.536086,Hamburguesas,Burger Society,23000,4100,27100
19124,19125,21-10-2020 16:04:45.844529,Desayunos,Fratelli - Desayunos,27800,4600,32400
19125,19126,21-10-2020 16:04:46.254128,Típica,El Mondongo y Mucho Mas,23000,5600,28600
19126,19127,21-10-2020 16:04:46.613275,Postres · Desayunos,Gelateria Da Favola,10700,6500,17200
19127,19128,21-10-2020 16:04:47.022710,Desayunos,Fratelli - Desayunos,8900,4600,13500
19128,19129,21-10-2020 16:04:47.281324,Desayunos · Panadería,Pasteleite,13600,5900,19500
19129,19130,21-10-2020 16:04:47.540621,Postres,Beiked,39700,4000,43700
19130,19131,21-10-2020 16:04:47.798704,Café · Helados,Sofia heladería y café,53900,5800,59700
19131,19132,21-10-2020 16:04:48.107109,Pollo · Saludable,Yerbabuena,27800,3900,31700
19132,19133,21-10-2020 16:04:48.466543,Saludable · Desayunos,La Cesta,7500,4700,12200
19133,19134,21-10-2020 16:04:48.776931,Hamburguesas · Panadería,NYC Burgers,9000,6200,15200
19134,19135,21-10-2020 16:04:48.935734,Saludable · Desayunos,Libre de Culpa,9000,4000,13000
19135,19136,21-10-2020 16:04:49.345657,Típica · Parrilla,Mi Ranchito Parrilla,18900,4400,23300
19136,19137,21-10-2020 16:04:49.705179,Postres · Desayunos,Restaurante Cornelia,34500,5500,40000
19137,19138,21-10-2020 16:04:49.963828,Desayunos · Típica,Peninsula Calentados y Parrilla,39700,3400,43100
19138,19139,21-10-2020 16:04:50.323265,Postres,Beiked,34500,4000,38500
19139,19140,21-10-2020 16:04:50.733043,Desayunos · Panadería,Artesanos,35000,4300,39300
19140,19141,21-10-2020 16:04:50.890912,Saludable · Desayunos,Distrito Gourmet,9000,3700,12700
19141,19142,21-10-2020 16:04:51.201223,Típica,El Cucharón - Tipica,12500,4400,16900
19142,19143,21-10-2020 16:04:51.610450,Postres · Desayunos,Gelateria Da Favola,23000,6500,29500
19143,19144,21-10-2020 16:04:51.870366,Saludable · Típica,Saludable Mrg,24300,5800,30100
19144,19145,21-10-2020 16:04:52.030028,Saludable · Desayunos,Copacabana Açai Bowls,23000,3000,26000
19145,19146,21-10-2020 16:04:52.189222,Desayunos · Panadería,Artesanos,9000,4300,13300
19146,19147,21-10-2020 16:04:52.347644,Saludable · Desayunos,Distrito Gourmet,8900,3700,12600
19147,19148,21-10-2020 16:04:52.557717,Saludable · Desayunos,Agua Dulce,27800,3700,31500
19148,19149,21-10-2020 16:04:52.916744,Típica,Bendita S,24300,4600,28900
19149,19150,21-10-2020 16:04:53.126639,Típica,El Cucharón - Tipica,53400,4400,57800
19150,19151,21-10-2020 16:04:53.436669,Hamburguesas,Monchis - Hamburguesa,7500,4300,11800
19151,19152,21-10-2020 16:04:53.696560,Típica,La Herencia,7500,5900,13400
19152,19153,21-10-2020 16:04:54.056593,Desayunos · Café,Norma's Ice Cream Café,17800,6300,24100
19153,19154,21-10-2020 16:04:54.368003,Saludable,Ventura Soup y Salad,24200,3800,28000
19154,19155,21-10-2020 16:04:54.577962,Alta Cocina · Parrilla,Criterión,8900,6000,14900
19155,19156,21-10-2020 16:04:54.838058,Desayunos · Típica,Peninsula Calentados y Parrilla,23000,3400,26400
19156,19157,21-10-2020 16:04:55.148958,Postres · Helados,Mahé,45800,6000,51800
19157,19158,21-10-2020 16:04:55.559056,Saludable · Desayunos,Guadalupe - Fruteria,29500,5900,35400
19158,19159,21-10-2020 16:04:55.768260,Sushi,Kim Pop,10700,5400,16100
19159,19160,21-10-2020 16:04:56.128225,Parrilla,Coquitas,9000,5600,14600
19160,19161,21-10-2020 16:04:56.438090,Típica,La Cocina,15600,4600,20200
19161,19162,21-10-2020 16:04:56.798199,Desayunos · Panadería,Decofruta,13000,4700,17700
19162,19163,21-10-2020 16:04:56.957935,Postres,Toledo Pastelería,70000,6800,76800
19163,19164,21-10-2020 16:04:57.168407,Desayunos,Señor Desayuno,37900,6800,44700
19164,19165,21-10-2020 16:04:57.528182,Postres,Toledo Pastelería,31800,6800,38600
19165,19166,21-10-2020 16:04:57.888965,Desayunos · Típica,Alce,23000,4900,27900
19166,19167,21-10-2020 16:04:58.299937,Pizza · Italiana,Pisapore - Pizza,34500,6600,41100
19167,19168,21-10-2020 16:04:58.559299,Pizza,pizza andante,10700,4200,14900
19168,19169,21-10-2020 16:04:58.918932,Saludable · Desayunos,Copacabana Açai Bowls,11870,3000,14870
19169,19170,21-10-2020 16:04:59.278924,Pollo · Saludable,Gratina,10700,4200,14900
19170,19171,21-10-2020 16:04:59.489561,Desayunos · Jugos y Batidos,Frutiwow,53400,4100,57500
19171,19172,21-10-2020 16:04:59.749958,Desayunos,El Fogón Castellano,9000,3200,12200
19172,19173,21-10-2020 16:05:00.059388,Sushi,Umi,35000,5600,40600
19173,19174,21-10-2020 16:05:00.419256,Desayunos · Panadería,Choclofee,23000,4700,27700
19174,19175,21-10-2020 16:05:00.728928,Desayunos · Jugos y Batidos,Kuriwaji,48750,6300,55050
19175,19176,21-10-2020 16:05:01.139253,Pollo · Típica,Auyama,9000,3900,12900
19176,19177,21-10-2020 16:05:01.298529,Postres · Desayunos,Maltihelado,35000,4500,39500
19177,19178,21-10-2020 16:05:01.507784,Típica,Sopitas y Más,23000,4200,27200
19178,19179,21-10-2020 16:05:01.768145,Desayunos · Parrilla,Mi Patria,35000,4600,39600
19179,19180,21-10-2020 16:05:01.978019,Saludable,Ventura Soup y Salad,35000,3800,38800
19180,19181,21-10-2020 16:05:02.387818,Jugos y Batidos,Pomponio,15600,3600,19200
19181,19182,21-10-2020 16:05:02.798265,Pollo · Desayunos,Piaf,65000,6500,71500
19182,19183,21-10-2020 16:05:03.007361,Típica · Pescados y Mariscos,Arroces Mrg,34500,4300,38800
19183,19184,21-10-2020 16:05:03.417709,Desayunos · Jugos y Batidos,Frutiwow,15600,4100,19700
19184,19185,21-10-2020 16:05:03.577314,Italiana,F*cking Good Pizza,24300,4200,28500
19185,19186,21-10-2020 16:05:03.737204,Pollo · Desayunos,Candelina,48750,5300,54050
19186,19187,21-10-2020 16:05:03.895913,Desayunos · Empanadas,Mis Delicias,53400,3200,56600
19187,19188,21-10-2020 16:05:04.055068,Café · Helados,Sofia heladería y café,8900,5800,14700
19188,19189,21-10-2020 16:05:04.213700,Pollo · China,China Tao,65000,3500,68500
19189,19190,21-10-2020 16:05:04.372678,Peruana · Internacional,La Chifería,37900,6600,44500
19190,19191,21-10-2020 16:05:04.633500,Pollo · Desayunos,Workzone,34500,3100,37600
19191,19192,21-10-2020 16:05:04.842514,Pollo · Desayunos,Workzone,65000,3100,68100
19192,19193,21-10-2020 16:05:05.051459,Desayunos · Panadería,Pasteleite,15600,5900,21500
19193,19194,21-10-2020 16:05:05.361631,Típica · Pescados y Mariscos,Arroces Mrg,15000,4300,19300
19194,19195,21-10-2020 16:05:05.620260,Saludable · Desayunos,Copacabana Açai Bowls,39700,3000,42700
19195,19196,21-10-2020 16:05:05.981510,Típica,El Mondongo y Mucho Mas,24200,5600,29800
19196,19197,21-10-2020 16:05:06.290799,Parrilla,Campocina,7500,4600,12100
19197,19198,21-10-2020 16:05:06.599640,Desayunos · Típica,Criollomania,12500,5200,17700
19198,19199,21-10-2020 16:05:06.809434,Pollo · China,China Tao,35000,3500,38500
19199,19200,21-10-2020 16:05:07.118000,Postres,La Galeta,48750,3000,51750
19200,19201,21-10-2020 16:05:07.527583,Sushi,Canoa To Go,10700,5900,16600
19201,19202,21-10-2020 16:05:07.838265,Parrilla,Coquitas,15000,5600,20600
19202,19203,21-10-2020 16:05:08.148409,Mexicana,Hidalgo Taquería,24300,4900,29200
19203,19204,21-10-2020 16:05:08.358844,Postres,La Tertulia,48750,3400,52150
19204,19205,21-10-2020 16:05:08.567619,Desayunos · Café,El Gualilo,9000,6200,15200
19205,19206,21-10-2020 16:05:08.925966,Helados,Buon Gelato,13000,4400,17400
19206,19207,21-10-2020 16:05:09.085453,Desayunos · Típica,Cochon,9000,3300,12300
19207,19208,21-10-2020 16:05:09.445462,Desayunos · Panadería,El Pan de Phillippe,23000,4600,27600
19208,19209,21-10-2020 16:05:09.805660,Desayunos · Sánduches,Garnish,48750,5200,53950
19209,19210,21-10-2020 16:05:10.066181,Mexicana,Mexicanachos,29500,3900,33400
19210,19211,21-10-2020 16:05:10.325555,Postres · Desayunos,KOKOA & co.,35000,4700,39700
19211,19212,21-10-2020 16:05:10.535545,Típica,Bandejas Mrg,37900,3800,41700
19212,19213,21-10-2020 16:05:10.946276,Pizza · Italiana,Piatto - Pizza,35000,6600,41600
19213,19214,21-10-2020 16:05:11.256450,Pizza,Pizza Andante,11870,6300,18170
19214,19215,21-10-2020 16:05:11.666053,Desayunos · Típica,La Frijolada,53900,4500,58400
19215,19216,21-10-2020 16:05:11.975946,Hamburguesas · Saludable,Restaurant Inn,9000,6100,15100
19216,19217,21-10-2020 16:05:12.235751,Hamburguesas · Pescados y Mariscos,El Velero,13600,6500,20100
19217,19218,21-10-2020 16:05:12.645844,Desayunos · Panadería,Decofruta,35000,4700,39700
19218,19219,21-10-2020 16:05:12.804928,Parrilla,Arepaisa de Medellín,48750,5600,54350
19219,19220,21-10-2020 16:05:13.114387,Hamburguesas · Alitas,Beer,37900,6600,44500
19220,19221,21-10-2020 16:05:13.374556,Desayunos · Café,Frambas,12500,3400,15900
19221,19222,21-10-2020 16:05:13.585766,Pollo,Señor Fantástico,13000,4700,17700
19222,19223,21-10-2020 16:05:13.995579,Típica · Parrilla,Typykos,15000,6000,21000
19223,19224,21-10-2020 16:05:14.155484,Desayunos · Jugos y Batidos,Kuriwaji,11870,6300,18170
19224,19225,21-10-2020 16:05:14.414667,Pollo · Desayunos,Abasto,65000,3600,68600
19225,19226,21-10-2020 16:05:14.825556,Desayunos · Típica,La Parrilla Dorada Polo,15000,6600,21600
19226,19227,21-10-2020 16:05:15.235378,Italiana,Bocatto Di Passo,31800,5000,36800
19227,19228,21-10-2020 16:05:15.446892,Desayunos · Panadería,Choclofee,23000,4700,27700
19228,19229,21-10-2020 16:05:15.656542,Internacional,La Esquina con Sabor Parrilla,15600,3000,18600
19229,19230,21-10-2020 16:05:15.915294,Pizza · Italiana,Piatto - Pizza,7500,6600,14100
19230,19231,21-10-2020 16:05:16.125867,Hamburguesas · Alitas,Beer,24200,6600,30800
19231,19232,21-10-2020 16:05:16.436412,Típica · Parrilla,Parrilla Farandula Gourmet,23000,5100,28100
19232,19233,21-10-2020 16:05:16.696455,Italiana,F*cking Good Pizza,24300,4200,28500
19233,19234,21-10-2020 16:05:16.956457,Pollo,Señor Fantástico,34500,4700,39200
19234,19235,21-10-2020 16:05:17.216371,Típica · Pescados y Mariscos,Arroces Mrg,9000,4300,13300
19235,19236,21-10-2020 16:05:17.375881,Alta Cocina · Italiana,Trattoria de la Plaza,10700,6000,16700
19236,19237,21-10-2020 16:05:17.535510,Saludable · Desayunos,Distrito Gourmet,18900,3700,22600
19237,19238,21-10-2020 16:05:17.745333,Postres · Desayunos,Maltihelado,48750,4500,53250
19238,19239,21-10-2020 16:05:18.155290,Desayunos,Bagel Shop,23000,3200,26200
19239,19240,21-10-2020 16:05:18.565326,Hamburguesas · Pescados y Mariscos,El Velero,8900,6500,15400
19240,19241,21-10-2020 16:05:18.875106,Saludable,A2manos,45800,4200,50000
19241,19242,21-10-2020 16:05:19.185476,Saludable · Desayunos,Bon Eat - Saludable,11870,4800,16670
19242,19243,21-10-2020 16:05:19.594672,Internacional,La Esquina con Sabor Parrilla,37900,3000,40900
19243,19244,21-10-2020 16:05:20.006474,Desayunos · Típica,90 Calentados,13000,3700,16700
19244,19245,21-10-2020 16:05:20.165846,Típica · Pescados y Mariscos,La Vitualla,24200,6300,30500
19245,19246,21-10-2020 16:05:20.476055,Desayunos · Sánduches,Garnish,15600,5200,20800
19246,19247,21-10-2020 16:05:20.635805,Desayunos,Archies Desayunos,35000,3100,38100
19247,19248,21-10-2020 16:05:21.045588,Postres · Desayunos,Sweet Tale,39700,5800,45500
19248,19249,21-10-2020 16:05:21.406117,Desayunos · Típica,Fogón Sangileño,8900,5000,13900
19249,19250,21-10-2020 16:05:21.815561,Mexicana,Hidalgo Taquería,15600,4900,20500
19250,19251,21-10-2020 16:05:22.026204,Desayunos · Pescados y Mariscos,Luzí­a - Mediterranea,7500,5700,13200
19251,19252,21-10-2020 16:05:22.437978,Postres · Desayunos,Cosmo Cookies,7500,5900,13400
19252,19253,21-10-2020 16:05:22.698792,Típica · Pescados y Mariscos,La Vitualla,24200,6300,30500
19253,19254,21-10-2020 16:05:22.909512,Desayunos · Pescados y Mariscos,Luzí­a - Mediterranea,10700,5700,16400
19254,19255,21-10-2020 16:05:23.069346,Desayunos · Típica,La Parrilla Dorada Polo,18900,6600,25500
19255,19256,21-10-2020 16:05:23.429546,Sánduches,Submarin,17800,3800,21600
19256,19257,21-10-2020 16:05:23.588846,Desayunos · Panadería,Le Pain Quotidien,35000,3900,38900
19257,19258,21-10-2020 16:05:23.949407,Internacional,La Esquina con Sabor Parrilla,35000,3000,38000
19258,19259,21-10-2020 16:05:24.209808,Pollo · Desayunos,Caserito Gourmet,8900,6700,15600
19259,19260,21-10-2020 16:05:24.569456,Desayunos · Sánduches,Garnish,9000,5200,14200
19260,19261,21-10-2020 16:05:24.929802,Típica,Campo Victoria,10700,3000,13700
19261,19262,21-10-2020 16:05:25.090773,Típica,Baondish,53900,5800,59700
19262,19263,21-10-2020 16:05:25.300450,Típica,Sopitas y Más,17800,4200,22000
19263,19264,21-10-2020 16:05:25.660913,Saludable · Desayunos,Guadalupe - Fruteria,13600,5900,19500
19264,19265,21-10-2020 16:05:25.820272,Típica,Bendita S,9000,4600,13600
19265,19266,21-10-2020 16:05:26.130363,Saludable,Amor Propio saludable,35000,4000,39000
19266,19267,21-10-2020 16:05:26.446755,Desayunos · Café,Aromacafé el Placer de Compartir,24300,5000,29300
19267,19268,21-10-2020 16:05:26.709975,Típica · Parrilla,El Santandereano,34500,5200,39700
19268,19269,21-10-2020 16:05:26.869763,Parrilla,Arroces Maria Paula,48750,6800,55550
19269,19270,21-10-2020 16:05:27.280359,Parrilla · Café,Figaro Café/ Restaurante Argentino,18900,5800,24700
19270,19271,21-10-2020 16:05:27.539773,Postres · Desayunos,Jacques Pastelería,35000,5900,40900
19271,19272,21-10-2020 16:05:27.700264,Típica · Parrilla,Parrilla Farandula Gourmet,39700,5100,44800
19272,19273,21-10-2020 16:05:28.059645,Típica,Juan Chorizo,53900,3900,57800
19273,19274,21-10-2020 16:05:28.218792,Sushi,Canoa To Go,24200,5900,30100
19274,19275,21-10-2020 16:05:28.579760,Pescados y Mariscos,La Gran Cazuela,24300,3200,27500
19275,19276,21-10-2020 16:05:28.738899,Desayunos · Jugos y Batidos,Frutiwow,23000,4100,27100
19276,19277,21-10-2020 16:05:28.999202,Mexicana,Hidalgo Taquería,35000,4900,39900
19277,19278,21-10-2020 16:05:29.159237,Desayunos · Café,Aromacafé el Placer de Compartir,45800,5000,50800
19278,19279,21-10-2020 16:05:29.570607,Saludable · Desayunos,Básico y Elemental,53900,5900,59800
19279,19280,21-10-2020 16:05:29.881399,Típica,El Cucharón - Tipica,13600,4400,18000
19280,19281,21-10-2020 16:05:30.293226,Desayunos · Típica,La Frijolada,24300,4500,28800
19281,19282,21-10-2020 16:05:30.553494,Saludable · Típica,Saludable Mrg,35000,5800,40800
19282,19283,21-10-2020 16:05:30.763186,Desayunos · Jugos y Batidos,Dont Be Hungry,13000,5600,18600
19283,19284,21-10-2020 16:05:30.973022,Desayunos · Café,Libertario Coffee Roasters,15600,4600,20200
19284,19285,21-10-2020 16:05:31.333027,Saludable · Jugos y Batidos,Berdes Drinks & Salads,27800,3500,31300
19285,19286,21-10-2020 16:05:31.743965,Sánduches · Pescados y Mariscos,Pacific Comida de Mar,39700,4000,43700
19286,19287,21-10-2020 16:05:32.003784,Desayunos · Empanadas,Empanadas Doraditas.com,9000,3000,12000
19287,19288,21-10-2020 16:05:32.313225,Típica,El Mondongo y Mucho Mas,37900,5600,43500
19288,19289,21-10-2020 16:05:32.723591,Postres · Café,Celestino Café,53900,5900,59800
19289,19290,21-10-2020 16:05:33.033021,Desayunos · Típica,90 Calentados,35000,3700,38700
19290,19291,21-10-2020 16:05:33.342595,Desayunos · Panadería,Ficchi Panadería,9000,3100,12100
19291,19292,21-10-2020 16:05:33.703218,China,China Food Col,53400,3600,57000
19292,19293,21-10-2020 16:05:33.963503,Desayunos · Panadería,Le Pain Quotidien,13600,3900,17500
19293,19294,21-10-2020 16:05:34.123650,Saludable · Desayunos,Re.al Alimentos Reales,23000,4000,27000
19294,19295,21-10-2020 16:05:34.484535,Desayunos · Sánduches,Frutos del Bosque,35000,3500,38500
19295,19296,21-10-2020 16:05:34.894913,Desayunos · Italiana,Rceta By Rausch,53400,3600,57000
19296,19297,21-10-2020 16:05:35.205196,Saludable · Desayunos,Guadalupe - Fruteria,18900,5900,24800
19297,19298,21-10-2020 16:05:35.565012,Saludable · Desayunos,Copacabana Açai Bowls,15600,3000,18600
19298,19299,21-10-2020 16:05:35.975620,Desayunos,La Frijolada Desayunos,13600,4400,18000
19299,19300,21-10-2020 16:05:36.286598,Parrilla,Carnes la Zarza,17800,4900,22700
19300,19301,21-10-2020 16:05:36.596644,Café · Helados,Sofia heladería y café,34500,5800,40300
19301,19302,21-10-2020 16:05:37.008378,Pollo · Desayunos,Piaf,34500,6500,41000
19302,19303,21-10-2020 16:05:37.368463,Postres · Desayunos,Jacques Pastelería,18900,5900,24800
19303,19304,21-10-2020 16:05:37.728219,Parrilla · Café,Gaira Café,53400,4400,57800
19304,19305,21-10-2020 16:05:38.089447,Desayunos · Panadería,Decofruta,23000,4700,27700
19305,19306,21-10-2020 16:05:38.250043,Saludable · Desayunos,Raices Bienestar Gourmet,11870,6600,18470
19306,19307,21-10-2020 16:05:38.411147,Típica,Lo Nuestro,39700,3100,42800
19307,19308,21-10-2020 16:05:38.772750,Saludable · Desayunos,Malú,13600,3700,17300
19308,19309,21-10-2020 16:05:39.182554,Peruana · Internacional,La Chifería,35000,6600,41600
19309,19310,21-10-2020 16:05:39.542616,Desayunos · Café,Frambas,18900,3400,22300
19310,19311,21-10-2020 16:05:39.704044,Pollo · Desayunos,Abasto,13000,3600,16600
19311,19312,21-10-2020 16:05:40.113673,Postres · Desayunos,La Folie - Postres,8900,3300,12200
19312,19313,21-10-2020 16:05:40.473529,Desayunos · Mexicana,La Mera Mera - Mexicana,35000,3100,38100
19313,19314,21-10-2020 16:05:40.886520,Típica · Pescados y Mariscos,La Vitualla,12500,6300,18800
19314,19315,21-10-2020 16:05:41.096420,Desayunos,Desayunos en Bogotá,65000,3400,68400
19315,19316,21-10-2020 16:05:41.256515,Desayunos · Panadería,Choclofee,24200,4700,28900
19316,19317,21-10-2020 16:05:41.468595,Desayunos · Árabe,Boniato Sabores Vivos,18900,5300,24200
19317,19318,21-10-2020 16:05:41.628894,Parrilla,Coquitas,65000,5600,70600
19318,19319,21-10-2020 16:05:42.038620,Desayunos · Típica,Peninsula Calentados y Parrilla,53900,3400,57300
19319,19320,21-10-2020 16:05:42.449990,Sushi,Kim Pop,8900,5400,14300
19320,19321,21-10-2020 16:05:42.860304,Típica,El Mondongo y Mucho Mas,23000,5600,28600
19321,19322,21-10-2020 16:05:43.171279,Hamburguesas · Alitas,Beer,18900,6600,25500
19322,19323,21-10-2020 16:05:43.482863,Desayunos · Típica,Cochon,8900,3300,12200
19323,19324,21-10-2020 16:05:43.643633,Postres,Beiked,24300,4000,28300
19324,19325,21-10-2020 16:05:43.953334,Asiática,Thai Station,35000,6000,41000
19325,19326,21-10-2020 16:05:44.164776,Típica,Sopitas y Más,34500,4200,38700
19326,19327,21-10-2020 16:05:44.526033,Típica,Campo Victoria,31800,3000,34800
19327,19328,21-10-2020 16:05:44.936745,Desayunos · Pescados y Mariscos,Luzí­a - Mediterranea,31800,5700,37500
19328,19329,21-10-2020 16:05:45.248518,Saludable · Desayunos,Distrito Gourmet,45800,3700,49500
19329,19330,21-10-2020 16:05:45.608252,Saludable · Jugos y Batidos,Berdes Drinks & Salads,27800,3500,31300
19330,19331,21-10-2020 16:05:45.769903,Típica · Parrilla,Parrilla Farandula Gourmet,31800,5100,36900
19331,19332,21-10-2020 16:05:46.083367,Parrilla · Internacional,Taperia de la Plaza,35000,5700,40700
19332,19333,21-10-2020 16:05:46.243177,Alta Cocina · Postres,La Pinta,45800,4500,50300
19333,19334,21-10-2020 16:05:46.453066,Desayunos · Café,Libertario Coffee Roasters,29500,4600,34100
19334,19335,21-10-2020 16:05:46.764984,Desayunos · Típica,Parrilla Farandula Típico,8900,5900,14800
19335,19336,21-10-2020 16:05:46.924342,Desayunos · Típica,Peninsula Calentados y Parrilla,37900,3400,41300
19336,19337,21-10-2020 16:05:47.133564,Desayunos · Empanadas,Empanadas Doraditas.com,10700,3000,13700
19337,19338,21-10-2020 16:05:47.446436,Desayunos,Sr Buñuelo,12500,6400,18900
19338,19339,21-10-2020 16:05:47.756441,Mexicana,La leyenda mexican kitchen,9000,3200,12200
19339,19340,21-10-2020 16:05:48.167077,Poke,Poke Go,23000,4600,27600
19340,19341,21-10-2020 16:05:48.477430,Hamburguesas · Desayunos,El Inglés Gastro Pub,12500,6600,19100
19341,19342,21-10-2020 16:05:48.838169,Peruana,Uma Cantina Peruana,35000,3200,38200
19342,19343,21-10-2020 16:05:49.248468,Desayunos · Panadería,Limarys,37900,6500,44400
19343,19344,21-10-2020 16:05:49.609170,Alta Cocina · Postres,La Pinta,27800,4500,32300
19344,19345,21-10-2020 16:05:49.819881,Desayunos · Típica,Fogón Sangileño,70000,5000,75000
19345,19346,21-10-2020 16:05:50.079272,Desayunos · Café,vereda central calle 99,53900,5700,59600
19346,19347,21-10-2020 16:05:50.390780,Desayunos · Típica,Criollomania,27800,5200,33000
19347,19348,21-10-2020 16:05:50.550562,Desayunos · Panadería,Le Pain Quotidien,9000,3900,12900
19348,19349,21-10-2020 16:05:50.910923,Desayunos · Típica,D´Porco,31800,3900,35700
19349,19350,21-10-2020 16:05:51.071578,Típica,Bendita S,15000,4600,19600
19350,19351,21-10-2020 16:05:51.284547,Postres · Café,Celestino Café,17800,5900,23700
19351,19352,21-10-2020 16:05:51.495614,Pollo · Saludable,Gratina,48750,4200,52950
19352,19353,21-10-2020 16:05:51.706637,Pollo,Chicken House,9000,4200,13200
19353,19354,21-10-2020 16:05:52.069396,Parrilla · Café,Figaro Café/ Restaurante Argentino,7500,5800,13300
19354,19355,21-10-2020 16:05:52.279957,Desayunos · Panadería,Artesanos,9000,4300,13300
19355,19356,21-10-2020 16:05:52.589979,Jugos y Batidos,Pomponio,23000,3600,26600
19356,19357,21-10-2020 16:05:52.852384,Postres,La Galeta,10700,3000,13700
19357,19358,21-10-2020 16:05:53.264370,Postres · Desayunos,Gelateria Da Favola,15000,6500,21500
19358,19359,21-10-2020 16:05:53.524696,Desayunos,El Fogón Castellano,18900,3200,22100
19359,19360,21-10-2020 16:05:53.737396,Postres,Toledo Pastelería,13600,6800,20400
19360,19361,21-10-2020 16:05:54.098035,Desayunos · Típica,Casa Vieja,15000,6000,21000
19361,19362,21-10-2020 16:05:54.308908,Postres · Saludable,Ana Rebana,27800,6300,34100
19362,19363,21-10-2020 16:05:54.470812,Desayunos · Panadería,Pasteleite,53900,5900,59800
19363,19364,21-10-2020 16:05:54.680924,Típica · Parrilla,El Portal de la Antigua,39700,5600,45300
19364,19365,21-10-2020 16:05:55.091144,Desayunos · Café,Frambas,7500,3400,10900
19365,19366,21-10-2020 16:05:55.452876,Saludable · Parrilla,The Angels Grill and Drinks,23000,6200,29200
19366,19367,21-10-2020 16:05:55.663445,Desayunos,Bagel Shop,17800,3200,21000
19367,19368,21-10-2020 16:05:55.824040,Desayunos · Internacional,Camilia,15000,3900,18900
19368,19369,21-10-2020 16:05:56.085563,Parrilla,Arepaisa de Medellín,70000,5600,75600
19369,19370,21-10-2020 16:05:56.397933,Típica,Sabores De Mi Tierra,8900,5400,14300
19370,19371,21-10-2020 16:05:56.707639,Parrilla,Parrilla Pimentón,27800,3400,31200
19371,19372,21-10-2020 16:05:57.069921,Típica,Juan Chorizo,29500,3900,33400
19372,19373,21-10-2020 16:05:57.280141,Desayunos · Típica,Cochon,15000,3300,18300
19373,19374,21-10-2020 16:05:57.590788,Desayunos · Típica,Cochon,27800,3300,31100
19374,19375,21-10-2020 16:05:57.752542,Típica,La Herencia,12500,5900,18400
19375,19376,21-10-2020 16:05:58.062795,Pollo · Desayunos,Caserito Gourmet,15000,6700,21700
19376,19377,21-10-2020 16:05:58.321680,Desayunos · Típica,Casa Vieja,48750,6000,54750
19377,19378,21-10-2020 16:05:58.483565,Saludable · Desayunos,Agua Dulce,8900,3700,12600
19378,19379,21-10-2020 16:05:58.892830,Parrilla,Rústico Picadería,39700,3800,43500
19379,19380,21-10-2020 16:05:59.103153,Alta Cocina · Postres,La Pinta,37900,4500,42400
19380,19381,21-10-2020 16:05:59.265189,Desayunos · Panadería,El Pan de Phillippe,23000,4600,27600
19381,19382,21-10-2020 16:05:59.677016,Desayunos,Señor Desayuno,7500,6800,14300
19382,19383,21-10-2020 16:05:59.986601,Desayunos · Típica,D'Porco - Lechona,24300,6300,30600
19383,19384,21-10-2020 16:06:00.347733,Asiática,TeT,13600,5900,19500
19384,19385,21-10-2020 16:06:00.607625,Desayunos · Italiana,Rceta By Rausch,13000,3600,16600
19385,19386,21-10-2020 16:06:00.767456,Saludable,A2manos,24200,4200,28400
19386,19387,21-10-2020 16:06:01.129105,Desayunos · Panadería,Pasteleite,12500,5900,18400
19387,19388,21-10-2020 16:06:01.290134,Postres · Desayunos,Restaurante Cornelia,39700,5500,45200
19388,19389,21-10-2020 16:06:01.600418,Típica,Baondish,13600,5800,19400
19389,19390,21-10-2020 16:06:01.911960,Postres · Desayunos,Gelateria Da Favola,24300,6500,30800
19390,19391,21-10-2020 16:06:02.223004,Desayunos · Parrilla,Mi Patria,53900,4600,58500
19391,19392,21-10-2020 16:06:02.635205,Mexicana,Hidalgo Taquería,35000,4900,39900
19392,19393,21-10-2020 16:06:02.994411,Desayunos · Típica,Alce,35000,4900,39900
19393,19394,21-10-2020 16:06:03.156494,Peruana,Masivo,15000,5800,20800
19394,19395,21-10-2020 16:06:03.367358,Sushi,Umi,15600,5600,21200
19395,19396,21-10-2020 16:06:03.579235,Típica · Parrilla,Toya,37900,4200,42100
19396,19397,21-10-2020 16:06:03.940116,Desayunos · Típica,La Parrilla Dorada Polo,12500,6600,19100
19397,19398,21-10-2020 16:06:04.251544,Desayunos · Sánduches,Garnish,11870,5200,17070
19398,19399,21-10-2020 16:06:04.610773,Postres · Desayunos,Maltihelados,12500,6200,18700
19399,19400,21-10-2020 16:06:04.822033,Alta Cocina · Italiana,Trattoria de la Plaza,39700,6000,45700
19400,19401,21-10-2020 16:06:05.031418,Hamburguesas,Gofi Burger,27800,5100,32900
19401,19402,21-10-2020 16:06:05.392387,Postres,Toledo Pastelería,23000,6800,29800
19402,19403,21-10-2020 16:06:05.653538,Parrilla · Café,Gaira Café,12500,4400,16900
19403,19404,21-10-2020 16:06:05.913545,Típica,El Mondongo y Mucho Mas,31800,5600,37400
19404,19405,21-10-2020 16:06:06.072883,Típica,Cabrito Santandereano,27800,6600,34400
19405,19406,21-10-2020 16:06:06.283594,Desayunos · Típica,Rojo Gourmet,53400,4700,58100
19406,19407,21-10-2020 16:06:06.445549,Italiana,Bocatto Di Passo,15600,5000,20600
19407,19408,21-10-2020 16:06:06.656524,Desayunos,La Frijolada Desayunos,7500,4400,11900
19408,19409,21-10-2020 16:06:06.915820,Pescados y Mariscos,La Gran Cazuela,8900,3200,12100
19409,19410,21-10-2020 16:06:07.075763,Pizza,pizza andante,8900,4200,13100
19410,19411,21-10-2020 16:06:07.385555,Parrilla · Internacional,Taperia de la Plaza,37900,5700,43600
19411,19412,21-10-2020 16:06:07.747173,Pollo · Desayunos,Abasto,35000,3600,38600
19412,19413,21-10-2020 16:06:08.007738,Desayunos · Panadería,Pasteleite,37900,5900,43800
19413,19414,21-10-2020 16:06:08.167597,Desayunos,Señor Desayuno,12500,6800,19300
19414,19415,21-10-2020 16:06:08.478613,Desayunos · Típica,Rojo Gourmet,31800,4700,36500
19415,19416,21-10-2020 16:06:08.839270,Desayunos · Típica,90 Calentados,13600,3700,17300
19416,19417,21-10-2020 16:06:09.048761,Saludable · Desayunos,Fresh Co,45800,5600,51400
19417,19418,21-10-2020 16:06:09.260049,Sushi,Umi,53400,5600,59000
19418,19419,21-10-2020 16:06:09.570375,Típica · Parrilla,El Portal de la Antigua,34500,5600,40100
19419,19420,21-10-2020 16:06:09.831212,Saludable · Desayunos,Re.al Alimentos Reales,13600,4000,17600
19420,19421,21-10-2020 16:06:09.991506,Hamburguesas · Alitas,Beer,27800,6600,34400
19421,19422,21-10-2020 16:06:10.152358,Sushi · Asiática,Arigato,18900,5300,24200
19422,19423,21-10-2020 16:06:10.412501,Saludable,Amor Propio saludable,18900,4000,22900
19423,19424,21-10-2020 16:06:10.722852,Desayunos · Típica,Cochon,10700,3300,14000
19424,19425,21-10-2020 16:06:11.133858,Café · Helados,Sofia heladería y café,48750,5800,54550
19425,19426,21-10-2020 16:06:11.444914,Desayunos,La Frijolada Desayunos,53400,4400,57800
19426,19427,21-10-2020 16:06:11.605338,Desayunos · Café,Aromacafé el Placer de Compartir,37900,5000,42900
19427,19428,21-10-2020 16:06:11.966391,Postres,Levelma,23000,6200,29200
19428,19429,21-10-2020 16:06:12.127132,Comida Rápida,Fiesta Digital Andrés,7500,3100,10600
19429,19430,21-10-2020 16:06:12.388524,Postres,Levelma,7500,6200,13700
19430,19431,21-10-2020 16:06:12.749697,Desayunos,Archies Desayunos,34500,3100,37600
19431,19432,21-10-2020 16:06:13.010214,Pollo · Desayunos,Caserito Gourmet,35000,6700,41700
19432,19433,21-10-2020 16:06:13.319927,Parrilla,Restaurante Bar Mi Ranchito,23000,5200,28200
19433,19434,21-10-2020 16:06:13.629724,Desayunos · Típica,La Frijolada,53400,4500,57900
19434,19435,21-10-2020 16:06:13.939949,Parrilla,Campocina,17800,4600,22400
19435,19436,21-10-2020 16:06:14.250196,Desayunos · Típica,Peninsula Calentados y Parrilla,8900,3400,12300
19436,19437,21-10-2020 16:06:14.461778,Saludable · Desayunos,Bon Eat - Saludable,48750,4800,53550
19437,19438,21-10-2020 16:06:14.671637,Desayunos · Panadería,El Pan de Phillippe,9000,4600,13600
19438,19439,21-10-2020 16:06:15.082131,Italiana,F*cking Good Pizza,8900,4200,13100
19439,19440,21-10-2020 16:06:15.292292,Típica · Parrilla,El Santandereano,7500,5200,12700
19440,19441,21-10-2020 16:06:15.702072,Parrilla,OAK Ahumado y Brebajes,12500,6000,18500
19441,19442,21-10-2020 16:06:16.012141,Desayunos · Panadería,El Pan de Phillippe,10700,4600,15300
19442,19443,21-10-2020 16:06:16.272202,Postres · Desayunos,BagBog Bagels,24200,6400,30600
19443,19444,21-10-2020 16:06:16.582449,Postres,Toledo Pastelería,53900,6800,60700
19444,19445,21-10-2020 16:06:16.841906,Pollo,Chicken House,18900,4200,23100
19445,19446,21-10-2020 16:06:17.252703,Desayunos · Empanadas,Empanadas Doraditas.com,34500,3000,37500
19446,19447,21-10-2020 16:06:17.612363,Desayunos · Típica,La Parrilla Dorada Polo,15000,6600,21600
19447,19448,21-10-2020 16:06:17.922234,Saludable,Hanai - Bowls Saludables,65000,5900,70900
19448,19449,21-10-2020 16:06:18.081431,Asiática,TeT,9000,5900,14900
19449,19450,21-10-2020 16:06:18.391710,Típica,Lo Nuestro,13600,3100,16700
19450,19451,21-10-2020 16:06:18.701621,Sánduches,Submarin,53900,3800,57700
19451,19452,21-10-2020 16:06:19.012412,Postres · Saludable,Ana Rebana,9000,6300,15300
19452,19453,21-10-2020 16:06:19.223619,Peruana,Uma Cantina Peruana,29500,3200,32700
19453,19454,21-10-2020 16:06:19.634715,Parrilla,Beraca Parrilla Bbq,27800,5600,33400
19454,19455,21-10-2020 16:06:19.994557,Desayunos · Panadería,El Pan de Phillippe,12500,4600,17100
19455,19456,21-10-2020 16:06:20.305488,Hamburguesas · Desayunos,El Inglés Gastro Pub,23000,6600,29600
19456,19457,21-10-2020 16:06:20.665962,Parrilla,Parrilla Pimentón,7500,3400,10900
19457,19458,21-10-2020 16:06:20.827223,Desayunos · Típica,La Parrilla Dorada Polo,31800,6600,38400
19458,19459,21-10-2020 16:06:21.088255,Parrilla,Beraca Parrilla Bbq,12500,5600,18100
19459,19460,21-10-2020 16:06:21.399996,Pizza · Italiana,Piatto - Pizza,8900,6600,15500
19460,19461,21-10-2020 16:06:21.810341,Desayunos · Café,Norma's Ice Cream Café,10700,6300,17000
19461,19462,21-10-2020 16:06:22.071442,Pollo · Saludable,Tremenda Sal y Dulce,35000,6500,41500
19462,19463,21-10-2020 16:06:22.282543,Desayunos · Panadería,Ficchi Panadería,11870,3100,14970
19463,19464,21-10-2020 16:06:22.593234,Típica,Cabrito Santandereano,10700,6600,17300
19464,19465,21-10-2020 16:06:22.753781,Desayunos,Desayunos en Bogotá,35000,3400,38400
19465,19466,21-10-2020 16:06:23.014119,Pizza · Italiana,Pisapore - Pizza,48750,6600,55350
19466,19467,21-10-2020 16:06:23.425472,Alta Cocina · Postres,La Pinta,27800,4500,32300
19467,19468,21-10-2020 16:06:23.636251,Mexicana,Mexicanachos,23000,3900,26900
19468,19469,21-10-2020 16:06:23.796376,Postres · Café,Loló Coffee & Snacks,12500,4600,17100
19469,19470,21-10-2020 16:06:24.207115,Sushi,Kim Pop,10700,5400,16100
19470,19471,21-10-2020 16:06:24.517260,Panadería,Boul,53400,3100,56500
19471,19472,21-10-2020 16:06:24.677750,Saludable · Parrilla,Box,27800,3700,31500
19472,19473,21-10-2020 16:06:24.938403,Pollo · Desayunos,Abasto,24300,3600,27900
19473,19474,21-10-2020 16:06:25.099457,Postres · Desayunos,Amelie Helados,17800,6400,24200
19474,19475,21-10-2020 16:06:25.510089,Desayunos · Helados,San Giorgio Gelateria,8900,3100,12000
19475,19476,21-10-2020 16:06:25.720488,Desayunos · Panadería,Santa Juana Food Bar,23000,5900,28900
19476,19477,21-10-2020 16:06:26.031388,Pollo · Típica,Auyama,35000,3900,38900
19477,19478,21-10-2020 16:06:26.241926,Saludable · Desayunos,Raices Bienestar Gourmet,35000,6600,41600
19478,19479,21-10-2020 16:06:26.602512,Típica,La Herencia,15600,5900,21500
19479,19480,21-10-2020 16:06:26.763179,Sushi,Canoa To Go,35000,5900,40900
19480,19481,21-10-2020 16:06:27.022415,Pizza,Pastas Laurentina,8900,4800,13700
19481,19482,21-10-2020 16:06:27.434279,Panadería,Boul,35000,3100,38100
19482,19483,21-10-2020 16:06:27.844457,Desayunos · Típica,D'Porco - Lechona,35000,6300,41300
19483,19484,21-10-2020 16:06:28.154009,Internacional,La Esquina con Sabor Parrilla,53400,3000,56400
19484,19485,21-10-2020 16:06:28.562955,Típica,Salsig,34500,5600,40100
19485,19486,21-10-2020 16:06:28.922250,Típica · Pescados y Mariscos,La Vitualla,37900,6300,44200
19486,19487,21-10-2020 16:06:29.080924,Parrilla,Parrilla Pimentón,15000,3400,18400
19487,19488,21-10-2020 16:06:29.439995,Saludable,Ventura Soup y Salad,48750,3800,52550
19488,19489,21-10-2020 16:06:29.848996,Postres,Toledo Pastelería,15000,6800,21800
19489,19490,21-10-2020 16:06:30.058632,Pizza,pizza andante,37900,4200,42100
19490,19491,21-10-2020 16:06:30.468517,Hamburguesas,Gofi Burger,37900,5100,43000
19491,19492,21-10-2020 16:06:30.629265,Típica,El Cucharón - Tipica,65000,4400,69400
19492,19493,21-10-2020 16:06:30.788325,Sushi,Umi,7500,5600,13100
19493,19494,21-10-2020 16:06:30.946480,Saludable · Desayunos,Básico y Elemental,15000,5900,20900
19494,19495,21-10-2020 16:06:31.206050,Saludable · Desayunos,La Cesta,35000,4700,39700
19495,19496,21-10-2020 16:06:31.564689,Desayunos · Típica,Rojo Gourmet,35000,4700,39700
19496,19497,21-10-2020 16:06:31.922736,Desayunos · Típica,Peninsula Calentados y Parrilla,11870,3400,15270
19497,19498,21-10-2020 16:06:32.080919,Internacional,La Esquina con Sabor Parrilla,53900,3000,56900
19498,19499,21-10-2020 16:06:32.389114,Saludable · Desayunos,Guadalupe - Fruteria,35000,5900,40900
19499,19500,21-10-2020 16:06:32.749150,Peruana,Uma Cantina Peruana,34500,3200,37700
19500,19501,21-10-2020 16:06:33.057362,Desayunos,Fratelli - Desayunos,24300,4600,28900
19501,19502,21-10-2020 16:06:33.266018,Postres · Desayunos,Jacques Pastelería,12500,5900,18400
19502,19503,21-10-2020 16:06:33.475539,Típica,Cazuelitas 93,34500,3900,38400
19503,19504,21-10-2020 16:06:33.784254,Postres · Desayunos,Aury Postres - Comidas & Picadas,39700,4700,44400
19504,19505,21-10-2020 16:06:34.143346,Típica,El Mondongo y Mucho Mas,27800,5600,33400
19505,19506,21-10-2020 16:06:34.301561,Postres · Saludable,Ana Rebana,65000,6300,71300
19506,19507,21-10-2020 16:06:34.509852,Sushi · Desayunos,Maki Roll,12500,4300,16800
19507,19508,21-10-2020 16:06:34.718094,Postres · Desayunos,Café Quindio,11870,5700,17570
19508,19509,21-10-2020 16:06:35.126813,Pollo · Desayunos,Caserito Gourmet,65000,6700,71700
19509,19510,21-10-2020 16:06:35.494534,Postres,La Galeta,24300,3000,27300
19510,19511,21-10-2020 16:06:35.904202,Postres,Beiked,45800,4000,49800
19511,19512,21-10-2020 16:06:36.213023,Saludable · Típica,Sopas Mrg,34500,3100,37600
19512,19513,21-10-2020 16:06:36.621800,Pescados y Mariscos,Fish Place - Del Mar,24300,5400,29700
19513,19514,21-10-2020 16:06:36.780073,Saludable,Amor Propio saludable,37900,4000,41900
19514,19515,21-10-2020 16:06:37.088355,Desayunos · Helados,San Giorgio Gelateria,9000,3100,12100
19515,19516,21-10-2020 16:06:37.447675,Desayunos · Café,Libertario Coffee Roasters,13000,4600,17600
19516,19517,21-10-2020 16:06:37.808321,Típica,Carbón & Mondongos,13600,6400,20000
19517,19518,21-10-2020 16:06:38.168242,Desayunos,Sunny Breakfast Brunch,15600,4300,19900
19518,19519,21-10-2020 16:06:38.327003,Saludable · Desayunos,Básico y elemental,23000,5000,28000
19519,19520,21-10-2020 16:06:38.686413,Desayunos · Panadería,Juliana Restaurante,18900,6100,25000
19520,19521,21-10-2020 16:06:38.844887,Sánduches · China,Peru Mix,65000,5900,70900
19521,19522,21-10-2020 16:06:39.003668,Postres,Beiked,7500,4000,11500
19522,19523,21-10-2020 16:06:39.362572,Pollo · Pescados y Mariscos,Bang Bang Rice,7500,3400,10900
19523,19524,21-10-2020 16:06:39.771677,Asiática,TeT,13000,5900,18900
19524,19525,21-10-2020 16:06:40.081113,Pollo,Chicken House,53400,4200,57600
19525,19526,21-10-2020 16:06:40.491049,Hamburguesas · Saludable,Restaurant Inn,27800,6100,33900
19526,19527,21-10-2020 16:06:40.850573,Desayunos · Típica,Casa Vieja,15000,6000,21000
19527,19528,21-10-2020 16:06:41.010524,Pollo,Señor Fantástico,35000,4700,39700
19528,19529,21-10-2020 16:06:41.321030,Saludable,Puro Verde,34500,5700,40200
19529,19530,21-10-2020 16:06:41.480495,Hamburguesas,Gofi Burger,23000,5100,28100
19530,19531,21-10-2020 16:06:41.740720,Desayunos · Internacional,Camilia,8900,3900,12800
19531,19532,21-10-2020 16:06:42.151090,Pollo · Típica,Auyama,7500,3900,11400
19532,19533,21-10-2020 16:06:42.461383,Desayunos,Jacinta Arepas de Huevo,13000,4000,17000
19533,19534,21-10-2020 16:06:42.873046,Desayunos · Panadería,Artesanos,15000,4300,19300
19534,19535,21-10-2020 16:06:43.083169,Saludable,A2manos,53900,4200,58100
19535,19536,21-10-2020 16:06:43.444567,Pizza,18 Scalini,23000,4300,27300
19536,19537,21-10-2020 16:06:43.754435,Pollo,Heart & Cooking,34500,5000,39500
19537,19538,21-10-2020 16:06:44.114533,Saludable · Desayunos,Bawana - Sandwich,9000,3400,12400
19538,19539,21-10-2020 16:06:44.474836,Saludable · Típica,Saludable Mrg,8900,5800,14700
19539,19540,21-10-2020 16:06:44.634498,Saludable · Desayunos,Fresh Co,15000,5600,20600
19540,19541,21-10-2020 16:06:44.894149,Pizza · Italiana,Piatto - Pizza,37900,6600,44500
19541,19542,21-10-2020 16:06:45.254996,Perros Calientes,Dog Shop - Rapida,7500,4900,12400
19542,19543,21-10-2020 16:06:45.514746,Saludable,Amor Propio saludable,34500,4000,38500
19543,19544,21-10-2020 16:06:45.875300,Pollo,Heart & Cooking,13600,5000,18600
19544,19545,21-10-2020 16:06:46.286215,Desayunos · Típica,Papadió - Colombianas,35000,5700,40700
19545,19546,21-10-2020 16:06:46.646393,Pescados y Mariscos,Fish Place - Del Mar,37900,5400,43300
19546,19547,21-10-2020 16:06:46.906238,Desayunos · Pescados y Mariscos,Gypsy Bistro,24300,4500,28800
19547,19548,21-10-2020 16:06:47.267053,Saludable · Desayunos,Básico y elemental,11870,5000,16870
19548,19549,21-10-2020 16:06:47.677337,Desayunos,Bagel Shop,23000,3200,26200
19549,19550,21-10-2020 16:06:48.039238,Desayunos · Típica,Cochon,53400,3300,56700
19550,19551,21-10-2020 16:06:48.249823,Pollo · Pescados y Mariscos,Bang Bang Rice,48750,3400,52150
19551,19552,21-10-2020 16:06:48.560419,Desayunos · Panadería,El Pan de Phillippe,39700,4600,44300
19552,19553,21-10-2020 16:06:48.920833,Hamburguesas,Gofi Burger,13000,5100,18100
19553,19554,21-10-2020 16:06:49.080332,Desayunos,Jacinta Arepas de Huevo,7500,4000,11500
19554,19555,21-10-2020 16:06:49.441581,Sushi · Asiática,Arigato,15000,5300,20300
19555,19556,21-10-2020 16:06:49.852437,Poke,Poke Go,31800,4600,36400
19556,19557,21-10-2020 16:06:50.012353,Peruana,Masivo,11870,5800,17670
19557,19558,21-10-2020 16:06:50.373008,Parrilla,Parrilla Pimentón,13000,3400,16400
19558,19559,21-10-2020 16:06:50.733596,Desayunos · Comida Rápida,La Veneca,37900,6300,44200
19559,19560,21-10-2020 16:06:50.993624,Helados,Orso To Go,9000,6800,15800
19560,19561,21-10-2020 16:06:51.303832,Postres · Desayunos,Gelateria Da Favola,11870,6500,18370
19561,19562,21-10-2020 16:06:51.714500,Postres · Desayunos,Aury Postres - Comidas & Picadas,27800,4700,32500
19562,19563,21-10-2020 16:06:52.075178,Parrilla,Beraca Parrilla Bbq,29500,5600,35100
19563,19564,21-10-2020 16:06:52.485047,Desayunos · Típica,Parrilla Farandula Típico,35000,5900,40900
19564,19565,21-10-2020 16:06:52.745419,Sánduches,Submarin,53900,3800,57700
19565,19566,21-10-2020 16:06:53.106489,Desayunos · Típica,La Parrilla Dorada Polo,15600,6600,22200
19566,19567,21-10-2020 16:06:53.366272,Desayunos · Panadería,Decofruta,7500,4700,12200
19567,19568,21-10-2020 16:06:53.675963,Café · Helados,Sofia heladería y café,8900,5800,14700
19568,19569,21-10-2020 16:06:53.985860,Desayunos · Helados,San Giorgio Gelateria,35000,3100,38100
19569,19570,21-10-2020 16:06:54.146240,Pollo · Desayunos,Caserito Gourmet,53900,6700,60600
19570,19571,21-10-2020 16:06:54.556134,Postres · Desayunos,Aury Postres - Comidas & Picadas,10700,4700,15400
19571,19572,21-10-2020 16:06:54.967125,Postres · Café,Loló Coffee & Snacks,35000,4600,39600
19572,19573,21-10-2020 16:06:55.227252,Postres · Desayunos,Cosmo Cookies,12500,5900,18400
19573,19574,21-10-2020 16:06:55.538059,Desayunos · Parrilla,Mi Patria,24300,4600,28900
19574,19575,21-10-2020 16:06:55.947204,Peruana,Masivo,45800,5800,51600
19575,19576,21-10-2020 16:06:56.306981,Saludable,MIMA,7500,3700,11200
19576,19577,21-10-2020 16:06:56.566144,Típica,Bendita S,13000,4600,17600
19577,19578,21-10-2020 16:06:56.775636,Hamburguesas · Panadería,NYC Burgers,35000,6200,41200
19578,19579,21-10-2020 16:06:57.135253,Postres · Desayunos,Jacques Pastelería,24200,5900,30100
19579,19580,21-10-2020 16:06:57.345277,Saludable · Típica,Sopas Mrg,18900,3100,22000
19580,19581,21-10-2020 16:06:57.755443,Típica · Parrilla,Parrilla Farandula Gourmet,24300,5100,29400
19581,19582,21-10-2020 16:06:57.914491,Desayunos · Mexicana,La Mera Mera - Mexicana,53400,3100,56500
19582,19583,21-10-2020 16:06:58.073660,Desayunos · Típica,Papadió - Colombianas,37900,5700,43600
19583,19584,21-10-2020 16:06:58.383916,Típica · Parrilla,La Parilla de David,45800,3100,48900
19584,19585,21-10-2020 16:06:58.743453,Poke,Poke Go,31800,4600,36400
19585,19586,21-10-2020 16:06:59.053378,Saludable · Desayunos,Fresh Co,24200,5600,29800
19586,19587,21-10-2020 16:06:59.312257,Parrilla,Rústico Picadería,70000,3800,73800
19587,19588,21-10-2020 16:06:59.471571,Desayunos · Típica,Rojo Gourmet,27800,4700,32500
19588,19589,21-10-2020 16:06:59.680781,Típica · Parrilla,Parrilla Farandula Gourmet,15600,5100,20700
19589,19590,21-10-2020 16:06:59.990966,Desayunos · Típica,Calentao Express,35000,6000,41000
19590,19591,21-10-2020 16:07:00.400469,Pescados y Mariscos,La Gran Cazuela,45800,3200,49000
19591,19592,21-10-2020 16:07:00.660127,Desayunos · Italiana,Rceta By Rausch,37900,3600,41500
19592,19593,21-10-2020 16:07:00.818169,Típica,Cazuelitas 93,53900,3900,57800
19593,19594,21-10-2020 16:07:01.127030,Típica · Pescados y Mariscos,Arroces Mrg,70000,4300,74300
19594,19595,21-10-2020 16:07:01.485543,Desayunos · Panadería,Choclofee,15600,4700,20300
19595,19596,21-10-2020 16:07:01.844551,Desayunos · Típica,D´Porco,24300,3900,28200
19596,19597,21-10-2020 16:07:02.053282,Desayunos · Internacional,Camilia,29500,3900,33400
19597,19598,21-10-2020 16:07:02.212077,Típica · Parrilla,El Portal de la Antigua,70000,5600,75600
19598,19599,21-10-2020 16:07:02.520930,Postres · Desayunos,KOKOA & co.,13000,4700,17700
19599,19600,21-10-2020 16:07:02.780146,Crepes,San Crepes,35000,4900,39900
19600,19601,21-10-2020 16:07:03.088566,Parrilla · Café,Gaira Café,24300,4400,28700
19601,19602,21-10-2020 16:07:03.247725,Pizza,pizza andante,11870,4200,16070
19602,19603,21-10-2020 16:07:03.407525,Pescados y Mariscos,La Gran Cazuela,65000,3200,68200
19603,19604,21-10-2020 16:07:03.566239,Pizza,Pastas Laurentina,24300,4800,29100
19604,19605,21-10-2020 16:07:03.824578,Desayunos · Típica,Casa Vieja,8900,6000,14900
19605,19606,21-10-2020 16:07:04.033166,Sushi,Canoa To Go,39700,5900,45600
19606,19607,21-10-2020 16:07:04.391815,Desayunos · Italiana,Rceta By Rausch,35000,3600,38600
19607,19608,21-10-2020 16:07:04.600459,Desayunos · Típica,D´Porco,24300,3900,28200
19608,19609,21-10-2020 16:07:05.009491,Saludable · Desayunos,Libre de Culpa,53400,4000,57400
19609,19610,21-10-2020 16:07:05.218678,Perros Calientes,Dog Shop - Rapida,23000,4900,27900
19610,19611,21-10-2020 16:07:05.577723,Desayunos · Empanadas,Empanadas Doraditas.com,45800,3000,48800
19611,19612,21-10-2020 16:07:05.936245,Típica,La Cocina,65000,4600,69600
19612,19613,21-10-2020 16:07:06.298376,Típica,Campo Victoria,13600,3000,16600
19613,19614,21-10-2020 16:07:06.459729,Desayunos · Típica,Peninsula Calentados y Parrilla,39700,3400,43100
19614,19615,21-10-2020 16:07:06.621842,Sánduches · Pescados y Mariscos,Pacific Comida de Mar,53400,4000,57400
19615,19616,21-10-2020 16:07:06.931793,Desayunos,Bagel Shop,24300,3200,27500
19616,19617,21-10-2020 16:07:07.244324,Desayunos · Café,Matchacha,24300,5900,30200
19617,19618,21-10-2020 16:07:07.454909,Desayunos · Panadería,Siena Café,37900,3700,41600
19618,19619,21-10-2020 16:07:07.717343,Sushi · Asiática,Arigato,24300,5300,29600
19619,19620,21-10-2020 16:07:08.128338,Desayunos · Empanadas,Mis Delicias,35000,3200,38200
19620,19621,21-10-2020 16:07:08.442849,Típica · Parrilla,Toya,34500,4200,38700
19621,19622,21-10-2020 16:07:08.802905,Saludable,Amor Propio saludable,29500,4000,33500
19622,19623,21-10-2020 16:07:09.114855,Desayunos · Panadería,Limarys,13600,6500,20100
19623,19624,21-10-2020 16:07:09.476548,Pizza,Pastas Laurentina,8900,4800,13700
19624,19625,21-10-2020 16:07:09.888806,Desayunos,Bagel Shop,24300,3200,27500
19625,19626,21-10-2020 16:07:10.300177,Saludable · Desayunos,Agua Dulce,15000,3700,18700
19626,19627,21-10-2020 16:07:10.612536,Pollo · Desayunos,Caserito Gourmet,23000,6700,29700
19627,19628,21-10-2020 16:07:10.823257,Desayunos · Mexicana,La Mera Mera - Mexicana,45800,3100,48900
19628,19629,21-10-2020 16:07:11.085424,Alta Cocina · Italiana,Trattoria de la Plaza,23000,6000,29000
19629,19630,21-10-2020 16:07:11.295857,Típica,La Olla de Barro,35000,5300,40300
19630,19631,21-10-2020 16:07:11.558077,Postres · Desayunos,Vivalight Market.,27800,6500,34300
19631,19632,21-10-2020 16:07:11.769149,Postres · Desayunos,Maltihelados,39700,6200,45900
19632,19633,21-10-2020 16:07:11.981203,Parrilla,Campocina,24200,4600,28800
19633,19634,21-10-2020 16:07:12.341181,Desayunos · Café,Aromacafé el Placer de Compartir,24300,5000,29300
19634,19635,21-10-2020 16:07:12.654006,Saludable,Puro Verde,8900,5700,14600
19635,19636,21-10-2020 16:07:12.814200,Desayunos · Helados,San Giorgio Gelateria,53400,3100,56500
19636,19637,21-10-2020 16:07:13.026495,Desayunos · Pescados y Mariscos,Gypsy Bistro,23000,4500,27500
19637,19638,21-10-2020 16:07:13.386708,Saludable · Desayunos,Re.al Alimentos Reales,65000,4000,69000
19638,19639,21-10-2020 16:07:13.700083,Sánduches,Submarin,48750,3800,52550
19639,19640,21-10-2020 16:07:13.860657,Desayunos · Típica,D'Porco - Lechona,48750,6300,55050
19640,19641,21-10-2020 16:07:14.172970,Saludable · Desayunos,La Estampilla,17800,6000,23800
19641,19642,21-10-2020 16:07:14.583483,Parrilla,Antojo a Domicilio,53900,5000,58900
19642,19643,21-10-2020 16:07:14.995189,Desayunos · Pescados y Mariscos,Luzí­a - Mediterranea,35000,5700,40700
19643,19644,21-10-2020 16:07:15.155459,Saludable · Jugos y Batidos,Berdes Drinks & Salads,34500,3500,38000
19644,19645,21-10-2020 16:07:15.467559,Hamburguesas · Panadería,NYC Burgers,45800,6200,52000
19645,19646,21-10-2020 16:07:15.677832,Postres · Panadería,RIGHT AWAY FOODS,23000,6600,29600
19646,19647,21-10-2020 16:07:15.939893,Postres,La Tertulia,39700,3400,43100
19647,19648,21-10-2020 16:07:16.150645,Parrilla,Rústico Picadería,35000,3800,38800
19648,19649,21-10-2020 16:07:16.512751,Postres · Desayunos,Vivalight Market.,23000,6500,29500
19649,19650,21-10-2020 16:07:16.873243,Sushi · Asiática,Tu Sushi,17800,6400,24200
19650,19651,21-10-2020 16:07:17.085865,Típica,Sabrosito,70000,4000,74000
19651,19652,21-10-2020 16:07:17.447328,Desayunos · Italiana,Rceta By Rausch,24200,3600,27800
19652,19653,21-10-2020 16:07:17.660222,Sánduches,Submarin,35000,3800,38800
19653,19654,21-10-2020 16:07:18.071038,Pollo · China,China Tao,35000,3500,38500
19654,19655,21-10-2020 16:07:18.433983,Saludable · Desayunos,Agua Dulce,48750,3700,52450
19655,19656,21-10-2020 16:07:18.644716,Sushi,Sushi Reel,23000,4700,27700
19656,19657,21-10-2020 16:07:19.007695,Pizza,Pastas Laurentina,70000,4800,74800
19657,19658,21-10-2020 16:07:19.268355,Saludable · Desayunos,Maracuyá,53900,6700,60600
19658,19659,21-10-2020 16:07:19.680351,Saludable · Desayunos,La Cesta,13600,4700,18300
19659,19660,21-10-2020 16:07:19.890574,Desayunos · Típica,Papadió - Colombianas,13000,5700,18700
19660,19661,21-10-2020 16:07:20.303231,Postres · Desayunos,Amelie Helados,13600,6400,20000
19661,19662,21-10-2020 16:07:20.613430,Desayunos · Panadería,Artesanos,45800,4300,50100
19662,19663,21-10-2020 16:07:20.875275,Desayunos · Árabe,Boniato Sabores Vivos,11870,5300,17170
19663,19664,21-10-2020 16:07:21.286992,Desayunos,La Frijolada Desayunos,13000,4400,17400
19664,19665,21-10-2020 16:07:21.699442,Hamburguesas · Pescados y Mariscos,El Velero,8900,6500,15400
19665,19666,21-10-2020 16:07:21.959527,Pollo,Señor Fantástico,35000,4700,39700
19666,19667,21-10-2020 16:07:22.272331,Desayunos · Empanadas,Empanadas Doraditas.com,39700,3000,42700
19667,19668,21-10-2020 16:07:22.583257,Desayunos · Panadería,Le Pain Quotidien,10700,3900,14600
19668,19669,21-10-2020 16:07:22.945449,Desayunos · Panadería,Le Pain Quotidien,35000,3900,38900
19669,19670,21-10-2020 16:07:23.306276,Pollo · Pescados y Mariscos,Bang Bang Rice,13600,3400,17000
19670,19671,21-10-2020 16:07:23.518336,Pollo · China,China Tao,15600,3500,19100
19671,19672,21-10-2020 16:07:23.828999,Saludable · Desayunos,La Cesta,27800,4700,32500
19672,19673,21-10-2020 16:07:24.191070,Desayunos,Archies Desayunos,35000,3100,38100
19673,19674,21-10-2020 16:07:24.401411,Postres · Desayunos,Amelie Helados,31800,6400,38200
19674,19675,21-10-2020 16:07:24.614253,Desayunos · Típica,Desayunadero de la 42,15000,5900,20900
19675,19676,21-10-2020 16:07:25.024781,Típica · Parrilla,Parrilla Farandula Gourmet,34500,5100,39600
19676,19677,21-10-2020 16:07:25.187221,Saludable,Hanai - Bowls Saludables,23000,5900,28900
19677,19678,21-10-2020 16:07:25.347624,Pescados y Mariscos,Fish Place - Del Mar,24200,5400,29600
19678,19679,21-10-2020 16:07:25.659663,Desayunos,Sr Buñuelo,23000,6400,29400
19679,19680,21-10-2020 16:07:25.970259,Típica · Parrilla,Typykos,17800,6000,23800
19680,19681,21-10-2020 16:07:26.232967,Típica · Parrilla,El Portal de la Antigua,35000,5600,40600
19681,19682,21-10-2020 16:07:26.393501,Desayunos · Jugos y Batidos,Kuriwaji,17800,6300,24100
19682,19683,21-10-2020 16:07:26.755789,Sushi · Asiática,Arigato,53900,5300,59200
19683,19684,21-10-2020 16:07:27.066088,Saludable · Desayunos,Distrito Gourmet,24300,3700,28000
19684,19685,21-10-2020 16:07:27.278642,Desayunos · Sánduches,Garnish,24200,5200,29400
19685,19686,21-10-2020 16:07:27.639801,Saludable,A2manos,48750,4200,52950
19686,19687,21-10-2020 16:07:28.051729,Desayunos · Típica,90 Calentados,45800,3700,49500
19687,19688,21-10-2020 16:07:28.362175,Postres,Beiked,9000,4000,13000
19688,19689,21-10-2020 16:07:28.774515,Postres · Desayunos,Cosmo Cookies,29500,5900,35400
19689,19690,21-10-2020 16:07:28.985380,Postres · Desayunos,BagBog Bagels,10700,6400,17100
19690,19691,21-10-2020 16:07:29.148275,Desayunos · Típica,Parrilla Farandula Típico,35000,5900,40900
19691,19692,21-10-2020 16:07:29.410532,Alta Cocina · Parrilla,Criterión,35000,6000,41000
19692,19693,21-10-2020 16:07:29.823348,Desayunos,Archies Desayunos,7500,3100,10600
19693,19694,21-10-2020 16:07:30.184283,Hamburguesas · Desayunos,El Inglés Gastro Pub,65000,6600,71600
19694,19695,21-10-2020 16:07:30.596299,Desayunos · Café,El Gualilo,35000,6200,41200
19695,19696,21-10-2020 16:07:30.906718,Desayunos,La Frijolada Desayunos,31800,4400,36200
19696,19697,21-10-2020 16:07:31.169697,Sushi,Kim Pop,65000,5400,70400
19697,19698,21-10-2020 16:07:31.330099,Postres · Desayunos,Maria Luisa - Postres,65000,4300,69300
19698,19699,21-10-2020 16:07:31.743764,Típica · Parrilla,Typykos,15600,6000,21600
19699,19700,21-10-2020 16:07:32.054559,Asiática,TeT,13000,5900,18900
19700,19701,21-10-2020 16:07:32.366847,Saludable · Desayunos,Básico y elemental,29500,5000,34500
19701,19702,21-10-2020 16:07:32.627993,Desayunos,Señor Desayuno,24300,6800,31100
19702,19703,21-10-2020 16:07:32.990371,Desayunos · Mexicana,La Mera Mera - Mexicana,29500,3100,32600
19703,19704,21-10-2020 16:07:33.251765,Sushi · Asiática,Tu Sushi,15600,6400,22000
19704,19705,21-10-2020 16:07:33.564225,Desayunos · Italiana,Rceta By Rausch,13000,3600,16600
19705,19706,21-10-2020 16:07:33.925040,Saludable · Desayunos,Maracuyá,35000,6700,41700
19706,19707,21-10-2020 16:07:34.086626,Pollo · China,China Tao,13000,3500,16500
19707,19708,21-10-2020 16:07:34.498133,Postres · Desayunos,Amelie Helados,15600,6400,22000
19708,19709,21-10-2020 16:07:34.810355,Pizza,18 Scalini,18900,4300,23200
19709,19710,21-10-2020 16:07:35.020208,Crepes,San Crepes,53400,4900,58300
19710,19711,21-10-2020 16:07:35.182707,Parrilla,Antojo a Domicilio,12500,5000,17500
19711,19712,21-10-2020 16:07:35.593291,Postres,Toledo Pastelería,23000,6800,29800
19712,19713,21-10-2020 16:07:36.005728,Saludable · Desayunos,Bawana - Sandwich,18900,3400,22300
19713,19714,21-10-2020 16:07:36.416758,Postres · Desayunos,Aury Postres - Comidas & Picadas,8900,4700,13600
19714,19715,21-10-2020 16:07:36.629655,Perros Calientes,Dog Shop - Rapida,48750,4900,53650
19715,19716,21-10-2020 16:07:36.840231,Helados,Buon Gelato,23000,4400,27400
19716,19717,21-10-2020 16:07:37.102323,Internacional,Rio Sabores y Experiencias,24200,4100,28300
19717,19718,21-10-2020 16:07:37.413390,Internacional,Rio Sabores y Experiencias,23000,4100,27100
19718,19719,21-10-2020 16:07:37.575375,Desayunos,Jacinta Arepas de Huevo,34500,4000,38500
19719,19720,21-10-2020 16:07:37.785643,Desayunos · Empanadas,Empanadas Doraditas.com,29500,3000,32500
19720,19721,21-10-2020 16:07:38.097923,Parrilla,Carnes la Zarza,35000,4900,39900
19721,19722,21-10-2020 16:07:38.508434,Desayunos · Empanadas,Empanadas Doraditas.com,70000,3000,73000
19722,19723,21-10-2020 16:07:38.670325,Hamburguesas,Bendito Cordero,24300,5800,30100
19723,19724,21-10-2020 16:07:38.880640,Sánduches · China,Peru Mix,35000,5900,40900
19724,19725,21-10-2020 16:07:39.293207,Típica · Parrilla,La Parilla de David,34500,3100,37600
19725,19726,21-10-2020 16:07:39.504696,Desayunos · Típica,Rojo Gourmet,15600,4700,20300
19726,19727,21-10-2020 16:07:39.817485,Típica · Pescados y Mariscos,Arroces Mrg,31800,4300,36100
19727,19728,21-10-2020 16:07:39.977814,Desayunos · Italiana,Rceta By Rausch,53400,3600,57000
19728,19729,21-10-2020 16:07:40.340178,Parrilla,Parrilla Pimentón,12500,3400,15900
19729,19730,21-10-2020 16:07:40.651159,Parrilla,Carnes la Zarza,11870,4900,16770
19730,19731,21-10-2020 16:07:40.963529,Peruana · Internacional,La Chifería,7500,6600,14100
19731,19732,21-10-2020 16:07:41.324185,Desayunos · Panadería,Santa Juana Food Bar,24300,5900,30200
19732,19733,21-10-2020 16:07:41.486232,Típica,Bandejas Mrg,70000,3800,73800
19733,19734,21-10-2020 16:07:41.846346,Italiana,F*cking Good Pizza,70000,4200,74200
19734,19735,21-10-2020 16:07:42.058499,Hamburguesas · Saludable,Restaurant Inn,37900,6100,44000
19735,19736,21-10-2020 16:07:42.269578,Sushi · Asiática,Tu Sushi,45800,6400,52200
19736,19737,21-10-2020 16:07:42.581518,Desayunos · Jugos y Batidos,Dont Be Hungry,70000,5600,75600
19737,19738,21-10-2020 16:07:42.742150,Mexicana,Hidalgo Taquería,15000,4900,19900
19738,19739,21-10-2020 16:07:43.054402,Sushi · Asiática,Tu Sushi,45800,6400,52200
19739,19740,21-10-2020 16:07:43.415347,Parrilla,Beraca Parrilla Bbq,35000,5600,40600
19740,19741,21-10-2020 16:07:43.577974,Sushi,Canoa To Go,45800,5900,51700
19741,19742,21-10-2020 16:07:43.738466,Desayunos · Panadería,Decofruta,13000,4700,17700
19742,19743,21-10-2020 16:07:43.951163,Desayunos · Típica,Desayunadero de la 42,9000,5900,14900
19743,19744,21-10-2020 16:07:44.312261,Desayunos · Típica,Papadió - Colombianas,17800,5700,23500
19744,19745,21-10-2020 16:07:44.674612,Postres · Desayunos,Sweet Tale,53400,5800,59200
19745,19746,21-10-2020 16:07:44.835056,Desayunos · Comida Rápida,Chocolatto,70000,3400,73400
19746,19747,21-10-2020 16:07:45.248102,Desayunos · Panadería,Pasteleite,53900,5900,59800
19747,19748,21-10-2020 16:07:45.409458,Desayunos · Italiana,Rceta By Rausch,34500,3600,38100
19748,19749,21-10-2020 16:07:45.621963,Poke,Poke Go,37900,4600,42500
19749,19750,21-10-2020 16:07:45.832382,Postres,La Galeta,27800,3000,30800
19750,19751,21-10-2020 16:07:46.195357,Parrilla,Arepaisa de Medellín,70000,5600,75600
19751,19752,21-10-2020 16:07:46.356753,Típica · Parrilla,El Portal de la Antigua,15600,5600,21200
19752,19753,21-10-2020 16:07:46.569893,Postres,Beiked,48750,4000,52750
19753,19754,21-10-2020 16:07:46.830164,Desayunos,Desayunos en Bogotá,35000,3400,38400
19754,19755,21-10-2020 16:07:47.192777,Asiática,Thai Station,35000,6000,41000
19755,19756,21-10-2020 16:07:47.553544,Saludable · Desayunos,La Estampilla,35000,6000,41000
19756,19757,21-10-2020 16:07:47.765594,Pollo · Pescados y Mariscos,Bang Bang Rice,37900,3400,41300
19757,19758,21-10-2020 16:07:48.025997,Desayunos · Comida Rápida,Chocolatto,29500,3400,32900
19758,19759,21-10-2020 16:07:48.438621,Sushi,Sushi Reel,9000,4700,13700
19759,19760,21-10-2020 16:07:48.849510,Saludable · Desayunos,La Cesta,11870,4700,16570
19760,19761,21-10-2020 16:07:49.262908,Hamburguesas · Saludable,Restaurant Inn,34500,6100,40600
19761,19762,21-10-2020 16:07:49.675307,Parrilla · Café,Figaro Café/ Restaurante Argentino,23000,5800,28800
19762,19763,21-10-2020 16:07:50.037445,Saludable · Típica,Saludable Mrg,39700,5800,45500
19763,19764,21-10-2020 16:07:50.198374,Desayunos · Café,Frambas,24300,3400,27700
19764,19765,21-10-2020 16:07:50.411366,Peruana,Uma Cantina Peruana,45800,3200,49000
19765,19766,21-10-2020 16:07:50.623452,Desayunos · Típica,Cochon,23000,3300,26300
19766,19767,21-10-2020 16:07:50.836229,Típica,Sabrosito,8900,4000,12900
19767,19768,21-10-2020 16:07:50.997942,Postres · Helados,Mahé,13600,6000,19600
19768,19769,21-10-2020 16:07:51.411317,Sushi · Asiática,Arigato,13000,5300,18300
19769,19770,21-10-2020 16:07:51.723534,Asiática,TeT,13600,5900,19500
19770,19771,21-10-2020 16:07:51.936584,Postres · Desayunos,Jacques Pastelería,11870,5900,17770
19771,19772,21-10-2020 16:07:52.098376,Pollo,Señor Fantástico,8900,4700,13600
19772,19773,21-10-2020 16:07:52.412208,Sushi · Desayunos,Maki Roll,37900,4300,42200
19773,19774,21-10-2020 16:07:52.824484,Desayunos,La Frijolada Desayunos,13000,4400,17400
19774,19775,21-10-2020 16:07:52.987292,Desayunos · Panadería,Choclofee,13600,4700,18300
19775,19776,21-10-2020 16:07:53.349408,Típica · Parrilla,Parrilla Farandula Gourmet,45800,5100,50900
19776,19777,21-10-2020 16:07:53.612775,Típica,La Herencia,11870,5900,17770
19777,19778,21-10-2020 16:07:53.773856,Pescados y Mariscos,La Gran Cazuela,11870,3200,15070
19778,19779,21-10-2020 16:07:54.187555,Desayunos · Sánduches,Danilo Colombia,53400,3300,56700
19779,19780,21-10-2020 16:07:54.499281,Desayunos · Típica,D'Porco - Lechona,39700,6300,46000
19780,19781,21-10-2020 16:07:54.714098,Peruana,Masivo,24200,5800,30000
19781,19782,21-10-2020 16:07:55.076358,Desayunos · Típica,La Parrilla Dorada Polo,10700,6600,17300
19782,19783,21-10-2020 16:07:55.440037,Saludable · Desayunos,Guadalupe - Fruteria,8900,5900,14800
19783,19784,21-10-2020 16:07:55.852185,Desayunos · Típica,Peninsula Calentados y Parrilla,10700,3400,14100
19784,19785,21-10-2020 16:07:56.266241,Peruana,Uma Cantina Peruana,15600,3200,18800
19785,19786,21-10-2020 16:07:56.428515,Típica,La Herencia,23000,5900,28900
19786,19787,21-10-2020 16:07:56.642504,Saludable · Parrilla,The Angels Grill and Drinks,18900,6200,25100
19787,19788,21-10-2020 16:07:56.803726,Desayunos · Panadería,Ficchi Panadería,9000,3100,12100
19788,19789,21-10-2020 16:07:56.965982,Desayunos · Café,Moramia,15000,4700,19700
19789,19790,21-10-2020 16:07:57.227036,Perros Calientes,Dog Shop - Rapida,10700,4900,15600
19790,19791,21-10-2020 16:07:57.639998,Típica · Parrilla,Parrilla Farandula Gourmet,13600,5100,18700
19791,19792,21-10-2020 16:07:58.051550,Sushi · Asiática,Arigato,39700,5300,45000
19792,19793,21-10-2020 16:07:58.314490,Pescados y Mariscos,Pescadero Héroes del Mar,70000,6600,76600
19793,19794,21-10-2020 16:07:58.725517,Típica,Carbón & Mondongos,10700,6400,17100
19794,19795,21-10-2020 16:07:58.937712,Típica,Bandejas Mrg,39700,3800,43500
19795,19796,21-10-2020 16:07:59.198947,Postres · Desayunos,Protein Bakes,29500,5900,35400
19796,19797,21-10-2020 16:07:59.612760,Postres · Desayunos,Café Quindio,53400,5700,59100
19797,19798,21-10-2020 16:07:59.775099,Pollo · Desayunos,Caserito Gourmet,8900,6700,15600
19798,19799,21-10-2020 16:07:59.937627,Desayunos · Típica,La Parrilla Dorada Polo,35000,6600,41600
19799,19800,21-10-2020 16:08:00.299273,Sánduches,Submarin,23000,3800,26800
19800,19801,21-10-2020 16:08:00.613606,Mexicana,Cantina La 15,7500,4300,11800
19801,19802,21-10-2020 16:08:01.025599,Poke,Poke Go,7500,4600,12100
19802,19803,21-10-2020 16:08:01.239954,Típica · Parrilla,El Portal de la Antigua,35000,5600,40600
19803,19804,21-10-2020 16:08:01.651473,Saludable · Desayunos,Bon Eat - Saludable,8900,4800,13700
19804,19805,21-10-2020 16:08:01.864057,Típica,Sabores De Mi Tierra,24200,5400,29600
19805,19806,21-10-2020 16:08:02.275547,Pizza · Italiana,Piatto - Pizza,29500,6600,36100
19806,19807,21-10-2020 16:08:02.639058,Sánduches,Submarin,17800,3800,21600
19807,19808,21-10-2020 16:08:02.899758,Helados,Buon Gelato,35000,4400,39400
19808,19809,21-10-2020 16:08:03.212366,Típica,El Mondongo y Mucho Mas,9000,5600,14600
19809,19810,21-10-2020 16:08:03.474062,Desayunos,El Corral - Desayunos,7500,5000,12500
19810,19811,21-10-2020 16:08:03.886567,Hamburguesas,Monchis - Hamburguesa,18900,4300,23200
19811,19812,21-10-2020 16:08:04.197555,Típica · Pescados y Mariscos,La Vitualla,29500,6300,35800
19812,19813,21-10-2020 16:08:04.610627,Saludable · Desayunos,Libre de Culpa,24200,4000,28200
19813,19814,21-10-2020 16:08:04.822373,Pizza · Italiana,Piatto - Pizza,35000,6600,41600
19814,19815,21-10-2020 16:08:05.085407,Mexicana,Mexicanachos,48750,3900,52650
19815,19816,21-10-2020 16:08:05.247057,Parrilla,Carnes la Zarza,15000,4900,19900
19816,19817,21-10-2020 16:08:05.559912,Desayunos · Café,Moramia,35000,4700,39700
19817,19818,21-10-2020 16:08:05.971086,Desayunos · Comida Rápida,Chocolatto,13600,3400,17000
19818,19819,21-10-2020 16:08:06.234768,Saludable · Desayunos,Copacabana Açai Bowls,53900,3000,56900
19819,19820,21-10-2020 16:08:06.395919,Jugos y Batidos,Pomponio,24200,3600,27800
19820,19821,21-10-2020 16:08:06.708368,Saludable · Típica,Sopas Mrg,23000,3100,26100
19821,19822,21-10-2020 16:08:06.969392,Saludable · Desayunos,La Estampilla,39700,6000,45700
19822,19823,21-10-2020 16:08:07.282349,Pollo · Saludable,Tremenda Sal y Dulce,39700,6500,46200
19823,19824,21-10-2020 16:08:07.693730,Sushi · Desayunos,Maki Roll,18900,4300,23200
19824,19825,21-10-2020 16:08:07.856388,Pollo,Señor Fantástico,11870,4700,16570
19825,19826,21-10-2020 16:08:08.117407,Peruana · Internacional,La Chifería,24200,6600,30800
19826,19827,21-10-2020 16:08:08.380259,Postres · Café,Celestino Café,11870,5900,17770
19827,19828,21-10-2020 16:08:08.691493,Sánduches,Submarin,24200,3800,28000
19828,19829,21-10-2020 16:08:09.003772,Desayunos · Típica,Fogón Sangileño,13600,5000,18600
19829,19830,21-10-2020 16:08:09.414736,Pollo · Pescados y Mariscos,Bang Bang Rice,12500,3400,15900
19830,19831,21-10-2020 16:08:09.777816,Crepes,La Chabatta,23000,5900,28900
19831,19832,21-10-2020 16:08:10.188860,Desayunos · Café,Moramia,23000,4700,27700
19832,19833,21-10-2020 16:08:10.601553,Saludable · Desayunos,Distrito Gourmet,37900,3700,41600
19833,19834,21-10-2020 16:08:10.962308,Típica · Pescados y Mariscos,Arroces Mrg,8900,4300,13200
19834,19835,21-10-2020 16:08:11.176489,Desayunos · Panadería,Decofruta,53400,4700,58100
19835,19836,21-10-2020 16:08:11.588419,Típica,El Mondongo y Mucho Mas,15600,5600,21200
19836,19837,21-10-2020 16:08:11.751638,Postres · Desayunos,Café Quindio,12500,5700,18200
19837,19838,21-10-2020 16:08:12.062330,Parrilla,OAK Ahumado y Brebajes,65000,6000,71000
19838,19839,21-10-2020 16:08:12.426050,Hamburguesas · Desayunos,El Inglés Gastro Pub,31800,6600,38400
19839,19840,21-10-2020 16:08:12.787417,Postres · Desayunos,Sharmus,13600,6100,19700
19840,19841,21-10-2020 16:08:12.999649,Típica,Carbón & Mondongos,11870,6400,18270
19841,19842,21-10-2020 16:08:13.360914,Desayunos · Pescados y Mariscos,Gypsy Bistro,31800,4500,36300
19842,19843,21-10-2020 16:08:13.524079,Típica,Cabrito Santandereano,45800,6600,52400
19843,19844,21-10-2020 16:08:13.884642,Hamburguesas,Burger Society,39700,4100,43800
19844,19845,21-10-2020 16:08:14.147675,Hamburguesas,Burger Society,12500,4100,16600
19845,19846,21-10-2020 16:08:14.308890,Desayunos · Típica,La Parrilla Dorada Polo,18900,6600,25500
19846,19847,21-10-2020 16:08:14.621497,Saludable,Amor Propio saludable,23000,4000,27000
19847,19848,21-10-2020 16:08:14.782964,Desayunos · Café,Norma's Ice Cream Café,39700,6300,46000
19848,19849,21-10-2020 16:08:15.095305,Hamburguesas,Gofi Burger,70000,5100,75100
19849,19850,21-10-2020 16:08:15.457440,Desayunos · Panadería,Le Pain Quotidien,18900,3900,22800
19850,19851,21-10-2020 16:08:15.621470,Desayunos · Típica,D´Porco,23000,3900,26900
19851,19852,21-10-2020 16:08:15.783482,Pescados y Mariscos,Fish Place - Del Mar,70000,5400,75400
19852,19853,21-10-2020 16:08:16.197640,Desayunos · Sánduches,Frutos del Bosque,15600,3500,19100
19853,19854,21-10-2020 16:08:16.558922,Saludable · Desayunos,Básico y elemental,10700,5000,15700
19854,19855,21-10-2020 16:08:16.922271,Desayunos · Típica,Papadió - Colombianas,18900,5700,24600
19855,19856,21-10-2020 16:08:17.083066,Postres · Desayunos,Cosmo Cookies,13600,5900,19500
19856,19857,21-10-2020 16:08:17.296357,Desayunos · Café,Frambas,34500,3400,37900
19857,19858,21-10-2020 16:08:17.707841,Desayunos · Internacional,Camilia,24300,3900,28200
19858,19859,21-10-2020 16:08:17.870295,Asiática,Thai Station,45800,6000,51800
19859,19860,21-10-2020 16:08:18.231346,Desayunos · Panadería,Le Pain Quotidien,24200,3900,28100
19860,19861,21-10-2020 16:08:18.594234,Pollo · Pescados y Mariscos,Bang Bang Rice,13600,3400,17000
19861,19862,21-10-2020 16:08:18.855427,Asiática,Thai Station,17800,6000,23800
19862,19863,21-10-2020 16:08:19.067818,Parrilla · Internacional,Taperia de la Plaza,8900,5700,14600
19863,19864,21-10-2020 16:08:19.479419,Desayunos · Típica,D´Porco,35000,3900,38900
19864,19865,21-10-2020 16:08:19.742257,Desayunos · Típica,D'Porco - Lechona,35000,6300,41300
19865,19866,21-10-2020 16:08:19.902789,Sushi,Canoa To Go,15600,5900,21500
19866,19867,21-10-2020 16:08:20.115415,Sánduches,Submarin,23000,3800,26800
19867,19868,21-10-2020 16:08:20.326258,Desayunos · Panadería,Le Pain Quotidien,53900,3900,57800
19868,19869,21-10-2020 16:08:20.538559,Postres · Desayunos,Café Quindio,18900,5700,24600
19869,19870,21-10-2020 16:08:20.799597,Desayunos · Café,Aromacafé el Placer de Compartir,48750,5000,53750
19870,19871,21-10-2020 16:08:21.061797,Hamburguesas · Alitas,Beer,34500,6600,41100
19871,19872,21-10-2020 16:08:21.423255,Desayunos · Panadería,Siena Café,37900,3700,41600
19872,19873,21-10-2020 16:08:21.736370,Parrilla,Arroces Maria Paula,31800,6800,38600
19873,19874,21-10-2020 16:08:21.897384,Postres · Desayunos,Café Quindio,18900,5700,24600
19874,19875,21-10-2020 16:08:22.209732,Pollo · China,China Tao,12500,3500,16000
19875,19876,21-10-2020 16:08:22.370464,Hamburguesas · Saludable,Restaurant Inn,10700,6100,16800
19876,19877,21-10-2020 16:08:22.683515,Típica,Cabrito Santandereano,8900,6600,15500
19877,19878,21-10-2020 16:08:22.944079,Saludable · Típica,Sopas Mrg,23000,3100,26100
19878,19879,21-10-2020 16:08:23.107168,Típica · Parrilla,Mi Ranchito Parrilla,23000,4400,27400
19879,19880,21-10-2020 16:08:23.318554,Postres · Desayunos,Sharmus,9000,6100,15100
19880,19881,21-10-2020 16:08:23.631579,Típica,Sabrosito,35000,4000,39000
19881,19882,21-10-2020 16:08:24.042651,Típica,La Cocina,23000,4600,27600
19882,19883,21-10-2020 16:08:24.257639,Hamburguesas,Bendito Cordero,8900,5800,14700
19883,19884,21-10-2020 16:08:24.619732,Desayunos · Típica,Desayunadero de la 42,31800,5900,37700
19884,19885,21-10-2020 16:08:24.782306,Pollo · Saludable,Tremenda Sal y Dulce,34500,6500,41000
19885,19886,21-10-2020 16:08:25.093107,Saludable · Desayunos,La Estampilla,15600,6000,21600
19886,19887,21-10-2020 16:08:25.306085,Pollo · Sánduches,Pollos Century,70000,3000,73000
19887,19888,21-10-2020 16:08:25.567788,Saludable,MIMA,48750,3700,52450
19888,19889,21-10-2020 16:08:25.730980,Desayunos,Archies Desayunos,13600,3100,16700
19889,19890,21-10-2020 16:08:26.042286,Postres · Desayunos,Jacques Pastelería,7500,5900,13400
19890,19891,21-10-2020 16:08:26.204956,Típica,Sopitas y Más,11870,4200,16070
19891,19892,21-10-2020 16:08:26.466121,Típica,Lo Nuestro,13000,3100,16100
19892,19893,21-10-2020 16:08:26.828445,Postres,Toledo Pastelería,23000,6800,29800
19893,19894,21-10-2020 16:08:26.989020,Jugos y Batidos,Pomponio,27800,3600,31400
19894,19895,21-10-2020 16:08:27.253481,Típica,Cabrito Santandereano,31800,6600,38400
19895,19896,21-10-2020 16:08:27.614505,Postres · Desayunos,Amelie Helados,7500,6400,13900
19896,19897,21-10-2020 16:08:27.827488,Postres,Beiked,23000,4000,27000
19897,19898,21-10-2020 16:08:28.238631,Saludable · Desayunos,Malú,8900,3700,12600
19898,19899,21-10-2020 16:08:28.601509,Mexicana,La leyenda mexican kitchen,18900,3200,22100
19899,19900,21-10-2020 16:08:28.962714,Saludable,Hanai - Bowls Saludables,23000,5900,28900
19900,19901,21-10-2020 16:08:29.225800,Pollo · Pescados y Mariscos,Bang Bang Rice,27800,3400,31200
19901,19902,21-10-2020 16:08:29.638227,Alta Cocina · Parrilla,Criterión,11870,6000,17870
19902,19903,21-10-2020 16:08:29.951462,Postres · Desayunos,BagBog Bagels,11870,6400,18270
19903,19904,21-10-2020 16:08:30.263468,Asiática,TeT,45800,5900,51700
19904,19905,21-10-2020 16:08:30.525972,Mexicana,Cantina La 15,11870,4300,16170
19905,19906,21-10-2020 16:08:30.837070,Desayunos · Típica,Peninsula Calentados y Parrilla,27800,3400,31200
19906,19907,21-10-2020 16:08:31.100952,Internacional,Rio Sabores y Experiencias,8900,4100,13000
19907,19908,21-10-2020 16:08:31.363334,Postres · Desayunos,Café Quindio,23000,5700,28700
19908,19909,21-10-2020 16:08:31.676186,Desayunos · Empanadas,Mis Delicias,53400,3200,56600
19909,19910,21-10-2020 16:08:31.887427,Postres · Café,Loló Coffee & Snacks,17800,4600,22400
19910,19911,21-10-2020 16:08:32.050011,Saludable,Amor Propio saludable,24200,4000,28200
19911,19912,21-10-2020 16:08:32.412204,Perros Calientes,Dog Shop - Rapida,13000,4900,17900
19912,19913,21-10-2020 16:08:32.825170,Hamburguesas · Alitas,Beer,17800,6600,24400
19913,19914,21-10-2020 16:08:33.186241,Desayunos · Árabe,Boniato Sabores Vivos,34500,5300,39800
19914,19915,21-10-2020 16:08:33.450016,Italiana,F*cking Good Pizza,17800,4200,22000
19915,19916,21-10-2020 16:08:33.861150,Desayunos · Panadería,Ficchi Panadería,9000,3100,12100
19916,19917,21-10-2020 16:08:34.124087,Desayunos · Típica,Peninsula Calentados y Parrilla,31800,3400,35200
19917,19918,21-10-2020 16:08:34.435636,Desayunos · Comida Rápida,La Veneca,23000,6300,29300
19918,19919,21-10-2020 16:08:34.799078,Desayunos,Don Leo,34500,6000,40500
19919,19920,21-10-2020 16:08:34.961072,Desayunos · Sánduches,Danilo Colombia,10700,3300,14000
19920,19921,21-10-2020 16:08:35.274853,Saludable · Desayunos,Re.al Alimentos Reales,23000,4000,27000
19921,19922,21-10-2020 16:08:35.436069,Desayunos · Típica,D'Porco - Lechona,53400,6300,59700
19922,19923,21-10-2020 16:08:35.599186,Pollo · Saludable,Yerbabuena,17800,3900,21700
19923,19924,21-10-2020 16:08:35.810595,Desayunos · Típica,Cochon,7500,3300,10800
19924,19925,21-10-2020 16:08:35.973864,Italiana,Bocatto Di Passo,24200,5000,29200
19925,19926,21-10-2020 16:08:36.136484,Postres · Desayunos,Maltihelados,9000,6200,15200
19926,19927,21-10-2020 16:08:36.349990,Desayunos · Típica,90 Calentados,31800,3700,35500
19927,19928,21-10-2020 16:08:36.611136,Típica,Juan Chorizo,45800,3900,49700
19928,19929,21-10-2020 16:08:36.975512,Pollo · Típica,Auyama,24300,3900,28200
19929,19930,21-10-2020 16:08:37.186458,Pescados y Mariscos,Pescadero Héroes del Mar,70000,6600,76600
19930,19931,21-10-2020 16:08:37.349115,Parrilla · Café,Figaro Café/ Restaurante Argentino,34500,5800,40300
19931,19932,21-10-2020 16:08:37.711080,Desayunos · Café,Matchacha,39700,5900,45600
19932,19933,21-10-2020 16:08:38.023805,Pizza · Italiana,Piatto - Pizza,34500,6600,41100
19933,19934,21-10-2020 16:08:38.235322,Postres · Desayunos,Restaurante Cornelia,37900,5500,43400
19934,19935,21-10-2020 16:08:38.598248,Típica,Sabores De Mi Tierra,35000,5400,40400
19935,19936,21-10-2020 16:08:39.009776,Sánduches · China,Peru Mix,15000,5900,20900
19936,19937,21-10-2020 16:08:39.222441,Mexicana,Cantina La 15,13600,4300,17900
19937,19938,21-10-2020 16:08:39.583806,Desayunos · Panadería,Pasteleite,9000,5900,14900
19938,19939,21-10-2020 16:08:39.846876,Desayunos · Panadería,Le Pain Quotidien,7500,3900,11400
19939,19940,21-10-2020 16:08:40.258414,Italiana,Bocatto Di Passo,27800,5000,32800
19940,19941,21-10-2020 16:08:40.422068,Típica · Parrilla,Parrilla Farandula Gourmet,70000,5100,75100
19941,19942,21-10-2020 16:08:40.833457,Típica,El Mondongo y Mucho Mas,15600,5600,21200
19942,19943,21-10-2020 16:08:41.096344,Desayunos · Café,Norma's Ice Cream Café,10700,6300,17000
19943,19944,21-10-2020 16:08:41.357937,Desayunos · Parrilla,Mi Patria,31800,4600,36400
19944,19945,21-10-2020 16:08:41.620738,Típica · Parrilla,Parrilla Farandula Gourmet,18900,5100,24000
19945,19946,21-10-2020 16:08:41.932390,Típica,Campo Victoria,7500,3000,10500
19946,19947,21-10-2020 16:08:42.095254,Saludable,Hanai - Bowls Saludables,29500,5900,35400
19947,19948,21-10-2020 16:08:42.356171,Internacional,Rio Sabores y Experiencias,45800,4100,49900
19948,19949,21-10-2020 16:08:42.669047,Parrilla,Rústico Picadería,11870,3800,15670
19949,19950,21-10-2020 16:08:42.831452,Típica · Parrilla,Mi Ranchito Parrilla,37900,4400,42300
19950,19951,21-10-2020 16:08:43.043957,Asiática,TeT,15000,5900,20900
19951,19952,21-10-2020 16:08:43.204940,Saludable · Desayunos,Maracuyá,7500,6700,14200
19952,19953,21-10-2020 16:08:43.618351,Típica · Parrilla,Toya,8900,4200,13100
19953,19954,21-10-2020 16:08:44.029762,Sushi,Sushi Reel,11870,4700,16570
19954,19955,21-10-2020 16:08:44.392659,Desayunos · Italiana,Rceta By Rausch,53400,3600,57000
19955,19956,21-10-2020 16:08:44.603649,Desayunos · Árabe,Boniato Sabores Vivos,8900,5300,14200
19956,19957,21-10-2020 16:08:44.916506,Saludable · Desayunos,Básico y Elemental,13000,5900,18900
19957,19958,21-10-2020 16:08:45.328104,Postres · Panadería,RIGHT AWAY FOODS,39700,6600,46300
19958,19959,21-10-2020 16:08:45.490803,Típica,La Cocina,34500,4600,39100
19959,19960,21-10-2020 16:08:45.701477,Desayunos · Café,Norma's Ice Cream Café,9000,6300,15300
19960,19961,21-10-2020 16:08:46.064425,Pollo · Saludable,Yerbabuena,53900,3900,57800
19961,19962,21-10-2020 16:08:46.375355,Poke,Poke Go,23000,4600,27600
19962,19963,21-10-2020 16:08:46.638241,Jugos y Batidos,Pomponio,9000,3600,12600
19963,19964,21-10-2020 16:08:46.899206,Panadería,Boul,12500,3100,15600
19964,19965,21-10-2020 16:08:47.111477,Pizza,pizza andante,23000,4200,27200
19965,19966,21-10-2020 16:08:47.523088,Desayunos · Comida Rápida,La Veneca,13600,6300,19900
19966,19967,21-10-2020 16:08:47.887056,Típica,Carbón & Mondongos,15000,6400,21400
19967,19968,21-10-2020 16:08:48.097801,Café · Helados,Sofia heladería y café,48750,5800,54550
19968,19969,21-10-2020 16:08:48.361117,Pollo · Saludable,Tremenda Sal y Dulce,13000,6500,19500
19969,19970,21-10-2020 16:08:48.672212,Desayunos · Típica,La Parrilla Dorada Polo,45800,6600,52400
19970,19971,21-10-2020 16:08:49.034891,Desayunos,El Fogón Castellano,18900,3200,22100
19971,19972,21-10-2020 16:08:49.296517,Típica · Parrilla,Typykos,8900,6000,14900
19972,19973,21-10-2020 16:08:49.609810,Típica,Campo Victoria,27800,3000,30800
19973,19974,21-10-2020 16:08:49.771339,Postres · Desayunos,Gelateria Da Favola,10700,6500,17200
19974,19975,21-10-2020 16:08:50.184799,Parrilla,Campocina,31800,4600,36400
19975,19976,21-10-2020 16:08:50.446918,Alta Cocina · Italiana,Trattoria de la Plaza,34500,6000,40500
19976,19977,21-10-2020 16:08:50.859769,Café · Helados,Sofia heladería y café,34500,5800,40300
19977,19978,21-10-2020 16:08:51.221600,Postres · Desayunos,Restaurante Cornelia,45800,5500,51300
19978,19979,21-10-2020 16:08:51.635226,Desayunos,Sunny Breakfast Brunch,10700,4300,15000
19979,19980,21-10-2020 16:08:51.996855,Desayunos · Panadería,Artesanos,15600,4300,19900
19980,19981,21-10-2020 16:08:52.359583,Pollo · Desayunos,Abasto,29500,3600,33100
19981,19982,21-10-2020 16:08:52.520971,Hamburguesas · Pescados y Mariscos,El Velero,70000,6500,76500
19982,19983,21-10-2020 16:08:52.885242,Pollo · Desayunos,Workzone,53400,3100,56500
19983,19984,21-10-2020 16:08:53.196888,Desayunos,Desayunos en Bogotá,11870,3400,15270
19984,19985,21-10-2020 16:08:53.359431,Desayunos · Típica,Criollomania,34500,5200,39700
19985,19986,21-10-2020 16:08:53.721544,Mexicana,La leyenda mexican kitchen,8900,3200,12100
19986,19987,21-10-2020 16:08:53.984354,Saludable · Parrilla,The Angels Grill and Drinks,53400,6200,59600
19987,19988,21-10-2020 16:08:54.295828,Desayunos · Típica,Papadió - Colombianas,35000,5700,40700
19988,19989,21-10-2020 16:08:54.508712,Desayunos · Típica,Calentao Express,17800,6000,23800
19989,19990,21-10-2020 16:08:54.870039,Típica,La Olla de Barro,15000,5300,20300
19990,19991,21-10-2020 16:08:55.032470,Pollo · Saludable,Yerbabuena,13600,3900,17500
19991,19992,21-10-2020 16:08:55.343540,Típica,Bendita S,10700,4600,15300
19992,19993,21-10-2020 16:08:55.606480,Sushi · Asiática,Tu Sushi,13600,6400,20000
19993,19994,21-10-2020 16:08:55.818359,Desayunos,Fratelli - Desayunos,9000,4600,13600
19994,19995,21-10-2020 16:08:56.032049,Poke,Poke Go,18900,4600,23500
19995,19996,21-10-2020 16:08:56.444070,Mexicana,La leyenda mexican kitchen,39700,3200,42900
19996,19997,21-10-2020 16:08:56.607625,Italiana,F*cking Good Pizza,13600,4200,17800
19997,19998,21-10-2020 16:08:56.919123,Sushi,Umi,8900,5600,14500
19998,19999,21-10-2020 16:08:57.182003,Jugos y Batidos,Pomponio,45800,3600,49400
19999,20000,21-10-2020 16:08:57.543810,Saludable · Desayunos,Distrito Gourmet,53900,3700,57600
20000,20001,21-10-2020 16:08:57.907598,Desayunos · Panadería,El Pan de Phillippe,24200,4600,28800
20001,20002,21-10-2020 16:08:58.169558,Pollo · Desayunos,Candelina,13600,5300,18900
20002,20003,21-10-2020 16:08:58.382842,Peruana,Uma Cantina Peruana,53400,3200,56600
20003,20004,21-10-2020 16:08:58.644493,Perros Calientes,Dog Shop - Rapida,37900,4900,42800
20004,20005,21-10-2020 16:08:58.807490,Típica · Parrilla,Parrilla Farandula Gourmet,31800,5100,36900
20005,20006,21-10-2020 16:08:59.169232,Internacional,La Esquina con Sabor Parrilla,31800,3000,34800
20006,20007,21-10-2020 16:08:59.381923,Pizza · Italiana,Piatto - Pizza,35000,6600,41600
20007,20008,21-10-2020 16:08:59.542915,Desayunos,El Corral - Desayunos,15000,5000,20000
20008,20009,21-10-2020 16:08:59.905894,Alta Cocina · Parrilla,Criterión,15000,6000,21000
20009,20010,21-10-2020 16:09:00.116982,Peruana · Internacional,La Chifería,15600,6600,22200
20010,20011,21-10-2020 16:09:00.530349,Desayunos · Café,vereda central calle 99,24200,5700,29900
20011,20012,21-10-2020 16:09:00.941444,Postres · Desayunos,Maltihelados,65000,6200,71200
20012,20013,21-10-2020 16:09:01.154585,Postres · Desayunos,Maltihelado,24300,4500,28800
20013,20014,21-10-2020 16:09:01.565844,Pollo · Desayunos,Caserito Gourmet,53900,6700,60600
20014,20015,21-10-2020 16:09:01.778783,Parrilla,El Tambor,27800,6800,34600
20015,20016,21-10-2020 16:09:02.040143,Saludable · Parrilla,The Angels Grill and Drinks,65000,6200,71200
20016,20017,21-10-2020 16:09:02.203094,Desayunos · Sánduches,Garnish,10700,5200,15900
20017,20018,21-10-2020 16:09:02.614528,Pescados y Mariscos,Fish Place - Del Mar,34500,5400,39900
20018,20019,21-10-2020 16:09:02.777794,Hamburguesas · Desayunos,El Inglés Gastro Pub,15600,6600,22200
20019,20020,21-10-2020 16:09:03.139802,Desayunos · Típica,Parrilla Farandula Típico,31800,5900,37700
20020,20021,21-10-2020 16:09:03.453708,Saludable · Típica,Sopas Mrg,27800,3100,30900
20021,20022,21-10-2020 16:09:03.865148,Postres · Desayunos,Gelateria Da Favola,9000,6500,15500
20022,20023,21-10-2020 16:09:04.178163,Desayunos · Café,Matchacha,15000,5900,20900
20023,20024,21-10-2020 16:09:04.339188,Pollo · Desayunos,Caserito Gourmet,23000,6700,29700
20024,20025,21-10-2020 16:09:04.652164,Postres · Desayunos,Café Quindio,17800,5700,23500
20025,20026,21-10-2020 16:09:05.013456,Desayunos · Típica,Peninsula Calentados y Parrilla,29500,3400,32900
20026,20027,21-10-2020 16:09:05.277883,Pollo · Desayunos,Caserito Gourmet,23000,6700,29700
20027,20028,21-10-2020 16:09:05.538969,Desayunos · Comida Rápida,Chocolatto,24300,3400,27700
20028,20029,21-10-2020 16:09:05.802106,Desayunos,Señor Desayuno,24300,6800,31100
20029,20030,21-10-2020 16:09:06.213666,Peruana,Uma Cantina Peruana,13000,3200,16200
20030,20031,21-10-2020 16:09:06.626833,Pizza · Parrilla,Urban Lunch,24200,4000,28200
20031,20032,21-10-2020 16:09:07.038233,Parrilla · Café,Figaro Café/ Restaurante Argentino,53400,5800,59200
20032,20033,21-10-2020 16:09:07.351716,Desayunos,El Fogón Castellano,70000,3200,73200
20033,20034,21-10-2020 16:09:07.713231,Saludable,Hanai - Bowls Saludables,48750,5900,54650
20034,20035,21-10-2020 16:09:07.926431,Pescados y Mariscos,Pescadero Héroes del Mar,35000,6600,41600
20035,20036,21-10-2020 16:09:08.289570,Desayunos · Típica,La Parrilla Dorada Polo,65000,6600,71600
20036,20037,21-10-2020 16:09:08.602721,Parrilla,Beraca Parrilla Bbq,31800,5600,37400
20037,20038,21-10-2020 16:09:08.914743,Desayunos · Panadería,Decofruta,31800,4700,36500
20038,20039,21-10-2020 16:09:09.127792,Desayunos,El Corral - Desayunos,31800,5000,36800
20039,20040,21-10-2020 16:09:09.289461,Sushi,Kim Pop,27800,5400,33200
20040,20041,21-10-2020 16:09:09.502943,Parrilla · Internacional,Taperia de la Plaza,9000,5700,14700
20041,20042,21-10-2020 16:09:09.764389,Saludable · Desayunos,Maracuyá,39700,6700,46400
20042,20043,21-10-2020 16:09:10.027421,Desayunos · Típica,Criollomania,31800,5200,37000
20043,20044,21-10-2020 16:09:10.338503,Saludable · Parrilla,Box,29500,3700,33200
20044,20045,21-10-2020 16:09:10.552242,Desayunos,Don Leo,13000,6000,19000
20045,20046,21-10-2020 16:09:10.813353,Desayunos,Cafetería el Kippe,34500,3200,37700
20046,20047,21-10-2020 16:09:11.126808,Desayunos · Café,Libertario Coffee Roasters,39700,4600,44300
20047,20048,21-10-2020 16:09:11.388217,Típica,Campo Victoria,12500,3000,15500
20048,20049,21-10-2020 16:09:11.801458,Desayunos,El Corral - Desayunos,13600,5000,18600
20049,20050,21-10-2020 16:09:12.113439,Desayunos · Típica,Desayunadero de la 42,9000,5900,14900
20050,20051,21-10-2020 16:09:12.377011,Crepes,La Chabatta,27800,5900,33700
20051,20052,21-10-2020 16:09:12.539098,Pizza,Pizza Andante,13000,6300,19300
20052,20053,21-10-2020 16:09:12.702957,Desayunos · Panadería,Limarys,65000,6500,71500
20053,20054,21-10-2020 16:09:13.014105,Postres · Desayunos,Protein Bakes,7500,5900,13400
20054,20055,21-10-2020 16:09:13.327955,Típica,Juan Chorizo,35000,3900,38900
20055,20056,21-10-2020 16:09:13.539994,Desayunos · Comida Rápida,La Veneca,53400,6300,59700
20056,20057,21-10-2020 16:09:13.803511,Parrilla,OAK Ahumado y Brebajes,65000,6000,71000
20057,20058,21-10-2020 16:09:14.165040,Típica,La Cocina,11870,4600,16470
20058,20059,21-10-2020 16:09:14.528194,Crepes,San Crepes,39700,4900,44600
20059,20060,21-10-2020 16:09:14.839893,Asiática,TeT,37900,5900,43800
20060,20061,21-10-2020 16:09:15.203224,Desayunos · Panadería,Ficchi Panadería,27800,3100,30900
20061,20062,21-10-2020 16:09:15.415221,Internacional,Rio Sabores y Experiencias,12500,4100,16600
20062,20063,21-10-2020 16:09:15.578298,Desayunos · Panadería,Siena Café,15600,3700,19300
20063,20064,21-10-2020 16:09:15.940070,Hamburguesas · Desayunos,El Inglés Gastro Pub,23000,6600,29600
20064,20065,21-10-2020 16:09:16.303511,Pizza · Italiana,Piatto - Pizza,27800,6600,34400
20065,20066,21-10-2020 16:09:16.515189,Típica · Pescados y Mariscos,Arroces Mrg,17800,4300,22100
20066,20067,21-10-2020 16:09:16.828690,Postres · Desayunos,Aury Postres - Comidas & Picadas,27800,4700,32500
20067,20068,21-10-2020 16:09:17.040603,Comida Rápida,Fiesta Digital Andrés,8900,3100,12000
20068,20069,21-10-2020 16:09:17.203788,Internacional,La Esquina con Sabor Parrilla,27800,3000,30800
20069,20070,21-10-2020 16:09:17.415342,Saludable · Desayunos,Básico y Elemental,65000,5900,70900
20070,20071,21-10-2020 16:09:17.829359,Postres,Levelma,35000,6200,41200
20071,20072,21-10-2020 16:09:18.241674,Desayunos · Panadería,Limarys,24300,6500,30800
20072,20073,21-10-2020 16:09:18.556447,Desayunos · Café,Frambas,35000,3400,38400
20073,20074,21-10-2020 16:09:18.968365,Mexicana,Mexicanachos,9000,3900,12900
20074,20075,21-10-2020 16:09:19.382565,Perros Calientes,Dog Shop - Rapida,31800,4900,36700
20075,20076,21-10-2020 16:09:19.644496,Internacional,Rio Sabores y Experiencias,9000,4100,13100
20076,20077,21-10-2020 16:09:19.958172,Típica,Carbón & Mondongos,12500,6400,18900
20077,20078,21-10-2020 16:09:20.119800,Hamburguesas,Gofi Burger,45800,5100,50900
20078,20079,21-10-2020 16:09:20.483807,Saludable · Típica,Sopas Mrg,7500,3100,10600
20079,20080,21-10-2020 16:09:20.745627,Parrilla,Arepaisa de Medellín,10700,5600,16300
20080,20081,21-10-2020 16:09:21.109281,Pizza · Italiana,Piatto - Pizza,65000,6600,71600
20081,20082,21-10-2020 16:09:21.421406,Parrilla,Carnes la Zarza,23000,4900,27900
20082,20083,21-10-2020 16:09:21.834740,Desayunos · Café,Libertario Coffee Roasters,45800,4600,50400
20083,20084,21-10-2020 16:09:22.246950,Desayunos,Don Leo,35000,6000,41000
20084,20085,21-10-2020 16:09:22.560623,Pizza,18 Scalini,23000,4300,27300
20085,20086,21-10-2020 16:09:22.721989,Saludable · Desayunos,Básico y elemental,12500,5000,17500
20086,20087,21-10-2020 16:09:23.086350,Típica · Pescados y Mariscos,La Vitualla,39700,6300,46000
20087,20088,21-10-2020 16:09:23.348533,Desayunos · Jugos y Batidos,Kuriwaji,45800,6300,52100
20088,20089,21-10-2020 16:09:23.664539,Hamburguesas · Saludable,Restaurant Inn,12500,6100,18600
20089,20090,21-10-2020 16:09:23.976800,Desayunos · Café,Norma's Ice Cream Café,65000,6300,71300
20090,20091,21-10-2020 16:09:24.340240,Típica,Bandejas Mrg,37900,3800,41700
20091,20092,21-10-2020 16:09:24.752668,Desayunos · Típica,Cochon,9000,3300,12300
20092,20093,21-10-2020 16:09:25.015722,Postres · Desayunos,Protein Bakes,15000,5900,20900
20093,20094,21-10-2020 16:09:25.377244,Postres · Desayunos,Restaurante Cornelia,13000,5500,18500
20094,20095,21-10-2020 16:09:25.540430,Postres · Desayunos,Amelie Helados,65000,6400,71400
20095,20096,21-10-2020 16:09:25.802173,Típica · Parrilla,Typykos,70000,6000,76000
20096,20097,21-10-2020 16:09:26.065272,Italiana,Bocatto Di Passo,15600,5000,20600
20097,20098,21-10-2020 16:09:26.226803,Desayunos · Árabe,Boniato Sabores Vivos,34500,5300,39800
20098,20099,21-10-2020 16:09:26.540245,Desayunos · Típica,Calentao Express,17800,6000,23800
20099,20100,21-10-2020 16:09:26.952126,Internacional,Rio Sabores y Experiencias,35000,4100,39100
20100,20101,21-10-2020 16:09:27.365804,Parrilla · Internacional,Taperia de la Plaza,45800,5700,51500
20101,20102,21-10-2020 16:09:27.728117,Desayunos · Panadería,Juliana Restaurante,23000,6100,29100
20102,20103,21-10-2020 16:09:27.891179,Hamburguesas · Saludable,Restaurant Inn,15000,6100,21100
20103,20104,21-10-2020 16:09:28.202819,Desayunos · Típica,D'Porco - Lechona,53900,6300,60200
20104,20105,21-10-2020 16:09:28.466307,Parrilla,Arroces Maria Paula,35000,6800,41800
20105,20106,21-10-2020 16:09:28.678193,Peruana,Masivo,35000,5800,40800
20106,20107,21-10-2020 16:09:28.991785,Típica,Lo Nuestro,27800,3100,30900
20107,20108,21-10-2020 16:09:29.403403,Postres,La Galeta,35000,3000,38000
20108,20109,21-10-2020 16:09:29.817474,Típica · Pescados y Mariscos,Arroces Mrg,17800,4300,22100
20109,20110,21-10-2020 16:09:30.229466,Pollo,Heart & Cooking,24200,5000,29200
20110,20111,21-10-2020 16:09:30.392537,Parrilla,Arroces Maria Paula,13000,6800,19800
20111,20112,21-10-2020 16:09:30.804204,Postres · Desayunos,Vivalight Market.,15000,6500,21500
20112,20113,21-10-2020 16:09:30.966931,Postres,Beiked,15600,4000,19600
20113,20114,21-10-2020 16:09:31.178556,Pollo · Desayunos,Caserito Gourmet,37900,6700,44600
20114,20115,21-10-2020 16:09:31.442771,Desayunos · Panadería,Artesanos,65000,4300,69300
20115,20116,21-10-2020 16:09:31.854472,Desayunos · Panadería,Limarys,18900,6500,25400
20116,20117,21-10-2020 16:09:32.269399,Sánduches · China,Peru Mix,35000,5900,40900
20117,20118,21-10-2020 16:09:32.532108,Saludable · Desayunos,Distrito Gourmet,13000,3700,16700
20118,20119,21-10-2020 16:09:32.846506,Desayunos · Típica,Calentao Express,65000,6000,71000
20119,20120,21-10-2020 16:09:33.108376,Desayunos · Panadería,Siena Café,13600,3700,17300
20120,20121,21-10-2020 16:09:33.472104,Saludable · Desayunos,Bawana - Sandwich,13600,3400,17000
20121,20122,21-10-2020 16:09:33.684258,Perros Calientes,Dog Shop - Rapida,8900,4900,13800
20122,20123,21-10-2020 16:09:34.097627,Postres · Desayunos,Maltihelado,23000,4500,27500
20123,20124,21-10-2020 16:09:34.510137,Panadería,Boul,53900,3100,57000
20124,20125,21-10-2020 16:09:34.825626,Desayunos · Pescados y Mariscos,Luzí­a - Mediterranea,12500,5700,18200
20125,20126,21-10-2020 16:09:35.238242,Peruana,Masivo,29500,5800,35300
20126,20127,21-10-2020 16:09:35.551757,Típica,Sopitas y Más,35000,4200,39200
20127,20128,21-10-2020 16:09:35.712793,Desayunos · Típica,Casa Vieja,24300,6000,30300
20128,20129,21-10-2020 16:09:36.076356,Pollo · China,China Tao,65000,3500,68500
20129,20130,21-10-2020 16:09:36.288247,Hamburguesas · Alitas,Beer,7500,6600,14100
20130,20131,21-10-2020 16:09:36.501819,Desayunos · Panadería,Choclofee,12500,4700,17200
20131,20132,21-10-2020 16:09:36.713538,Pescados y Mariscos,La Gran Cazuela,35000,3200,38200
20132,20133,21-10-2020 16:09:37.127832,Desayunos · Panadería,Premium Break Bakery,15600,3700,19300
20133,20134,21-10-2020 16:09:37.290294,Perros Calientes,Dog Shop - Rapida,17800,4900,22700
20134,20135,21-10-2020 16:09:37.454227,Saludable · Desayunos,Libre de Culpa,13600,4000,17600
20135,20136,21-10-2020 16:09:37.665949,Jugos y Batidos,Pomponio,8900,3600,12500
20136,20137,21-10-2020 16:09:37.979447,Desayunos,Sunny Breakfast Brunch,37900,4300,42200
20137,20138,21-10-2020 16:09:38.141472,Desayunos · Helados,San Giorgio Gelateria,13600,3100,16700
20138,20139,21-10-2020 16:09:38.354974,Hamburguesas,Bendito Cordero,15000,5800,20800
20139,20140,21-10-2020 16:09:38.567033,Parrilla,Carnes la Zarza,9000,4900,13900
20140,20141,21-10-2020 16:09:38.931283,Parrilla,Beraca Parrilla Bbq,23000,5600,28600
20141,20142,21-10-2020 16:09:39.242985,Desayunos · Panadería,Pasteleite,8900,5900,14800
20142,20143,21-10-2020 16:09:39.506289,Típica,Sopitas y Más,7500,4200,11700
20143,20144,21-10-2020 16:09:39.918836,Hamburguesas,Gofi Burger,70000,5100,75100
20144,20145,21-10-2020 16:09:40.134053,Desayunos · Jugos y Batidos,Kuriwaji,53400,6300,59700
20145,20146,21-10-2020 16:09:40.347004,Saludable · Desayunos,Copacabana Açai Bowls,13600,3000,16600
20146,20147,21-10-2020 16:09:40.762243,Pizza · Italiana,Pisapore - Pizza,23000,6600,29600
20147,20148,21-10-2020 16:09:40.924357,Pollo · Típica,Auyama,17800,3900,21700
20148,20149,21-10-2020 16:09:41.088347,Saludable · Desayunos,Fresh Co,8900,5600,14500
20149,20150,21-10-2020 16:09:41.500418,Mexicana,Mexicanachos,18900,3900,22800
20150,20151,21-10-2020 16:09:41.815290,Postres · Saludable,Ana Rebana,24200,6300,30500
20151,20152,21-10-2020 16:09:41.978022,Desayunos · Sánduches,Frutos del Bosque,8900,3500,12400
20152,20153,21-10-2020 16:09:42.242622,Parrilla,Carnes la Zarza,39700,4900,44600
20153,20154,21-10-2020 16:09:42.404761,Desayunos · Típica,Criollomania,48750,5200,53950
20154,20155,21-10-2020 16:09:42.569823,Típica,El Cucharón - Tipica,70000,4400,74400
20155,20156,21-10-2020 16:09:42.982175,Postres,La Tertulia,17800,3400,21200
20156,20157,21-10-2020 16:09:43.246603,Pollo · China,China Tao,34500,3500,38000
20157,20158,21-10-2020 16:09:43.559589,Típica,El Cucharón - Tipica,12500,4400,16900
20158,20159,21-10-2020 16:09:43.975072,Desayunos · Típica,D'Porco - Lechona,70000,6300,76300
20159,20160,21-10-2020 16:09:44.287900,Desayunos · Típica,Rojo Gourmet,45800,4700,50500
20160,20161,21-10-2020 16:09:44.652007,Postres · Desayunos,Cosmo Cookies,24200,5900,30100
20161,20162,21-10-2020 16:09:44.814314,Postres · Desayunos,Maltihelados,15000,6200,21200
20162,20163,21-10-2020 16:09:45.128244,Sánduches,Submarin,23000,3800,26800
20163,20164,21-10-2020 16:09:45.290562,Sánduches · China,Peru Mix,11870,5900,17770
20164,20165,21-10-2020 16:09:45.705090,Italiana,Bocatto Di Passo,39700,5000,44700
20165,20166,21-10-2020 16:09:46.067555,Hamburguesas · Pescados y Mariscos,El Velero,15600,6500,22100
20166,20167,21-10-2020 16:09:46.481911,Desayunos · Típica,Casa Vieja,35000,6000,41000
20167,20168,21-10-2020 16:09:46.694617,Alta Cocina · Italiana,Trattoria de la Plaza,13600,6000,19600
20168,20169,21-10-2020 16:09:47.108521,Típica,El Cucharón - Tipica,29500,4400,33900
20169,20170,21-10-2020 16:09:47.271728,Típica,Carbón & Mondongos,17800,6400,24200
20170,20171,21-10-2020 16:09:47.536185,Parrilla,Rústico Picadería,10700,3800,14500
20171,20172,21-10-2020 16:09:47.899120,Desayunos · Empanadas,Mis Delicias,18900,3200,22100
20172,20173,21-10-2020 16:09:48.063663,Parrilla,Arepaisa de Medellín,34500,5600,40100
20173,20174,21-10-2020 16:09:48.376138,Saludable · Desayunos,Copacabana Açai Bowls,48750,3000,51750
20174,20175,21-10-2020 16:09:48.640530,Postres · Desayunos,Amelie Helados,24300,6400,30700
20175,20176,21-10-2020 16:09:48.952486,Pollo · Saludable,Gratina,45800,4200,50000
20176,20177,21-10-2020 16:09:49.167727,Hamburguesas · Desayunos,El Inglés Gastro Pub,15600,6600,22200
20177,20178,21-10-2020 16:09:49.580520,Hamburguesas · Alitas,Beer,15000,6600,21600
20178,20179,21-10-2020 16:09:49.845290,Desayunos · Italiana,Rceta By Rausch,34500,3600,38100
20179,20180,21-10-2020 16:09:50.258454,Peruana,Masivo,29500,5800,35300
20180,20181,21-10-2020 16:09:50.622709,Hamburguesas · Alitas,Beer,17800,6600,24400
20181,20182,21-10-2020 16:09:50.834936,Saludable · Desayunos,Raices Bienestar Gourmet,70000,6600,76600
20182,20183,21-10-2020 16:09:51.198550,Desayunos · Mexicana,La Mera Mera - Mexicana,37900,3100,41000
20183,20184,21-10-2020 16:09:51.610470,Pizza · Italiana,Piatto - Pizza,13000,6600,19600
20184,20185,21-10-2020 16:09:51.824360,Postres · Desayunos,Maltihelado,23000,4500,27500
20185,20186,21-10-2020 16:09:52.086207,Parrilla · Café,Figaro Café/ Restaurante Argentino,13000,5800,18800
20186,20187,21-10-2020 16:09:52.349811,Pollo · Típica,Auyama,37900,3900,41800
20187,20188,21-10-2020 16:09:52.611708,Desayunos · Italiana,Rceta By Rausch,24300,3600,27900
20188,20189,21-10-2020 16:09:52.825610,Postres,Beiked,65000,4000,69000
20189,20190,21-10-2020 16:09:53.138071,Saludable,A2manos,37900,4200,42100
20190,20191,21-10-2020 16:09:53.351164,Desayunos · Panadería,Juliana Restaurante,8900,6100,15000
20191,20192,21-10-2020 16:09:53.763647,Postres · Desayunos,La Folie - Postres,35000,3300,38300
20192,20193,21-10-2020 16:09:53.977559,Peruana,Uma Cantina Peruana,48750,3200,51950
20193,20194,21-10-2020 16:09:54.391127,Saludable · Parrilla,Box,11870,3700,15570
20194,20195,21-10-2020 16:09:54.655156,Desayunos · Panadería,Limarys,48750,6500,55250
20195,20196,21-10-2020 16:09:55.067377,Desayunos · Panadería,Santa Juana Food Bar,53400,5900,59300
20196,20197,21-10-2020 16:09:55.482424,Típica,Cazuelitas 93,12500,3900,16400
20197,20198,21-10-2020 16:09:55.644417,Mexicana,Hidalgo Taquería,48750,4900,53650
20198,20199,21-10-2020 16:09:55.807955,Típica,Salsig,7500,5600,13100
20199,20200,21-10-2020 16:09:56.120628,Hamburguesas · Saludable,Restaurant Inn,39700,6100,45800
20200,20201,21-10-2020 16:09:56.334511,Parrilla · Internacional,Taperia de la Plaza,29500,5700,35200
20201,20202,21-10-2020 16:09:56.546914,Parrilla,Carnes la Zarza,13000,4900,17900
20202,20203,21-10-2020 16:09:56.761288,Parrilla,OAK Ahumado y Brebajes,11870,6000,17870
20203,20204,21-10-2020 16:09:56.973686,Desayunos · Empanadas,Empanadas Doraditas.com,35000,3000,38000
20204,20205,21-10-2020 16:09:57.387626,Saludable,MIMA,27800,3700,31500
20205,20206,21-10-2020 16:09:57.650484,Desayunos · Panadería,Choclofee,17800,4700,22500
20206,20207,21-10-2020 16:09:58.064583,Saludable · Típica,Saludable Mrg,53400,5800,59200
20207,20208,21-10-2020 16:09:58.327535,Pollo · Típica,Auyama,45800,3900,49700
20208,20209,21-10-2020 16:09:58.642178,Sánduches · China,Peru Mix,17800,5900,23700
20209,20210,21-10-2020 16:09:59.054572,Postres · Desayunos,Maltihelado,11870,4500,16370
20210,20211,21-10-2020 16:09:59.470169,Hamburguesas,Burger Society,27800,4100,31900
20211,20212,21-10-2020 16:09:59.782608,Pescados y Mariscos,Pescadero Héroes del Mar,35000,6600,41600
20212,20213,21-10-2020 16:09:59.946586,Saludable · Desayunos,Maracuyá,29500,6700,36200
20213,20214,21-10-2020 16:10:00.359089,Pollo · Saludable,Gratina,37900,4200,42100
20214,20215,21-10-2020 16:10:00.574157,Saludable · Desayunos,La Estampilla,48750,6000,54750
20215,20216,21-10-2020 16:10:00.936612,Típica · Pescados y Mariscos,La Vitualla,15600,6300,21900
20216,20217,21-10-2020 16:10:01.201196,Asiática,TeT,8900,5900,14800
20217,20218,21-10-2020 16:10:01.463541,Pollo · Pescados y Mariscos,Bang Bang Rice,12500,3400,15900
20218,20219,21-10-2020 16:10:01.627826,Hamburguesas · Saludable,Restaurant Inn,31800,6100,37900
20219,20220,21-10-2020 16:10:01.789441,Pollo · Desayunos,Candelina,24300,5300,29600
20220,20221,21-10-2020 16:10:02.153524,Desayunos · Café,Matchacha,11870,5900,17770
20221,20222,21-10-2020 16:10:02.315246,Desayunos · Panadería,Pasteleite,27800,5900,33700
20222,20223,21-10-2020 16:10:02.528576,Desayunos,Bagel Shop,17800,3200,21000
20223,20224,21-10-2020 16:10:02.690579,Pescados y Mariscos,La Gran Cazuela,9000,3200,12200
20224,20225,21-10-2020 16:10:03.054444,Típica,Cabrito Santandereano,7500,6600,14100
20225,20226,21-10-2020 16:10:03.467150,Internacional,La Esquina con Sabor Parrilla,65000,3000,68000
20226,20227,21-10-2020 16:10:03.881588,Saludable · Jugos y Batidos,Berdes Drinks & Salads,48750,3500,52250
20227,20228,21-10-2020 16:10:04.143941,Típica · Parrilla,La Ternera Parrilla,65000,5200,70200
20228,20229,21-10-2020 16:10:04.558966,Parrilla,OAK Ahumado y Brebajes,29500,6000,35500
20229,20230,21-10-2020 16:10:04.820664,China,China Food Col,15000,3600,18600
20230,20231,21-10-2020 16:10:05.235320,Postres · Desayunos,La Folie - Postres,13000,3300,16300
20231,20232,21-10-2020 16:10:05.447718,Parrilla,Coquitas,12500,5600,18100
20232,20233,21-10-2020 16:10:05.661587,Postres · Desayunos,Sharmus,37900,6100,44000
20233,20234,21-10-2020 16:10:05.922953,Asiática,TeT,27800,5900,33700
20234,20235,21-10-2020 16:10:06.237020,Desayunos · Típica,D´Porco,34500,3900,38400
20235,20236,21-10-2020 16:10:06.499160,Pollo · Pescados y Mariscos,Bang Bang Rice,10700,3400,14100
20236,20237,21-10-2020 16:10:06.663203,Desayunos · Panadería,Santa Juana Food Bar,11870,5900,17770
20237,20238,21-10-2020 16:10:07.025352,Parrilla · Internacional,Taperia de la Plaza,15000,5700,20700
20238,20239,21-10-2020 16:10:07.439887,Desayunos · Típica,Papadió - Colombianas,23000,5700,28700
20239,20240,21-10-2020 16:10:07.802049,Desayunos · Panadería,Le Pain Quotidien,31800,3900,35700
20240,20241,21-10-2020 16:10:08.015161,Desayunos · Café,Norma's Ice Cream Café,29500,6300,35800
20241,20242,21-10-2020 16:10:08.277441,Internacional,La Esquina con Sabor Parrilla,13600,3000,16600
20242,20243,21-10-2020 16:10:08.642395,Típica,La Olla de Barro,48750,5300,54050
20243,20244,21-10-2020 16:10:08.854227,Típica,Cabrito Santandereano,24300,6600,30900
20244,20245,21-10-2020 16:10:09.268782,Desayunos · Típica,Casa Vieja,13600,6000,19600
20245,20246,21-10-2020 16:10:09.581769,Desayunos,Cafetería el Kippe,15600,3200,18800
20246,20247,21-10-2020 16:10:09.846302,Pizza,Pizza Andante,23000,6300,29300
20247,20248,21-10-2020 16:10:10.058235,Parrilla,Coquitas,23000,5600,28600
20248,20249,21-10-2020 16:10:10.422978,Desayunos,El Corral - Desayunos,13600,5000,18600
20249,20250,21-10-2020 16:10:10.585516,Peruana,Uma Cantina Peruana,15600,3200,18800
20250,20251,21-10-2020 16:10:10.800418,Desayunos,Sr Buñuelo,10700,6400,17100
20251,20252,21-10-2020 16:10:11.063242,Típica,Campo Victoria,31800,3000,34800
20252,20253,21-10-2020 16:10:11.278657,Hamburguesas · Panadería,NYC Burgers,15000,6200,21200
20253,20254,21-10-2020 16:10:11.441249,Pollo,Chicken House,37900,4200,42100
20254,20255,21-10-2020 16:10:11.805372,Helados,Buon Gelato,24300,4400,28700
20255,20256,21-10-2020 16:10:12.117369,Típica,Juan Chorizo,53400,3900,57300
20256,20257,21-10-2020 16:10:12.281889,Desayunos · Empanadas,Mis Delicias,10700,3200,13900
20257,20258,21-10-2020 16:10:12.694335,Desayunos,Sunny Breakfast Brunch,31800,4300,36100
20258,20259,21-10-2020 16:10:12.958519,Saludable,Ventura Soup y Salad,24300,3800,28100
20259,20260,21-10-2020 16:10:13.221326,Postres · Desayunos,Buñuelos nacho,9000,6600,15600
20260,20261,21-10-2020 16:10:13.636125,Típica · Pescados y Mariscos,La Vitualla,11870,6300,18170
20261,20262,21-10-2020 16:10:13.848200,Desayunos · Típica,La Frijolada,15000,4500,19500
20262,20263,21-10-2020 16:10:14.112269,Parrilla,Arepaisa de Medellín,53400,5600,59000
20263,20264,21-10-2020 16:10:14.374394,Desayunos · Típica,Peninsula Calentados y Parrilla,8900,3400,12300
20264,20265,21-10-2020 16:10:14.739596,Parrilla,Restaurante Bar Mi Ranchito,12500,5200,17700
20265,20266,21-10-2020 16:10:15.101493,Mexicana,Cantina La 15,39700,4300,44000
20266,20267,21-10-2020 16:10:15.315637,Postres · Desayunos,Restaurante Cornelia,10700,5500,16200
20267,20268,21-10-2020 16:10:15.678392,China,China Food Col,27800,3600,31400
20268,20269,21-10-2020 16:10:15.891750,Parrilla,El Tambor,23000,6800,29800
20269,20270,21-10-2020 16:10:16.153856,Desayunos,El Corral - Desayunos,24200,5000,29200
20270,20271,21-10-2020 16:10:16.468179,Parrilla · Internacional,Taperia de la Plaza,37900,5700,43600
20271,20272,21-10-2020 16:10:16.830416,Postres · Desayunos,Sharmus,39700,6100,45800
20272,20273,21-10-2020 16:10:17.094372,Mexicana,Mexicanachos,29500,3900,33400
20273,20274,21-10-2020 16:10:17.456784,Desayunos · Panadería,Premium Break Bakery,35000,3700,38700
20274,20275,21-10-2020 16:10:17.670789,Saludable · Desayunos,Raices Bienestar Gourmet,8900,6600,15500
20275,20276,21-10-2020 16:10:17.882442,Desayunos · Típica,Parrilla Farandula Típico,34500,5900,40400
20276,20277,21-10-2020 16:10:18.045574,Típica,El Cucharón - Tipica,15600,4400,20000
20277,20278,21-10-2020 16:10:18.357938,Postres · Desayunos,Café Quindio,7500,5700,13200
20278,20279,21-10-2020 16:10:18.672196,Hamburguesas · Pescados y Mariscos,El Velero,65000,6500,71500
20279,20280,21-10-2020 16:10:18.883761,Desayunos · Jugos y Batidos,Dont Be Hungry,10700,5600,16300
20280,20281,21-10-2020 16:10:19.197638,Desayunos · Típica,Calentao Express,45800,6000,51800
20281,20282,21-10-2020 16:10:19.509616,Desayunos,El Corral - Desayunos,10700,5000,15700
20282,20283,21-10-2020 16:10:19.924208,Desayunos · Típica,Calentao Express,8900,6000,14900
20283,20284,21-10-2020 16:10:20.336928,Pollo,Heart & Cooking,24300,5000,29300
20284,20285,21-10-2020 16:10:20.650988,Desayunos · Comida Rápida,La Veneca,15000,6300,21300
20285,20286,21-10-2020 16:10:21.012999,Saludable,Amor Propio saludable,12500,4000,16500
20286,20287,21-10-2020 16:10:21.277194,Pollo · Pescados y Mariscos,Bang Bang Rice,48750,3400,52150
20287,20288,21-10-2020 16:10:21.539470,Pollo · Pescados y Mariscos,Bang Bang Rice,17800,3400,21200
20288,20289,21-10-2020 16:10:21.853447,Típica · Pescados y Mariscos,Arroces Mrg,24300,4300,28600
20289,20290,21-10-2020 16:10:22.266445,Desayunos,La Frijolada Desayunos,53900,4400,58300
20290,20291,21-10-2020 16:10:22.431415,Saludable · Desayunos,Maracuyá,18900,6700,25600
20291,20292,21-10-2020 16:10:22.744019,Desayunos · Árabe,Boniato Sabores Vivos,8900,5300,14200
20292,20293,21-10-2020 16:10:23.108363,Alta Cocina · Postres,La Pinta,34500,4500,39000
20293,20294,21-10-2020 16:10:23.320470,Pizza,Pastas Laurentina,35000,4800,39800
20294,20295,21-10-2020 16:10:23.684109,Postres · Desayunos,Sweet Tale,17800,5800,23600
20295,20296,21-10-2020 16:10:23.946401,Típica · Parrilla,La Ternera Parrilla,65000,5200,70200
20296,20297,21-10-2020 16:10:24.260978,Postres · Desayunos,Buñuelos nacho,48750,6600,55350
20297,20298,21-10-2020 16:10:24.623304,Asiática,TeT,35000,5900,40900
20298,20299,21-10-2020 16:10:24.938610,Desayunos,Fratelli - Desayunos,17800,4600,22400
20299,20300,21-10-2020 16:10:25.101653,Desayunos · Típica,Desayunadero de la 42,18900,5900,24800
20300,20301,21-10-2020 16:10:25.365547,Postres · Café,Loló Coffee & Snacks,53900,4600,58500
20301,20302,21-10-2020 16:10:25.528132,Típica,Cabrito Santandereano,15600,6600,22200
20302,20303,21-10-2020 16:10:25.792439,Saludable,MIMA,23000,3700,26700
20303,20304,21-10-2020 16:10:26.204980,Parrilla · Internacional,Taperia de la Plaza,12500,5700,18200
20304,20305,21-10-2020 16:10:26.519367,Pizza,pizza andante,24200,4200,28400
20305,20306,21-10-2020 16:10:26.831522,Desayunos · Típica,Fogón Sangileño,31800,5000,36800
20306,20307,21-10-2020 16:10:26.995645,Saludable · Desayunos,Fresh Co,37900,5600,43500
20307,20308,21-10-2020 16:10:27.257994,Postres · Café,Loló Coffee & Snacks,11870,4600,16470
20308,20309,21-10-2020 16:10:27.571835,Desayunos · Sánduches,Garnish,10700,5200,15900
20309,20310,21-10-2020 16:10:27.833500,Pescados y Mariscos,La Gran Cazuela,24300,3200,27500
20310,20311,21-10-2020 16:10:28.197830,Hamburguesas · Pescados y Mariscos,El Velero,53900,6500,60400
20311,20312,21-10-2020 16:10:28.610260,Mexicana,La leyenda mexican kitchen,23000,3200,26200
20312,20313,21-10-2020 16:10:28.974263,Típica · Pescados y Mariscos,La Vitualla,13000,6300,19300
20313,20314,21-10-2020 16:10:29.286288,Postres · Desayunos,Café Quindio,17800,5700,23500
20314,20315,21-10-2020 16:10:29.550296,Saludable · Jugos y Batidos,Berdes Drinks & Salads,39700,3500,43200
20315,20316,21-10-2020 16:10:29.862663,Desayunos · Típica,La Parrilla Dorada Polo,12500,6600,19100
20316,20317,21-10-2020 16:10:30.077595,Peruana,Uma Cantina Peruana,18900,3200,22100
20317,20318,21-10-2020 16:10:30.240189,Crepes,La Chabatta,12500,5900,18400
20318,20319,21-10-2020 16:10:30.604818,Pollo · Pescados y Mariscos,Bang Bang Rice,11870,3400,15270
20319,20320,21-10-2020 16:10:30.817432,Internacional,La Esquina con Sabor Parrilla,17800,3000,20800
20320,20321,21-10-2020 16:10:31.031903,Desayunos · Café,Matchacha,29500,5900,35400
20321,20322,21-10-2020 16:10:31.194312,Sushi,Canoa To Go,53400,5900,59300
20322,20323,21-10-2020 16:10:31.508781,Desayunos · Panadería,Le Pain Quotidien,23000,3900,26900
20323,20324,21-10-2020 16:10:31.822940,Helados,Buon Gelato,18900,4400,23300
20324,20325,21-10-2020 16:10:32.138865,Desayunos · Café,Frambas,45800,3400,49200
20325,20326,21-10-2020 16:10:32.501715,Mexicana,Cantina La 15,18900,4300,23200
20326,20327,21-10-2020 16:10:32.715797,Postres · Desayunos,Gelateria Da Favola,34500,6500,41000
20327,20328,21-10-2020 16:10:32.927955,Típica,Bandejas Mrg,13000,3800,16800
20328,20329,21-10-2020 16:10:33.091923,Pescados y Mariscos,Pescadero Héroes del Mar,8900,6600,15500
20329,20330,21-10-2020 16:10:33.256509,Saludable,MIMA,13000,3700,16700
20330,20331,21-10-2020 16:10:33.671207,Postres · Helados,Mahé,24200,6000,30200
20331,20332,21-10-2020 16:10:34.034501,Desayunos · Típica,Casa Vieja,12500,6000,18500
20332,20333,21-10-2020 16:10:34.249294,Desayunos,Archies Desayunos,34500,3100,37600
20333,20334,21-10-2020 16:10:34.462444,Típica · Parrilla,Typykos,29500,6000,35500
20334,20335,21-10-2020 16:10:34.876922,Postres,La Galeta,27800,3000,30800
20335,20336,21-10-2020 16:10:35.241477,Alta Cocina · Italiana,Trattoria de la Plaza,35000,6000,41000
20336,20337,21-10-2020 16:10:35.656213,Desayunos · Típica,Alce,45800,4900,50700
20337,20338,21-10-2020 16:10:35.918820,Desayunos · Empanadas,Mis Delicias,35000,3200,38200
20338,20339,21-10-2020 16:10:36.133392,Típica,Lo Nuestro,65000,3100,68100
20339,20340,21-10-2020 16:10:36.345241,Pizza · Italiana,Pisapore - Pizza,24300,6600,30900
20340,20341,21-10-2020 16:10:36.559329,Peruana · Internacional,La Chifería,15600,6600,22200
20341,20342,21-10-2020 16:10:36.771419,Postres · Desayunos,KOKOA & co.,37900,4700,42600
20342,20343,21-10-2020 16:10:37.186146,Hamburguesas · Alitas,Beer,13000,6600,19600
20343,20344,21-10-2020 16:10:37.548553,Saludable · Desayunos,Malú,70000,3700,73700
20344,20345,21-10-2020 16:10:37.762858,Poke,Poke Go,39700,4600,44300
20345,20346,21-10-2020 16:10:38.025205,Sushi,Umi,13000,5600,18600
20346,20347,21-10-2020 16:10:38.440387,Desayunos,Señor Desayuno,23000,6800,29800
20347,20348,21-10-2020 16:10:38.803385,Perros Calientes,Dog Shop - Rapida,8900,4900,13800
20348,20349,21-10-2020 16:10:39.218177,Saludable · Desayunos,Maracuyá,7500,6700,14200
20349,20350,21-10-2020 16:10:39.483181,Desayunos · Panadería,Limarys,34500,6500,41000
20350,20351,21-10-2020 16:10:39.798268,Postres · Desayunos,Protein Bakes,8900,5900,14800
20351,20352,21-10-2020 16:10:39.960916,Desayunos · Típica,Desayunadero de la 42,11870,5900,17770
20352,20353,21-10-2020 16:10:40.125644,Pizza · Parrilla,Urban Lunch,34500,4000,38500
20353,20354,21-10-2020 16:10:40.539123,Típica,Baondish,7500,5800,13300
20354,20355,21-10-2020 16:10:40.754260,Desayunos,Cafetería el Kippe,45800,3200,49000
20355,20356,21-10-2020 16:10:41.067184,Saludable · Desayunos,Básico y elemental,13600,5000,18600
20356,20357,21-10-2020 16:10:41.482544,Pollo,Oliva Va,24300,5600,29900
20357,20358,21-10-2020 16:10:41.745682,Desayunos · Panadería,Artesanos,39700,4300,44000
20358,20359,21-10-2020 16:10:42.160592,Desayunos · Típica,90 Calentados,15000,3700,18700
20359,20360,21-10-2020 16:10:42.424241,Saludable · Desayunos,Libre de Culpa,8900,4000,12900
20360,20361,21-10-2020 16:10:42.789012,Saludable · Desayunos,Libre de Culpa,39700,4000,43700
20361,20362,21-10-2020 16:10:43.002088,Postres · Desayunos,Amelie Helados,24200,6400,30600
20362,20363,21-10-2020 16:10:43.416837,Pollo · Saludable,Tremenda Sal y Dulce,24200,6500,30700
20363,20364,21-10-2020 16:10:43.579310,Internacional,Rio Sabores y Experiencias,7500,4100,11600
20364,20365,21-10-2020 16:10:43.943720,Postres · Desayunos,Protein Bakes,15600,5900,21500
20365,20366,21-10-2020 16:10:44.309688,Saludable · Desayunos,Maracuyá,65000,6700,71700
20366,20367,21-10-2020 16:10:44.624272,Parrilla · Café,Gaira Café,53400,4400,57800
20367,20368,21-10-2020 16:10:44.936901,Parrilla,Coquitas,23000,5600,28600
20368,20369,21-10-2020 16:10:45.200884,Pollo · Desayunos,Caserito Gourmet,65000,6700,71700
20369,20370,21-10-2020 16:10:45.513564,Saludable · Desayunos,La Cesta,9000,4700,13700
20370,20371,21-10-2020 16:10:45.828519,Típica,Sopitas y Más,34500,4200,38700
20371,20372,21-10-2020 16:10:45.990663,Postres,Toledo Pastelería,65000,6800,71800
20372,20373,21-10-2020 16:10:46.354919,Postres · Saludable,Ana Rebana,34500,6300,40800
20373,20374,21-10-2020 16:10:46.667173,Desayunos,El Fogón Castellano,13000,3200,16200
20374,20375,21-10-2020 16:10:46.831092,Sánduches,Submarin,12500,3800,16300
20375,20376,21-10-2020 16:10:47.193816,Típica,El Mondongo y Mucho Mas,70000,5600,75600
20376,20377,21-10-2020 16:10:47.407977,Mexicana,Hidalgo Taquería,12500,4900,17400
20377,20378,21-10-2020 16:10:47.670338,Helados,Orso To Go,35000,6800,41800
20378,20379,21-10-2020 16:10:47.984657,Desayunos · Café,Libertario Coffee Roasters,45800,4600,50400
20379,20380,21-10-2020 16:10:48.248347,Internacional,La Esquina con Sabor Parrilla,29500,3000,32500
20380,20381,21-10-2020 16:10:48.563571,Típica,Bendita S,18900,4600,23500
20381,20382,21-10-2020 16:10:48.877454,Desayunos · Panadería,Siena Café,24300,3700,28000
20382,20383,21-10-2020 16:10:49.192847,Alta Cocina · Postres,La Pinta,70000,4500,74500
20383,20384,21-10-2020 16:10:49.507209,China,China Food Col,48750,3600,52350
20384,20385,21-10-2020 16:10:49.922595,Desayunos,Desayunos en Bogotá,11870,3400,15270
20385,20386,21-10-2020 16:10:50.235485,Postres,Levelma,35000,6200,41200
20386,20387,21-10-2020 16:10:50.651482,Típica · Parrilla,La Ternera Parrilla,35000,5200,40200
20387,20388,21-10-2020 16:10:51.015329,Italiana,F*cking Good Pizza,53900,4200,58100
20388,20389,21-10-2020 16:10:51.230849,Postres · Helados,Mahé,17800,6000,23800
20389,20390,21-10-2020 16:10:51.492939,Postres,Levelma,13000,6200,19200
20390,20391,21-10-2020 16:10:51.808323,Saludable,The Good Rice Bowls,15600,3500,19100
20391,20392,21-10-2020 16:10:52.171533,Postres · Desayunos,Sweet Tale,23000,5800,28800
20392,20393,21-10-2020 16:10:52.486949,Desayunos · Sánduches,Garnish,23000,5200,28200
20393,20394,21-10-2020 16:10:52.649164,Postres · Desayunos,Vivalight Market.,15600,6500,22100
20394,20395,21-10-2020 16:10:52.914354,Parrilla,Arepaisa de Medellín,39700,5600,45300
20395,20396,21-10-2020 16:10:53.227221,Desayunos,El Corral - Desayunos,15000,5000,20000
20396,20397,21-10-2020 16:10:53.643204,Saludable · Desayunos,Re.al Alimentos Reales,11870,4000,15870
20397,20398,21-10-2020 16:10:53.905435,Pizza,pizza andante,23000,4200,27200
20398,20399,21-10-2020 16:10:54.219942,Típica,El Mondongo y Mucho Mas,12500,5600,18100
20399,20400,21-10-2020 16:10:54.382460,Parrilla,Arroces Maria Paula,7500,6800,14300
20400,20401,21-10-2020 16:10:54.647584,Parrilla,Campocina,35000,4600,39600
20401,20402,21-10-2020 16:10:54.860715,Desayunos · Panadería,El Pan de Phillippe,8900,4600,13500
20402,20403,21-10-2020 16:10:55.175642,Desayunos,Desayunos en Bogotá,10700,3400,14100
20403,20404,21-10-2020 16:10:55.438562,Pollo · Desayunos,Caserito Gourmet,27800,6700,34500
20404,20405,21-10-2020 16:10:55.703071,Saludable · Jugos y Batidos,Berdes Drinks & Salads,24300,3500,27800
20405,20406,21-10-2020 16:10:55.914868,Típica,El Cucharón - Tipica,18900,4400,23300
20406,20407,21-10-2020 16:10:56.229953,Desayunos · Café,Libertario Coffee Roasters,53900,4600,58500
20407,20408,21-10-2020 16:10:56.392533,Desayunos · Típica,D'Porco - Lechona,45800,6300,52100
20408,20409,21-10-2020 16:10:56.657545,Asiática,TeT,9000,5900,14900
20409,20410,21-10-2020 16:10:56.970426,Saludable · Desayunos,Libre de Culpa,31800,4000,35800
20410,20411,21-10-2020 16:10:57.234533,Pescados y Mariscos,Fish Place - Del Mar,15600,5400,21000
20411,20412,21-10-2020 16:10:57.496621,Típica · Parrilla,La Parilla de David,23000,3100,26100
20412,20413,21-10-2020 16:10:57.711131,Saludable · Parrilla,The Angels Grill and Drinks,48750,6200,54950
20413,20414,21-10-2020 16:10:58.023580,Pizza,pizza andante,29500,4200,33700
20414,20415,21-10-2020 16:10:58.438473,Pollo · Desayunos,Caserito Gourmet,37900,6700,44600
20415,20416,21-10-2020 16:10:58.700887,Típica,La Olla de Barro,29500,5300,34800
20416,20417,21-10-2020 16:10:59.065117,Desayunos · Pescados y Mariscos,Luzí­a - Mediterranea,9000,5700,14700
20417,20418,21-10-2020 16:10:59.327394,Típica,La Olla de Barro,12500,5300,17800
20418,20419,21-10-2020 16:10:59.541843,Parrilla,Campocina,70000,4600,74600
20419,20420,21-10-2020 16:10:59.753967,Desayunos · Panadería,Pasteleite,23000,5900,28900
20420,20421,21-10-2020 16:10:59.917646,Desayunos · Típica,90 Calentados,10700,3700,14400
20421,20422,21-10-2020 16:11:00.129973,Postres,La Galeta,17800,3000,20800
20422,20423,21-10-2020 16:11:00.494629,Desayunos · Típica,Criollomania,48750,5200,53950
20423,20424,21-10-2020 16:11:00.756761,Desayunos · Panadería,Le Pain Quotidien,12500,3900,16400
20424,20425,21-10-2020 16:11:01.020860,Parrilla,El Tambor,8900,6800,15700
20425,20426,21-10-2020 16:11:01.234323,Alta Cocina · Italiana,Trattoria de la Plaza,11870,6000,17870
20426,20427,21-10-2020 16:11:01.649095,Asiática,Thai Station,13000,6000,19000
20427,20428,21-10-2020 16:11:02.011629,Pizza,pizza andante,12500,4200,16700
20428,20429,21-10-2020 16:11:02.325949,Postres · Panadería,RIGHT AWAY FOODS,48750,6600,55350
20429,20430,21-10-2020 16:11:02.688509,Hamburguesas,Monchis - Hamburguesa,34500,4300,38800
20430,20431,21-10-2020 16:11:02.952470,Pollo,Chicken House,7500,4200,11700
20431,20432,21-10-2020 16:11:03.314895,Poke,Poke Go,9000,4600,13600
20432,20433,21-10-2020 16:11:03.579258,Saludable · Desayunos,Básico y elemental,65000,5000,70000
20433,20434,21-10-2020 16:11:03.841638,Saludable · Desayunos,Re.al Alimentos Reales,31800,4000,35800
20434,20435,21-10-2020 16:11:04.006049,Desayunos · Helados,San Giorgio Gelateria,24200,3100,27300
20435,20436,21-10-2020 16:11:04.168626,Pollo · China,China Tao,23000,3500,26500
20436,20437,21-10-2020 16:11:04.434317,Parrilla,Parrilla Pimentón,17800,3400,21200
20437,20438,21-10-2020 16:11:04.696873,Sushi · Asiática,Tu Sushi,15000,6400,21400
20438,20439,21-10-2020 16:11:05.111207,Saludable · Desayunos,Distrito Gourmet,34500,3700,38200
20439,20440,21-10-2020 16:11:05.523286,Desayunos · Café,Moramia,13600,4700,18300
20440,20441,21-10-2020 16:11:05.737881,Desayunos · Café,Aromacafé el Placer de Compartir,15000,5000,20000
20441,20442,21-10-2020 16:11:06.151099,Pizza,pizza andante,13600,4200,17800
20442,20443,21-10-2020 16:11:06.516480,Peruana · Internacional,La Chifería,39700,6600,46300
20443,20444,21-10-2020 16:11:06.829394,Típica,Bandejas Mrg,13600,3800,17400
20444,20445,21-10-2020 16:11:07.043402,Típica,Baondish,18900,5800,24700
20445,20446,21-10-2020 16:11:07.456017,Desayunos · Típica,Casa Vieja,45800,6000,51800
20446,20447,21-10-2020 16:11:07.620050,Desayunos · Pescados y Mariscos,Luzí­a - Mediterranea,45800,5700,51500
20447,20448,21-10-2020 16:11:07.782126,Parrilla · Café,Figaro Café/ Restaurante Argentino,18900,5800,24700
20448,20449,21-10-2020 16:11:07.947195,Desayunos · Panadería,Artesanos,12500,4300,16800
20449,20450,21-10-2020 16:11:08.210196,Alta Cocina · Parrilla,Criterión,24200,6000,30200
20450,20451,21-10-2020 16:11:08.625700,Peruana · Internacional,La Chifería,13000,6600,19600
20451,20452,21-10-2020 16:11:08.889997,Parrilla,El Tambor,18900,6800,25700
20452,20453,21-10-2020 16:11:09.305533,Desayunos · Típica,Cochon,12500,3300,15800
20453,20454,21-10-2020 16:11:09.618761,Café · Helados,Sofia heladería y café,23000,5800,28800
20454,20455,21-10-2020 16:11:09.983157,Parrilla,Campocina,23000,4600,27600
20455,20456,21-10-2020 16:11:10.395949,Típica,El Mondongo y Mucho Mas,29500,5600,35100
20456,20457,21-10-2020 16:11:10.761004,Desayunos · Mexicana,La Mera Mera - Mexicana,18900,3100,22000
20457,20458,21-10-2020 16:11:11.173624,Desayunos · Típica,Casa Vieja,31800,6000,37800
20458,20459,21-10-2020 16:11:11.588982,Mexicana,Hidalgo Taquería,9000,4900,13900
20459,20460,21-10-2020 16:11:11.901241,Comida Rápida,Fiesta Digital Andrés,48750,3100,51850
20460,20461,21-10-2020 16:11:12.165822,Desayunos · Jugos y Batidos,Kuriwaji,24300,6300,30600
20461,20462,21-10-2020 16:11:12.578470,Desayunos · Café,Libertario Coffee Roasters,23000,4600,27600
20462,20463,21-10-2020 16:11:12.792724,Típica,Bandejas Mrg,39700,3800,43500
20463,20464,21-10-2020 16:11:13.005550,Desayunos · Típica,La Parrilla Dorada Polo,37900,6600,44500
20464,20465,21-10-2020 16:11:13.270147,Saludable · Desayunos,Maracuyá,13000,6700,19700
20465,20466,21-10-2020 16:11:13.433305,Sánduches · Pescados y Mariscos,Pacific Comida de Mar,9000,4000,13000
20466,20467,21-10-2020 16:11:13.697865,Desayunos · Internacional,Camilia,9000,3900,12900
20467,20468,21-10-2020 16:11:13.860300,Típica · Parrilla,Parrilla Farandula Gourmet,10700,5100,15800
20468,20469,21-10-2020 16:11:14.024519,Saludable · Desayunos,Libre de Culpa,9000,4000,13000
20469,20470,21-10-2020 16:11:14.437584,Hamburguesas,Gofi Burger,11870,5100,16970
20470,20471,21-10-2020 16:11:14.702222,China,China Food Col,13000,3600,16600
20471,20472,21-10-2020 16:11:15.014687,Desayunos · Árabe,Boniato Sabores Vivos,10700,5300,16000
20472,20473,21-10-2020 16:11:15.329368,Desayunos · Típica,Criollomania,15000,5200,20200
20473,20474,21-10-2020 16:11:15.592059,Desayunos · Típica,Criollomania,10700,5200,15900
20474,20475,21-10-2020 16:11:15.956592,Desayunos · Comida Rápida,La Veneca,70000,6300,76300
20475,20476,21-10-2020 16:11:16.119599,Parrilla,Restaurante Bar Mi Ranchito,37900,5200,43100
20476,20477,21-10-2020 16:11:16.484317,Típica,Campo Victoria,23000,3000,26000
20477,20478,21-10-2020 16:11:16.897827,Saludable · Desayunos,Agua Dulce,15600,3700,19300
20478,20479,21-10-2020 16:11:17.312629,Sushi · Asiática,Arigato,45800,5300,51100
20479,20480,21-10-2020 16:11:17.574965,Postres · Panadería,RIGHT AWAY FOODS,24200,6600,30800
20480,20481,21-10-2020 16:11:17.789152,Pollo · Saludable,Gratina,7500,4200,11700
20481,20482,21-10-2020 16:11:18.202048,Desayunos,Archies Desayunos,65000,3100,68100
20482,20483,21-10-2020 16:11:18.367004,Típica,Cabrito Santandereano,13000,6600,19600
20483,20484,21-10-2020 16:11:18.629751,Saludable · Parrilla,Box,12500,3700,16200
20484,20485,21-10-2020 16:11:18.793927,Desayunos,Don Leo,23000,6000,29000
20485,20486,21-10-2020 16:11:19.006441,Desayunos · Parrilla,Mi Patria,11870,4600,16470
20486,20487,21-10-2020 16:11:19.421608,Desayunos · Italiana,Rceta By Rausch,35000,3600,38600
20487,20488,21-10-2020 16:11:19.734457,Desayunos · Jugos y Batidos,Dont Be Hungry,12500,5600,18100
20488,20489,21-10-2020 16:11:19.999363,Desayunos,Bagel Shop,15000,3200,18200
20489,20490,21-10-2020 16:11:20.212007,Parrilla,Restaurante Bar Mi Ranchito,15000,5200,20200
20490,20491,21-10-2020 16:11:20.476715,Desayunos · Panadería,Limarys,23000,6500,29500
20491,20492,21-10-2020 16:11:20.839470,Desayunos · Típica,Casa Vieja,23000,6000,29000
20492,20493,21-10-2020 16:11:21.153862,Parrilla,Arepaisa de Medellín,12500,5600,18100
20493,20494,21-10-2020 16:11:21.366434,Asiática,TeT,65000,5900,70900
20494,20495,21-10-2020 16:11:21.580786,Postres,Toledo Pastelería,12500,6800,19300
20495,20496,21-10-2020 16:11:21.944001,Típica,El Cucharón - Tipica,18900,4400,23300
20496,20497,21-10-2020 16:11:22.358922,Desayunos · Café,Norma's Ice Cream Café,18900,6300,25200
20497,20498,21-10-2020 16:11:22.771474,Desayunos · Sánduches,Danilo Colombia,12500,3300,15800
20498,20499,21-10-2020 16:11:23.036064,Hamburguesas · Desayunos,El Inglés Gastro Pub,9000,6600,15600
20499,20500,21-10-2020 16:11:23.450249,Parrilla · Café,Gaira Café,34500,4400,38900
20500,20501,21-10-2020 16:11:23.715497,Típica · Pescados y Mariscos,La Vitualla,27800,6300,34100
20501,20502,21-10-2020 16:11:24.078820,Postres · Café,Loló Coffee & Snacks,65000,4600,69600
20502,20503,21-10-2020 16:11:24.394581,Pollo · Típica,Auyama,39700,3900,43600
20503,20504,21-10-2020 16:11:24.557551,Desayunos,Cafetería el Kippe,65000,3200,68200
20504,20505,21-10-2020 16:11:24.772104,Desayunos · Panadería,Premium Break Bakery,15000,3700,18700
20505,20506,21-10-2020 16:11:25.134851,Desayunos · Típica,90 Calentados,48750,3700,52450
20506,20507,21-10-2020 16:11:25.499574,Típica,La Herencia,23000,5900,28900
20507,20508,21-10-2020 16:11:25.812471,Desayunos,Bagel Shop,13000,3200,16200
20508,20509,21-10-2020 16:11:26.127081,Desayunos · Café,El Gualilo,11870,6200,18070
20509,20510,21-10-2020 16:11:26.290137,Típica · Parrilla,Parrilla Farandula Gourmet,8900,5100,14000
20510,20511,21-10-2020 16:11:26.554049,Típica · Parrilla,El Portal de la Antigua,13000,5600,18600
20511,20512,21-10-2020 16:11:26.767252,Sushi,Sushi Reel,8900,4700,13600
20512,20513,21-10-2020 16:11:27.183329,Hamburguesas · Pescados y Mariscos,El Velero,29500,6500,36000
20513,20514,21-10-2020 16:11:27.545721,Postres,Levelma,9000,6200,15200
20514,20515,21-10-2020 16:11:27.760223,Saludable · Desayunos,Básico y Elemental,10700,5900,16600
20515,20516,21-10-2020 16:11:27.922398,Pizza,Pizza Andante,29500,6300,35800
20516,20517,21-10-2020 16:11:28.186955,Internacional,Rio Sabores y Experiencias,7500,4100,11600
20517,20518,21-10-2020 16:11:28.349961,Postres · Café,Loló Coffee & Snacks,31800,4600,36400
20518,20519,21-10-2020 16:11:28.614765,Típica,Campo Victoria,53400,3000,56400
20519,20520,21-10-2020 16:11:28.827126,Saludable,Puro Verde,23000,5700,28700
20520,20521,21-10-2020 16:11:29.142268,Típica,Cazuelitas 93,11870,3900,15770
20521,20522,21-10-2020 16:11:29.404979,Saludable,MIMA,24300,3700,28000
20522,20523,21-10-2020 16:11:29.769901,Desayunos · Café,Norma's Ice Cream Café,7500,6300,13800
20523,20524,21-10-2020 16:11:30.033063,Saludable,MIMA,70000,3700,73700
20524,20525,21-10-2020 16:11:30.247682,Desayunos · Comida Rápida,La Veneca,39700,6300,46000
20525,20526,21-10-2020 16:11:30.610520,Desayunos · Panadería,Premium Break Bakery,7500,3700,11200
20526,20527,21-10-2020 16:11:30.874658,Italiana,F*cking Good Pizza,23000,4200,27200
20527,20528,21-10-2020 16:11:31.237991,Desayunos · Pescados y Mariscos,Luzí­a - Mediterranea,10700,5700,16400
20528,20529,21-10-2020 16:11:31.453391,Postres,Toledo Pastelería,39700,6800,46500
20529,20530,21-10-2020 16:11:31.766038,Hamburguesas · Saludable,Restaurant Inn,45800,6100,51900
20530,20531,21-10-2020 16:11:32.131070,Desayunos · Café,Moramia,53900,4700,58600
20531,20532,21-10-2020 16:11:32.344437,Desayunos · Panadería,Decofruta,39700,4700,44400
20532,20533,21-10-2020 16:11:32.658982,Postres,Toledo Pastelería,70000,6800,76800
20533,20534,21-10-2020 16:11:32.972530,Pollo,Heart & Cooking,34500,5000,39500
20534,20535,21-10-2020 16:11:33.288455,Parrilla,Coquitas,34500,5600,40100
20535,20536,21-10-2020 16:11:33.701298,Saludable · Desayunos,La Cesta,37900,4700,42600
20536,20537,21-10-2020 16:11:33.866234,Parrilla,Arepaisa de Medellín,24300,5600,29900
20537,20538,21-10-2020 16:11:34.129439,Desayunos · Típica,Alce,23000,4900,27900
20538,20539,21-10-2020 16:11:34.293813,Postres · Desayunos,Maria Luisa - Postres,24200,4300,28500
20539,20540,21-10-2020 16:11:34.706876,Postres · Café,Loló Coffee & Snacks,10700,4600,15300
20540,20541,21-10-2020 16:11:34.871368,Pollo · Desayunos,Abasto,15000,3600,18600
20541,20542,21-10-2020 16:11:35.134585,Parrilla,Restaurante Bar Mi Ranchito,10700,5200,15900
20542,20543,21-10-2020 16:11:35.549438,Alta Cocina · Postres,La Pinta,70000,4500,74500
20543,20544,21-10-2020 16:11:35.812082,Saludable · Desayunos,Copacabana Açai Bowls,31800,3000,34800
20544,20545,21-10-2020 16:11:35.977503,Hamburguesas,Monchis - Hamburguesa,9000,4300,13300
20545,20546,21-10-2020 16:11:36.191104,Desayunos · Pescados y Mariscos,Luzí­a - Mediterranea,45800,5700,51500
20546,20547,21-10-2020 16:11:36.405878,Saludable · Desayunos,Agua Dulce,29500,3700,33200
20547,20548,21-10-2020 16:11:36.669395,Típica,Bandejas Mrg,53400,3800,57200
20548,20549,21-10-2020 16:11:37.084358,Típica · Parrilla,El Santandereano,23000,5200,28200
20549,20550,21-10-2020 16:11:37.498379,Postres · Desayunos,Buñuelos nacho,8900,6600,15500
20550,20551,21-10-2020 16:11:37.663408,Comida Rápida · Perros Calientes,Similoa - Comida Rapida,17800,3700,21500
20551,20552,21-10-2020 16:11:37.926603,Sushi,Umi,39700,5600,45300
20552,20553,21-10-2020 16:11:38.242438,Pollo · Desayunos,Piaf,10700,6500,17200
20553,20554,21-10-2020 16:11:38.505798,Alta Cocina · Postres,La Pinta,8900,4500,13400
20554,20555,21-10-2020 16:11:38.670840,Típica · Parrilla,Parrilla Farandula Gourmet,15600,5100,20700
20555,20556,21-10-2020 16:11:38.933699,Típica,El Mondongo y Mucho Mas,10700,5600,16300
20556,20557,21-10-2020 16:11:39.248365,Saludable · Desayunos,Malú,53900,3700,57600
20557,20558,21-10-2020 16:11:39.461922,Postres · Desayunos,Buñuelos nacho,24300,6600,30900
20558,20559,21-10-2020 16:11:39.777424,Desayunos,Desayunos en Bogotá,10700,3400,14100
20559,20560,21-10-2020 16:11:40.090491,Mexicana,La leyenda mexican kitchen,39700,3200,42900
20560,20561,21-10-2020 16:11:40.355418,Desayunos · Panadería,Pasteleite,53400,5900,59300
20561,20562,21-10-2020 16:11:40.518475,Postres · Desayunos,Vivalight Market.,9000,6500,15500
20562,20563,21-10-2020 16:11:40.883621,Pollo,Señor Fantástico,37900,4700,42600
20563,20564,21-10-2020 16:11:41.196959,Desayunos,Sr Buñuelo,53400,6400,59800
20564,20565,21-10-2020 16:11:41.511794,Típica,Bandejas Mrg,23000,3800,26800
20565,20566,21-10-2020 16:11:41.874460,Pescados y Mariscos,Pescadero Héroes del Mar,35000,6600,41600
20566,20567,21-10-2020 16:11:42.088652,Postres,La Tertulia,15000,3400,18400
20567,20568,21-10-2020 16:11:42.251779,Pollo · China,China Tao,39700,3500,43200
20568,20569,21-10-2020 16:11:42.568251,Saludable · Desayunos,Bawana - Sandwich,8900,3400,12300
20569,20570,21-10-2020 16:11:42.781259,Típica · Parrilla,La Parilla de David,23000,3100,26100
20570,20571,21-10-2020 16:11:43.045766,Postres · Desayunos,La Folie - Postres,9000,3300,12300
20571,20572,21-10-2020 16:11:43.460006,Desayunos,Desayunos en Bogotá,18900,3400,22300
20572,20573,21-10-2020 16:11:43.875100,Hamburguesas,Monchis - Hamburguesa,10700,4300,15000
20573,20574,21-10-2020 16:11:44.037584,Desayunos · Sánduches,Danilo Colombia,39700,3300,43000
20574,20575,21-10-2020 16:11:44.302368,Típica,La Olla de Barro,37900,5300,43200
20575,20576,21-10-2020 16:11:44.665091,Pollo,Oliva Va,23000,5600,28600
20576,20577,21-10-2020 16:11:44.979732,Desayunos · Típica,La Frijolada,39700,4500,44200
20577,20578,21-10-2020 16:11:45.192369,Pollo,Heart & Cooking,9000,5000,14000
20578,20579,21-10-2020 16:11:45.357115,Postres · Desayunos,Aury Postres - Comidas & Picadas,24300,4700,29000
20579,20580,21-10-2020 16:11:45.570038,Típica · Parrilla,El Portal de la Antigua,70000,5600,75600
20580,20581,21-10-2020 16:11:45.784872,Desayunos,Desayunos en Bogotá,70000,3400,73400
20581,20582,21-10-2020 16:11:46.098031,Postres,Levelma,24300,6200,30500
20582,20583,21-10-2020 16:11:46.412640,Saludable,Ventura Soup y Salad,34500,3800,38300
20583,20584,21-10-2020 16:11:46.726570,Sushi,Umi,10700,5600,16300
20584,20585,21-10-2020 16:11:47.091573,Desayunos · Empanadas,Empanadas Doraditas.com,35000,3000,38000
20585,20586,21-10-2020 16:11:47.354691,Postres · Desayunos,BagBog Bagels,24200,6400,30600
20586,20587,21-10-2020 16:11:47.770780,Desayunos,Don Leo,8900,6000,14900
20587,20588,21-10-2020 16:11:47.984191,Típica,La Cocina,45800,4600,50400
20588,20589,21-10-2020 16:11:48.249705,Desayunos · Comida Rápida,Chocolatto,53900,3400,57300
20589,20590,21-10-2020 16:11:48.663238,Desayunos · Panadería,Le Pain Quotidien,13600,3900,17500
20590,20591,21-10-2020 16:11:49.078376,Desayunos · Panadería,Decofruta,9000,4700,13700
20591,20592,21-10-2020 16:11:49.391888,Pizza,Pastas Laurentina,27800,4800,32600
20592,20593,21-10-2020 16:11:49.706837,Internacional,Rio Sabores y Experiencias,35000,4100,39100
20593,20594,21-10-2020 16:11:49.870163,Típica,Sabores De Mi Tierra,27800,5400,33200
20594,20595,21-10-2020 16:11:50.185168,Asiática,Thai Station,53400,6000,59400
20595,20596,21-10-2020 16:11:50.448869,Postres,Beiked,23000,4000,27000
20596,20597,21-10-2020 16:11:50.764341,Postres · Desayunos,BagBog Bagels,11870,6400,18270
20597,20598,21-10-2020 16:11:50.977751,Desayunos · Típica,Rojo Gourmet,29500,4700,34200
20598,20599,21-10-2020 16:11:51.242906,Típica,Bendita S,11870,4600,16470
20599,20600,21-10-2020 16:11:51.556627,Hamburguesas · Desayunos,El Inglés Gastro Pub,27800,6600,34400
20600,20601,21-10-2020 16:11:51.722541,Parrilla,Restaurante Bar Mi Ranchito,7500,5200,12700
20601,20602,21-10-2020 16:11:52.036411,Postres · Desayunos,Gelateria Da Favola,8900,6500,15400
20602,20603,21-10-2020 16:11:52.302490,Postres · Desayunos,Cosmo Cookies,15000,5900,20900
20603,20604,21-10-2020 16:11:52.615564,Sushi · Desayunos,Maki Roll,17800,4300,22100
20604,20605,21-10-2020 16:11:53.032038,Asiática,Thai Station,12500,6000,18500
20605,20606,21-10-2020 16:11:53.344572,Saludable · Desayunos,La Cesta,17800,4700,22500
20606,20607,21-10-2020 16:11:53.509687,Desayunos,La Frijolada Desayunos,37900,4400,42300
20607,20608,21-10-2020 16:11:53.922872,Hamburguesas,Burger Society,24200,4100,28300
20608,20609,21-10-2020 16:11:54.237502,Desayunos · Empanadas,Empanadas Doraditas.com,13600,3000,16600
20609,20610,21-10-2020 16:11:54.651447,Parrilla,OAK Ahumado y Brebajes,45800,6000,51800
20610,20611,21-10-2020 16:11:54.815588,Italiana,Bocatto Di Passo,17800,5000,22800
20611,20612,21-10-2020 16:11:54.978166,Parrilla,Arepaisa de Medellín,31800,5600,37400
20612,20613,21-10-2020 16:11:55.393206,Desayunos · Panadería,Limarys,24200,6500,30700
20613,20614,21-10-2020 16:11:55.656663,Pollo · Desayunos,Workzone,53400,3100,56500
20614,20615,21-10-2020 16:11:55.920899,Postres · Desayunos,Maria Luisa - Postres,23000,4300,27300
20615,20616,21-10-2020 16:11:56.234216,Sánduches · Pescados y Mariscos,Pacific Comida de Mar,9000,4000,13000
20616,20617,21-10-2020 16:11:56.399643,Postres · Café,Celestino Café,24200,5900,30100
20617,20618,21-10-2020 16:11:56.813149,Pollo · Típica,Auyama,8900,3900,12800
20618,20619,21-10-2020 16:11:57.077985,Desayunos · Café,Moramia,31800,4700,36500
20619,20620,21-10-2020 16:11:57.491556,Saludable · Parrilla,Box,17800,3700,21500
20620,20621,21-10-2020 16:11:57.855894,Típica,Lo Nuestro,17800,3100,20900
20621,20622,21-10-2020 16:11:58.269852,Típica,La Herencia,24300,5900,30200
20622,20623,21-10-2020 16:11:58.686077,Desayunos · Café,Frambas,35000,3400,38400
20623,20624,21-10-2020 16:11:58.953764,Sushi,Umi,10700,5600,16300
20624,20625,21-10-2020 16:11:59.118527,Típica,Cazuelitas 93,39700,3900,43600
20625,20626,21-10-2020 16:11:59.432411,Postres,Toledo Pastelería,12500,6800,19300
20626,20627,21-10-2020 16:11:59.647792,Desayunos · Panadería,El Pan de Phillippe,18900,4600,23500
20627,20628,21-10-2020 16:11:59.910123,Desayunos · Típica,Criollomania,27800,5200,33000
20628,20629,21-10-2020 16:12:00.075044,Alta Cocina · Postres,La Pinta,12500,4500,17000
20629,20630,21-10-2020 16:12:00.338198,Típica · Pescados y Mariscos,Arroces Mrg,12500,4300,16800
20630,20631,21-10-2020 16:12:00.553096,Postres · Desayunos,Maria Luisa - Postres,45800,4300,50100
20631,20632,21-10-2020 16:12:00.716345,Saludable · Desayunos,Básico y elemental,10700,5000,15700
20632,20633,21-10-2020 16:12:01.031592,Postres · Saludable,Ana Rebana,48750,6300,55050
20633,20634,21-10-2020 16:12:01.395169,Desayunos,La Frijolada Desayunos,27800,4400,32200
20634,20635,21-10-2020 16:12:01.560286,Típica,Bandejas Mrg,24200,3800,28000
20635,20636,21-10-2020 16:12:01.873980,Típica,Sopitas y Más,23000,4200,27200
20636,20637,21-10-2020 16:12:02.239410,Típica,La Cocina,37900,4600,42500
20637,20638,21-10-2020 16:12:02.552213,Saludable,A2manos,15600,4200,19800
20638,20639,21-10-2020 16:12:02.916988,Desayunos · Típica,D'Porco - Lechona,15000,6300,21300
20639,20640,21-10-2020 16:12:03.079671,Postres · Saludable,Ana Rebana,17800,6300,24100
20640,20641,21-10-2020 16:12:03.496201,Sushi,Sushi Reel,12500,4700,17200
20641,20642,21-10-2020 16:12:03.708825,Pollo · Saludable,Tremenda Sal y Dulce,18900,6500,25400
20642,20643,21-10-2020 16:12:04.023457,Típica,Baondish,18900,5800,24700
20643,20644,21-10-2020 16:12:04.186587,Típica,Cabrito Santandereano,31800,6600,38400
20644,20645,21-10-2020 16:12:04.402282,Pescados y Mariscos,La Gran Cazuela,27800,3200,31000
20645,20646,21-10-2020 16:12:04.665337,Jugos y Batidos,Pomponio,23000,3600,26600
20646,20647,21-10-2020 16:12:05.029835,Sushi · Asiática,Tu Sushi,11870,6400,18270
20647,20648,21-10-2020 16:12:05.193150,Saludable · Típica,Saludable Mrg,29500,5800,35300
20648,20649,21-10-2020 16:12:05.557731,Desayunos · Típica,Calentao Express,9000,6000,15000
20649,20650,21-10-2020 16:12:05.721031,Postres · Desayunos,Protein Bakes,12500,5900,18400
20650,20651,21-10-2020 16:12:06.036421,Desayunos · Típica,La Parrilla Dorada Polo,7500,6600,14100
20651,20652,21-10-2020 16:12:06.451832,Pollo · Desayunos,Abasto,10700,3600,14300
20652,20653,21-10-2020 16:12:06.716982,Saludable · Desayunos,La Estampilla,37900,6000,43900
20653,20654,21-10-2020 16:12:07.030211,Pescados y Mariscos,La Gran Cazuela,37900,3200,41100
20654,20655,21-10-2020 16:12:07.446442,Sánduches · China,Peru Mix,48750,5900,54650
20655,20656,21-10-2020 16:12:07.709221,Saludable · Parrilla,The Angels Grill and Drinks,37900,6200,44100
20656,20657,21-10-2020 16:12:07.974558,Crepes,La Chabatta,13000,5900,18900
20657,20658,21-10-2020 16:12:08.187769,Pollo,Señor Fantástico,15000,4700,19700
20658,20659,21-10-2020 16:12:08.403589,Típica · Parrilla,Mi Ranchito Parrilla,13600,4400,18000
20659,20660,21-10-2020 16:12:08.669603,Saludable · Desayunos,Fresh Co,29500,5600,35100
20660,20661,21-10-2020 16:12:08.834161,Sushi · Asiática,Tu Sushi,9000,6400,15400
20661,20662,21-10-2020 16:12:09.147384,Saludable · Desayunos,Guadalupe - Fruteria,9000,5900,14900
20662,20663,21-10-2020 16:12:09.312323,Saludable · Desayunos,Re.al Alimentos Reales,39700,4000,43700
20663,20664,21-10-2020 16:12:09.726082,Postres · Desayunos,Jacques Pastelería,53900,5900,59800
20664,20665,21-10-2020 16:12:10.041740,Desayunos,Bagel Shop,18900,3200,22100
20665,20666,21-10-2020 16:12:10.205204,Típica · Parrilla,Mi Ranchito Parrilla,37900,4400,42300
20666,20667,21-10-2020 16:12:10.470508,Típica · Pescados y Mariscos,Arroces Mrg,35000,4300,39300
20667,20668,21-10-2020 16:12:10.883745,Postres · Desayunos,Aury Postres - Comidas & Picadas,7500,4700,12200
20668,20669,21-10-2020 16:12:11.299317,Pollo · Desayunos,Workzone,34500,3100,37600
20669,20670,21-10-2020 16:12:11.713722,Típica,Sabores De Mi Tierra,37900,5400,43300
20670,20671,21-10-2020 16:12:11.878896,Postres · Desayunos,Sweet Tale,13600,5800,19400
20671,20672,21-10-2020 16:12:12.292456,Postres,Beiked,45800,4000,49800
20672,20673,21-10-2020 16:12:12.607562,Típica,La Olla de Barro,23000,5300,28300
20673,20674,21-10-2020 16:12:12.871027,Postres · Desayunos,La Folie - Postres,34500,3300,37800
20674,20675,21-10-2020 16:12:13.287398,Parrilla,Parrilla Pimentón,29500,3400,32900
20675,20676,21-10-2020 16:12:13.705569,Desayunos · Comida Rápida,La Veneca,9000,6300,15300
20676,20677,21-10-2020 16:12:13.970393,Sushi,Umi,18900,5600,24500
20677,20678,21-10-2020 16:12:14.133588,Pollo · China,China Tao,35000,3500,38500
20678,20679,21-10-2020 16:12:14.548912,Típica,Cazuelitas 93,7500,3900,11400
20679,20680,21-10-2020 16:12:14.812404,Pescados y Mariscos,La Gran Cazuela,11870,3200,15070
20680,20681,21-10-2020 16:12:15.127676,Desayunos · Panadería,Decofruta,39700,4700,44400
20681,20682,21-10-2020 16:12:15.442292,Típica · Parrilla,Toya,10700,4200,14900
20682,20683,21-10-2020 16:12:15.857389,Helados,Orso To Go,53900,6800,60700
20683,20684,21-10-2020 16:12:16.070840,Saludable · Parrilla,Box,18900,3700,22600
20684,20685,21-10-2020 16:12:16.436579,Desayunos · Jugos y Batidos,Kuriwaji,15000,6300,21300
20685,20686,21-10-2020 16:12:16.849721,Postres · Desayunos,Maltihelados,9000,6200,15200
20686,20687,21-10-2020 16:12:17.065372,Típica,Juan Chorizo,7500,3900,11400
20687,20688,21-10-2020 16:12:17.378641,Pollo,Señor Fantástico,23000,4700,27700
20688,20689,21-10-2020 16:12:17.594326,Postres · Desayunos,Café Quindio,23000,5700,28700
20689,20690,21-10-2020 16:12:18.008185,Saludable · Desayunos,Maracuyá,45800,6700,52500
20690,20691,21-10-2020 16:12:18.173567,Desayunos · Comida Rápida,La Veneca,12500,6300,18800
20691,20692,21-10-2020 16:12:18.387562,Saludable,The Good Rice Bowls,11870,3500,15370
20692,20693,21-10-2020 16:12:18.703924,Desayunos · Comida Rápida,La Veneca,53900,6300,60200
20693,20694,21-10-2020 16:12:19.116620,Desayunos,Bagel Shop,23000,3200,26200
20694,20695,21-10-2020 16:12:19.381800,Desayunos · Típica,Criollomania,24300,5200,29500
20695,20696,21-10-2020 16:12:19.745543,Helados,Orso To Go,12500,6800,19300
20696,20697,21-10-2020 16:12:19.960796,Italiana,F*cking Good Pizza,48750,4200,52950
20697,20698,21-10-2020 16:12:20.374577,Sushi,Sushi Reel,53900,4700,58600
20698,20699,21-10-2020 16:12:20.589804,Mexicana,Mexicanachos,31800,3900,35700
20699,20700,21-10-2020 16:12:20.853087,Postres · Panadería,RIGHT AWAY FOODS,15000,6600,21600
20700,20701,21-10-2020 16:12:21.168318,Parrilla,Campocina,17800,4600,22400
20701,20702,21-10-2020 16:12:21.582059,Desayunos,Don Leo,23000,6000,29000
20702,20703,21-10-2020 16:12:21.999365,Pollo · Desayunos,Piaf,11870,6500,18370
20703,20704,21-10-2020 16:12:22.163136,Peruana · Internacional,La Chifería,8900,6600,15500
20704,20705,21-10-2020 16:12:22.578890,Saludable · Desayunos,Maracuyá,9000,6700,15700
20705,20706,21-10-2020 16:12:22.741877,Alta Cocina · Italiana,Trattoria de la Plaza,15600,6000,21600
20706,20707,21-10-2020 16:12:22.906507,Parrilla,Parrilla Pimentón,23000,3400,26400
20707,20708,21-10-2020 16:12:23.220521,Alta Cocina · Postres,La Pinta,24200,4500,28700
20708,20709,21-10-2020 16:12:23.436660,Postres,La Galeta,53400,3000,56400
20709,20710,21-10-2020 16:12:23.701238,Típica,Sabrosito,70000,4000,74000
20710,20711,21-10-2020 16:12:24.116375,Pollo · Desayunos,Workzone,23000,3100,26100
20711,20712,21-10-2020 16:12:24.480280,Parrilla · Internacional,Taperia de la Plaza,10700,5700,16400
20712,20713,21-10-2020 16:12:24.845966,Saludable · Desayunos,Bon Eat - Saludable,15000,4800,19800
20713,20714,21-10-2020 16:12:25.009296,Alta Cocina · Italiana,Trattoria de la Plaza,53400,6000,59400
20714,20715,21-10-2020 16:12:25.224602,Postres · Desayunos,La Folie - Postres,15600,3300,18900
20715,20716,21-10-2020 16:12:25.587854,Saludable,The Good Rice Bowls,39700,3500,43200
20716,20717,21-10-2020 16:12:25.902921,Desayunos · Típica,Criollomania,10700,5200,15900
20717,20718,21-10-2020 16:12:26.066035,Postres · Desayunos,Aury Postres - Comidas & Picadas,15000,4700,19700
20718,20719,21-10-2020 16:12:26.481974,Típica,Juan Chorizo,65000,3900,68900
20719,20720,21-10-2020 16:12:26.795269,Típica,Baondish,12500,5800,18300
20720,20721,21-10-2020 16:12:26.960687,Hamburguesas · Saludable,Restaurant Inn,23000,6100,29100
20721,20722,21-10-2020 16:12:27.124538,Saludable · Desayunos,Bon Eat - Saludable,18900,4800,23700
20722,20723,21-10-2020 16:12:27.440498,Desayunos · Internacional,Camilia,48750,3900,52650
20723,20724,21-10-2020 16:12:27.804274,Internacional,La Esquina con Sabor Parrilla,53900,3000,56900
20724,20725,21-10-2020 16:12:28.019821,Desayunos · Empanadas,Empanadas Doraditas.com,39700,3000,42700
20725,20726,21-10-2020 16:12:28.333149,Saludable · Desayunos,Básico y Elemental,12500,5900,18400
20726,20727,21-10-2020 16:12:28.598663,Parrilla · Café,Figaro Café/ Restaurante Argentino,8900,5800,14700
20727,20728,21-10-2020 16:12:29.013167,Desayunos · Típica,Criollomania,24200,5200,29400
20728,20729,21-10-2020 16:12:29.429648,Postres · Desayunos,Aury Postres - Comidas & Picadas,53400,4700,58100
20729,20730,21-10-2020 16:12:29.743048,Desayunos · Panadería,Limarys,13000,6500,19500
20730,20731,21-10-2020 16:12:30.158901,Postres · Saludable,Ana Rebana,24200,6300,30500
20731,20732,21-10-2020 16:12:30.472457,Desayunos · Típica,Cochon,34500,3300,37800
20732,20733,21-10-2020 16:12:30.738148,Típica · Pescados y Mariscos,Arroces Mrg,35000,4300,39300
20733,20734,21-10-2020 16:12:31.151975,Desayunos · Típica,Papadió - Colombianas,11870,5700,17570
20734,20735,21-10-2020 16:12:31.417851,Saludable,Puro Verde,23000,5700,28700
20735,20736,21-10-2020 16:12:31.681932,Típica,Carbón & Mondongos,34500,6400,40900
20736,20737,21-10-2020 16:12:31.897101,Parrilla,Coquitas,48750,5600,54350
20737,20738,21-10-2020 16:12:32.311184,Típica,Baondish,13600,5800,19400
20738,20739,21-10-2020 16:12:32.727578,Desayunos,Butter,31800,6700,38500
20739,20740,21-10-2020 16:12:32.891567,Típica,Salsig,13600,5600,19200
20740,20741,21-10-2020 16:12:33.157437,Típica,Bendita S,15000,4600,19600
20741,20742,21-10-2020 16:12:33.571121,Típica,Sabores De Mi Tierra,65000,5400,70400
20742,20743,21-10-2020 16:12:33.936573,Típica,Juan Chorizo,27800,3900,31700
20743,20744,21-10-2020 16:12:34.300965,Desayunos · Típica,Criollomania,48750,5200,53950
20744,20745,21-10-2020 16:12:34.516291,Postres · Desayunos,Vivalight Market.,35000,6500,41500
20745,20746,21-10-2020 16:12:34.929841,Saludable · Desayunos,Bawana - Sandwich,27800,3400,31200
20746,20747,21-10-2020 16:12:35.095123,Pollo · Desayunos,Workzone,10700,3100,13800
20747,20748,21-10-2020 16:12:35.308498,Postres · Café,Loló Coffee & Snacks,18900,4600,23500
20748,20749,21-10-2020 16:12:35.573696,Típica,Juan Chorizo,15000,3900,18900
20749,20750,21-10-2020 16:12:35.836885,Típica,Cazuelitas 93,15000,3900,18900
20750,20751,21-10-2020 16:12:36.152901,Desayunos · Panadería,El Pan de Phillippe,39700,4600,44300
20751,20752,21-10-2020 16:12:36.516552,Sushi,Canoa To Go,11870,5900,17770
20752,20753,21-10-2020 16:12:36.832341,Postres · Panadería,RIGHT AWAY FOODS,31800,6600,38400
20753,20754,21-10-2020 16:12:36.995541,Pollo · Sánduches,Pollos Century,18900,3000,21900
20754,20755,21-10-2020 16:12:37.261298,Típica · Parrilla,Typykos,24300,6000,30300
20755,20756,21-10-2020 16:12:37.574704,Desayunos · Café,Aromacafé el Placer de Compartir,29500,5000,34500
20756,20757,21-10-2020 16:12:37.790139,Saludable,Ventura Soup y Salad,24300,3800,28100
20757,20758,21-10-2020 16:12:38.203742,Helados,Buon Gelato,13600,4400,18000
20758,20759,21-10-2020 16:12:38.368957,Parrilla,Parrilla Pimentón,10700,3400,14100
20759,20760,21-10-2020 16:12:38.732774,Postres · Café,Celestino Café,15000,5900,20900
20760,20761,21-10-2020 16:12:38.997832,Desayunos · Empanadas,Empanadas Doraditas.com,13000,3000,16000
20761,20762,21-10-2020 16:12:39.260966,Parrilla,Rústico Picadería,29500,3800,33300
20762,20763,21-10-2020 16:12:39.577518,Sushi,Canoa To Go,11870,5900,17770
20763,20764,21-10-2020 16:12:39.840958,Postres · Desayunos,Maria Luisa - Postres,37900,4300,42200
20764,20765,21-10-2020 16:12:40.006053,Desayunos · Típica,Criollomania,8900,5200,14100
20765,20766,21-10-2020 16:12:40.219659,Desayunos · Panadería,Siena Café,10700,3700,14400
20766,20767,21-10-2020 16:12:40.485243,Postres · Helados,Mahé,7500,6000,13500
20767,20768,21-10-2020 16:12:40.648804,Postres · Desayunos,Jacques Pastelería,48750,5900,54650
20768,20769,21-10-2020 16:12:40.915862,Típica,Cabrito Santandereano,27800,6600,34400
20769,20770,21-10-2020 16:12:41.280442,Desayunos · Comida Rápida,La Veneca,23000,6300,29300
20770,20771,21-10-2020 16:12:41.545838,Sushi,Canoa To Go,24200,5900,30100
20771,20772,21-10-2020 16:12:41.709413,Saludable · Desayunos,La Estampilla,18900,6000,24900
20772,20773,21-10-2020 16:12:41.924403,Postres · Desayunos,Protein Bakes,65000,5900,70900
20773,20774,21-10-2020 16:12:42.188142,Pollo · Desayunos,Candelina,10700,5300,16000
20774,20775,21-10-2020 16:12:42.603987,Parrilla,Campocina,31800,4600,36400
20775,20776,21-10-2020 16:12:42.867585,Saludable · Desayunos,La Cesta,29500,4700,34200
20776,20777,21-10-2020 16:12:43.183584,Postres · Desayunos,La Folie - Postres,53900,3300,57200
20777,20778,21-10-2020 16:12:43.547884,Alta Cocina · Postres,La Pinta,9000,4500,13500
20778,20779,21-10-2020 16:12:43.964225,Pollo · Saludable,Tremenda Sal y Dulce,31800,6500,38300
20779,20780,21-10-2020 16:12:44.377925,Desayunos · Panadería,Artesanos,15000,4300,19300
20780,20781,21-10-2020 16:12:44.794638,Desayunos · Típica,D'Porco - Lechona,31800,6300,38100
20781,20782,21-10-2020 16:12:45.008180,Parrilla · Café,Gaira Café,24200,4400,28600
20782,20783,21-10-2020 16:12:45.174281,Desayunos · Típica,La Frijolada,35000,4500,39500
20783,20784,21-10-2020 16:12:45.538181,Pollo · Saludable,Yerbabuena,39700,3900,43600
20784,20785,21-10-2020 16:12:45.704675,Desayunos,El Corral - Desayunos,35000,5000,40000
20785,20786,21-10-2020 16:12:45.918305,Desayunos · Típica,Calentao Express,9000,6000,15000
20786,20787,21-10-2020 16:12:46.333927,Desayunos · Internacional,Camilia,48750,3900,52650
20787,20788,21-10-2020 16:12:46.648877,Desayunos,Archies Desayunos,24200,3100,27300
20788,20789,21-10-2020 16:12:46.914235,Hamburguesas · Panadería,NYC Burgers,70000,6200,76200
20789,20790,21-10-2020 16:12:47.128119,Desayunos · Café,Norma's Ice Cream Café,48750,6300,55050
20790,20791,21-10-2020 16:12:47.344019,Pollo · Desayunos,Caserito Gourmet,48750,6700,55450
20791,20792,21-10-2020 16:12:47.657863,Desayunos · Pescados y Mariscos,Luzí­a - Mediterranea,23000,5700,28700
20792,20793,21-10-2020 16:12:48.074231,Pizza · Parrilla,Urban Lunch,35000,4000,39000
20793,20794,21-10-2020 16:12:48.337471,Pizza · Parrilla,Urban Lunch,15000,4000,19000
20794,20795,21-10-2020 16:12:48.502596,Desayunos · Panadería,Santa Juana Food Bar,18900,5900,24800
20795,20796,21-10-2020 16:12:48.665917,Pizza,Pastas Laurentina,35000,4800,39800
20796,20797,21-10-2020 16:12:48.881580,Pescados y Mariscos,Fish Place - Del Mar,39700,5400,45100
20797,20798,21-10-2020 16:12:49.145336,Internacional,La Esquina con Sabor Parrilla,8900,3000,11900
20798,20799,21-10-2020 16:12:49.460810,Desayunos,Señor Desayuno,35000,6800,41800
20799,20800,21-10-2020 16:12:49.774686,Pollo,Señor Fantástico,29500,4700,34200
20800,20801,21-10-2020 16:12:50.091393,Típica,Bendita S,17800,4600,22400
20801,20802,21-10-2020 16:12:50.405722,Desayunos · Típica,Peninsula Calentados y Parrilla,11870,3400,15270
20802,20803,21-10-2020 16:12:50.622035,Típica · Parrilla,Mi Ranchito Parrilla,34500,4400,38900
20803,20804,21-10-2020 16:12:51.035703,Postres,Beiked,45800,4000,49800
20804,20805,21-10-2020 16:12:51.451754,Hamburguesas · Alitas,Beer,23000,6600,29600
20805,20806,21-10-2020 16:12:51.665494,Postres · Helados,Mahé,7500,6000,13500
20806,20807,21-10-2020 16:12:51.930374,Desayunos · Jugos y Batidos,Kuriwaji,34500,6300,40800
20807,20808,21-10-2020 16:12:52.094102,Típica · Parrilla,Toya,10700,4200,14900
20808,20809,21-10-2020 16:12:52.459785,Pollo · Desayunos,Workzone,18900,3100,22000
20809,20810,21-10-2020 16:12:52.873259,Jugos y Batidos,Pomponio,18900,3600,22500
20810,20811,21-10-2020 16:12:53.188661,Saludable · Desayunos,Libre de Culpa,12500,4000,16500
20811,20812,21-10-2020 16:12:53.352056,Parrilla · Internacional,Taperia de la Plaza,27800,5700,33500
20812,20813,21-10-2020 16:12:53.617298,Desayunos · Típica,D´Porco,53400,3900,57300
20813,20814,21-10-2020 16:12:53.880780,Típica,La Cocina,35000,4600,39600
20814,20815,21-10-2020 16:12:54.146438,Desayunos · Panadería,Pasteleite,23000,5900,28900
20815,20816,21-10-2020 16:12:54.359861,Peruana,Masivo,8900,5800,14700
20816,20817,21-10-2020 16:12:54.725810,Desayunos · Típica,Peninsula Calentados y Parrilla,15000,3400,18400
20817,20818,21-10-2020 16:12:55.089767,Peruana,Uma Cantina Peruana,65000,3200,68200
20818,20819,21-10-2020 16:12:55.505542,Sushi,Sushi Reel,35000,4700,39700
20819,20820,21-10-2020 16:12:55.668922,Postres · Desayunos,Restaurante Cornelia,8900,5500,14400
20820,20821,21-10-2020 16:12:55.883796,Parrilla,OAK Ahumado y Brebajes,35000,6000,41000
20821,20822,21-10-2020 16:12:56.247462,Saludable,Puro Verde,12500,5700,18200
20822,20823,21-10-2020 16:12:56.462808,Desayunos · Típica,Alce,15600,4900,20500
20823,20824,21-10-2020 16:12:56.676702,Desayunos,Sunny Breakfast Brunch,39700,4300,44000
20824,20825,21-10-2020 16:12:57.042661,Panadería,Boul,34500,3100,37600
20825,20826,21-10-2020 16:12:57.306700,Parrilla,Parrilla Pimentón,15600,3400,19000
20826,20827,21-10-2020 16:12:57.723401,Saludable · Típica,Sopas Mrg,70000,3100,73100
20827,20828,21-10-2020 16:12:58.036901,Helados,Orso To Go,24300,6800,31100
20828,20829,21-10-2020 16:12:58.302521,Desayunos · Panadería,Ficchi Panadería,65000,3100,68100
20829,20830,21-10-2020 16:12:58.665880,Desayunos,El Corral - Desayunos,24200,5000,29200
20830,20831,21-10-2020 16:12:58.831085,Desayunos,La Frijolada Desayunos,12500,4400,16900
20831,20832,21-10-2020 16:12:59.043996,Postres · Desayunos,Protein Bakes,48750,5900,54650
20832,20833,21-10-2020 16:12:59.359139,Desayunos · Comida Rápida,Chocolatto,35000,3400,38400
20833,20834,21-10-2020 16:12:59.773587,Hamburguesas · Saludable,Restaurant Inn,31800,6100,37900
20834,20835,21-10-2020 16:13:00.140671,Parrilla,Rústico Picadería,24300,3800,28100
20835,20836,21-10-2020 16:13:00.504497,Internacional,Rio Sabores y Experiencias,48750,4100,52850
20836,20837,21-10-2020 16:13:00.770026,Postres · Desayunos,Maltihelados,23000,6200,29200
20837,20838,21-10-2020 16:13:00.983584,Saludable · Desayunos,La Estampilla,45800,6000,51800
20838,20839,21-10-2020 16:13:01.149602,Típica,Sabores De Mi Tierra,8900,5400,14300
20839,20840,21-10-2020 16:13:01.363399,Postres · Desayunos,La Folie - Postres,10700,3300,14000
20840,20841,21-10-2020 16:13:01.729804,Postres · Helados,Mahé,8900,6000,14900
20841,20842,21-10-2020 16:13:01.893709,Desayunos,Desayunos en Bogotá,29500,3400,32900
20842,20843,21-10-2020 16:13:02.260289,Típica,El Mondongo y Mucho Mas,11870,5600,17470
20843,20844,21-10-2020 16:13:02.474692,Desayunos,El Corral - Desayunos,31800,5000,36800
20844,20845,21-10-2020 16:13:02.791024,Desayunos · Comida Rápida,La Veneca,45800,6300,52100
20845,20846,21-10-2020 16:13:03.055022,Desayunos · Típica,90 Calentados,23000,3700,26700
20846,20847,21-10-2020 16:13:03.473082,Desayunos · Jugos y Batidos,Kuriwaji,29500,6300,35800
20847,20848,21-10-2020 16:13:03.837494,Pizza,18 Scalini,23000,4300,27300
20848,20849,21-10-2020 16:13:04.154415,Desayunos · Helados,San Giorgio Gelateria,9000,3100,12100
20849,20850,21-10-2020 16:13:04.519120,Parrilla,Arroces Maria Paula,23000,6800,29800
20850,20851,21-10-2020 16:13:04.735950,Postres · Desayunos,Aury Postres - Comidas & Picadas,53900,4700,58600
20851,20852,21-10-2020 16:13:05.001337,Saludable,Puro Verde,24300,5700,30000
20852,20853,21-10-2020 16:13:05.370430,Hamburguesas · Saludable,Restaurant Inn,53400,6100,59500
20853,20854,21-10-2020 16:13:05.784800,Saludable · Desayunos,La Cesta,10700,4700,15400
20854,20855,21-10-2020 16:13:06.202138,Desayunos · Típica,90 Calentados,45800,3700,49500
20855,20856,21-10-2020 16:13:06.616225,Sushi · Asiática,Arigato,7500,5300,12800
20856,20857,21-10-2020 16:13:06.783519,Pollo · Desayunos,Candelina,15000,5300,20300
20857,20858,21-10-2020 16:13:06.997087,Desayunos · Comida Rápida,Chocolatto,45800,3400,49200
20858,20859,21-10-2020 16:13:07.412845,Postres · Desayunos,Buñuelos nacho,24200,6600,30800
20859,20860,21-10-2020 16:13:07.576531,Desayunos · Típica,Fogón Sangileño,35000,5000,40000
20860,20861,21-10-2020 16:13:07.992570,Postres · Desayunos,Sharmus,39700,6100,45800
20861,20862,21-10-2020 16:13:08.406838,Postres · Desayunos,Café Quindio,39700,5700,45400
20862,20863,21-10-2020 16:13:08.672959,Típica · Parrilla,El Portal de la Antigua,10700,5600,16300
20863,20864,21-10-2020 16:13:08.836189,Típica,Sabrosito,27800,4000,31800
20864,20865,21-10-2020 16:13:09.051288,Saludable,The Good Rice Bowls,70000,3500,73500
20865,20866,21-10-2020 16:13:09.465632,Pollo,Heart & Cooking,37900,5000,42900
20866,20867,21-10-2020 16:13:09.832326,Desayunos · Mexicana,La Mera Mera - Mexicana,39700,3100,42800
20867,20868,21-10-2020 16:13:10.195624,Saludable · Desayunos,Guadalupe - Fruteria,17800,5900,23700
20868,20869,21-10-2020 16:13:10.612396,Desayunos · Comida Rápida,La Veneca,29500,6300,35800
20869,20870,21-10-2020 16:13:10.975908,Pollo · Desayunos,Workzone,37900,3100,41000
20870,20871,21-10-2020 16:13:11.141083,Helados,Orso To Go,13000,6800,19800
20871,20872,21-10-2020 16:13:11.354649,Típica,El Mondongo y Mucho Mas,23000,5600,28600
20872,20873,21-10-2020 16:13:11.770767,Saludable · Desayunos,Básico y elemental,24300,5000,29300
20873,20874,21-10-2020 16:13:12.184481,Comida Rápida · Perros Calientes,Similoa - Comida Rapida,8900,3700,12600
20874,20875,21-10-2020 16:13:12.549733,Desayunos · Mexicana,La Mera Mera - Mexicana,11870,3100,14970
20875,20876,21-10-2020 16:13:12.713903,Saludable · Parrilla,Box,70000,3700,73700
20876,20877,21-10-2020 16:13:13.079153,Parrilla,El Tambor,10700,6800,17500
20877,20878,21-10-2020 16:13:13.444056,Desayunos · Café,vereda central calle 99,37900,5700,43600
20878,20879,21-10-2020 16:13:13.859963,Helados,Orso To Go,9000,6800,15800
20879,20880,21-10-2020 16:13:14.173744,Postres · Desayunos,Vivalight Market.,10700,6500,17200
20880,20881,21-10-2020 16:13:14.339931,Desayunos · Típica,Cochon,35000,3300,38300
20881,20882,21-10-2020 16:13:14.503582,Desayunos · Panadería,Santa Juana Food Bar,10700,5900,16600
20882,20883,21-10-2020 16:13:14.819263,Parrilla,Coquitas,11870,5600,17470
20883,20884,21-10-2020 16:13:15.233946,Desayunos · Sánduches,Frutos del Bosque,17800,3500,21300
20884,20885,21-10-2020 16:13:15.450133,Desayunos,Archies Desayunos,70000,3100,73100
20885,20886,21-10-2020 16:13:15.814684,Italiana,F*cking Good Pizza,29500,4200,33700
20886,20887,21-10-2020 16:13:16.180772,Típica,La Herencia,13600,5900,19500
20887,20888,21-10-2020 16:13:16.445153,Típica,Sabores De Mi Tierra,15600,5400,21000
20888,20889,21-10-2020 16:13:16.760954,Internacional,Rio Sabores y Experiencias,9000,4100,13100
20889,20890,21-10-2020 16:13:16.924496,Parrilla,Antojo a Domicilio,15600,5000,20600
20890,20891,21-10-2020 16:13:17.340591,Pizza,Pastas Laurentina,18900,4800,23700
20891,20892,21-10-2020 16:13:17.605086,Asiática,TeT,31800,5900,37700
20892,20893,21-10-2020 16:13:17.871489,Desayunos,Cafetería el Kippe,53900,3200,57100
20893,20894,21-10-2020 16:13:18.285876,Desayunos · Italiana,Rceta By Rausch,12500,3600,16100
20894,20895,21-10-2020 16:13:18.501912,Desayunos · Jugos y Batidos,Kuriwaji,9000,6300,15300
20895,20896,21-10-2020 16:13:18.816394,Desayunos,Bagel Shop,15000,3200,18200
20896,20897,21-10-2020 16:13:18.982674,Saludable · Desayunos,Bawana - Sandwich,37900,3400,41300
20897,20898,21-10-2020 16:13:19.296670,Saludable · Desayunos,Copacabana Açai Bowls,35000,3000,38000
20898,20899,21-10-2020 16:13:19.612667,Desayunos,Cafetería el Kippe,15000,3200,18200
20899,20900,21-10-2020 16:13:20.027956,Típica · Parrilla,La Parilla de David,39700,3100,42800
20900,20901,21-10-2020 16:13:20.344332,Pollo · Desayunos,Candelina,17800,5300,23100
20901,20902,21-10-2020 16:13:20.660351,Pescados y Mariscos,La Gran Cazuela,48750,3200,51950
20902,20903,21-10-2020 16:13:21.078209,Comida Rápida · Perros Calientes,Similoa - Comida Rapida,70000,3700,73700
20903,20904,21-10-2020 16:13:21.492856,Desayunos,El Corral - Desayunos,53400,5000,58400
20904,20905,21-10-2020 16:13:21.759639,Típica,Carbón & Mondongos,24200,6400,30600
20905,20906,21-10-2020 16:13:22.074338,Postres · Desayunos,Jacques Pastelería,17800,5900,23700
20906,20907,21-10-2020 16:13:22.391203,Saludable · Parrilla,The Angels Grill and Drinks,31800,6200,38000
20907,20908,21-10-2020 16:13:22.706436,Saludable · Desayunos,Agua Dulce,11870,3700,15570
20908,20909,21-10-2020 16:13:23.023189,Sánduches · Pescados y Mariscos,Pacific Comida de Mar,65000,4000,69000
20909,20910,21-10-2020 16:13:23.337262,Típica,Sabores De Mi Tierra,35000,5400,40400
20910,20911,21-10-2020 16:13:23.554124,Desayunos · Helados,San Giorgio Gelateria,18900,3100,22000
20911,20912,21-10-2020 16:13:23.968254,Típica · Pescados y Mariscos,La Vitualla,34500,6300,40800
20912,20913,21-10-2020 16:13:24.185556,Postres · Desayunos,Cosmo Cookies,29500,5900,35400
20913,20914,21-10-2020 16:13:24.600072,Desayunos · Internacional,Camilia,31800,3900,35700
20914,20915,21-10-2020 16:13:25.016904,Desayunos · Típica,Fogón Sangileño,15000,5000,20000
20915,20916,21-10-2020 16:13:25.331507,Postres · Desayunos,Jacques Pastelería,23000,5900,28900
20916,20917,21-10-2020 16:13:25.547123,Típica,Salsig,34500,5600,40100
20917,20918,21-10-2020 16:13:25.860844,Postres · Desayunos,Vivalight Market.,7500,6500,14000
20918,20919,21-10-2020 16:13:26.228139,Saludable · Típica,Saludable Mrg,7500,5800,13300
20919,20920,21-10-2020 16:13:26.392112,China,China Food Col,12500,3600,16100
20920,20921,21-10-2020 16:13:26.607770,Postres · Desayunos,Café Quindio,23000,5700,28700
20921,20922,21-10-2020 16:13:27.021091,Parrilla,Coquitas,34500,5600,40100
20922,20923,21-10-2020 16:13:27.336885,Desayunos · Típica,D'Porco - Lechona,37900,6300,44200
20923,20924,21-10-2020 16:13:27.600797,Saludable · Desayunos,Fresh Co,23000,5600,28600
20924,20925,21-10-2020 16:13:27.967360,Mexicana,Mexicanachos,65000,3900,68900
20925,20926,21-10-2020 16:13:28.281535,Peruana · Internacional,La Chifería,17800,6600,24400
20926,20927,21-10-2020 16:13:28.497369,Hamburguesas,Gofi Burger,27800,5100,32900
20927,20928,21-10-2020 16:13:28.710770,Pizza,Pastas Laurentina,70000,4800,74800
20928,20929,21-10-2020 16:13:29.026580,Desayunos · Típica,Casa Vieja,65000,6000,71000
20929,20930,21-10-2020 16:13:29.190039,Desayunos,Señor Desayuno,45800,6800,52600
20930,20931,21-10-2020 16:13:29.355384,Saludable,MIMA,70000,3700,73700
20931,20932,21-10-2020 16:13:29.669800,Saludable · Desayunos,Maracuyá,13000,6700,19700
20932,20933,21-10-2020 16:13:29.835245,Postres · Desayunos,Maltihelados,35000,6200,41200
20933,20934,21-10-2020 16:13:30.249027,Típica · Parrilla,Typykos,29500,6000,35500
20934,20935,21-10-2020 16:13:30.614920,Pescados y Mariscos,Pescadero Héroes del Mar,24200,6600,30800
20935,20936,21-10-2020 16:13:30.978595,Desayunos,Fratelli - Desayunos,15000,4600,19600
20936,20937,21-10-2020 16:13:31.194617,Postres · Desayunos,Gelateria Da Favola,7500,6500,14000
20937,20938,21-10-2020 16:13:31.559594,Desayunos · Empanadas,Mis Delicias,39700,3200,42900
20938,20939,21-10-2020 16:13:31.975381,Pizza · Italiana,Piatto - Pizza,18900,6600,25500
20939,20940,21-10-2020 16:13:32.389257,Desayunos,Butter,17800,6700,24500
20940,20941,21-10-2020 16:13:32.655089,Parrilla,Parrilla Pimentón,35000,3400,38400
20941,20942,21-10-2020 16:13:32.868490,Postres,Levelma,11870,6200,18070
20942,20943,21-10-2020 16:13:33.183942,Saludable · Desayunos,La Estampilla,9000,6000,15000
20943,20944,21-10-2020 16:13:33.448754,Desayunos · Típica,D´Porco,24300,3900,28200
20944,20945,21-10-2020 16:13:33.815292,Parrilla,Parrilla Pimentón,37900,3400,41300
20945,20946,21-10-2020 16:13:33.980197,Pollo · Pescados y Mariscos,Bang Bang Rice,15000,3400,18400
20946,20947,21-10-2020 16:13:34.297239,Saludable,Puro Verde,35000,5700,40700
20947,20948,21-10-2020 16:13:34.611682,Saludable,Hanai - Bowls Saludables,11870,5900,17770
20948,20949,21-10-2020 16:13:34.827012,Café · Helados,Sofia heladería y café,23000,5800,28800
20949,20950,21-10-2020 16:13:35.090647,Desayunos · Árabe,Boniato Sabores Vivos,23000,5300,28300
20950,20951,21-10-2020 16:13:35.356278,Saludable · Desayunos,La Estampilla,70000,6000,76000
20951,20952,21-10-2020 16:13:35.620373,Parrilla,Beraca Parrilla Bbq,37900,5600,43500
20952,20953,21-10-2020 16:13:35.987002,China,China Food Col,15000,3600,18600
20953,20954,21-10-2020 16:13:36.350855,Pizza,18 Scalini,9000,4300,13300
20954,20955,21-10-2020 16:13:36.767747,Desayunos · Parrilla,Mi Patria,53400,4600,58000
20955,20956,21-10-2020 16:13:36.930725,Desayunos,Sr Buñuelo,39700,6400,46100
20956,20957,21-10-2020 16:13:37.346974,Hamburguesas,Monchis - Hamburguesa,11870,4300,16170
20957,20958,21-10-2020 16:13:37.610970,Saludable · Desayunos,Maracuyá,29500,6700,36200
20958,20959,21-10-2020 16:13:37.777009,Mexicana,Hidalgo Taquería,10700,4900,15600
20959,20960,21-10-2020 16:13:38.141005,Postres · Desayunos,La Folie - Postres,27800,3300,31100
20960,20961,21-10-2020 16:13:38.407055,Desayunos · Típica,D´Porco,45800,3900,49700
20961,20962,21-10-2020 16:13:38.570917,Parrilla,Arepaisa de Medellín,24200,5600,29800
20962,20963,21-10-2020 16:13:38.787066,Hamburguesas · Alitas,Beer,13600,6600,20200
20963,20964,21-10-2020 16:13:39.100720,Sánduches · Pescados y Mariscos,Pacific Comida de Mar,39700,4000,43700
20964,20965,21-10-2020 16:13:39.266606,Saludable · Desayunos,Bon Eat - Saludable,35000,4800,39800
20965,20966,21-10-2020 16:13:39.631713,Asiática,Thai Station,65000,6000,71000
20966,20967,21-10-2020 16:13:39.848579,Desayunos · Típica,Rojo Gourmet,29500,4700,34200
20967,20968,21-10-2020 16:13:40.263659,Postres · Saludable,Ana Rebana,65000,6300,71300
20968,20969,21-10-2020 16:13:40.680087,Típica,Lo Nuestro,11870,3100,14970
20969,20970,21-10-2020 16:13:40.994368,Parrilla · Café,Figaro Café/ Restaurante Argentino,31800,5800,37600
20970,20971,21-10-2020 16:13:41.360513,Típica,Cazuelitas 93,8900,3900,12800
20971,20972,21-10-2020 16:13:41.776069,Típica,Bendita S,15000,4600,19600
20972,20973,21-10-2020 16:13:41.941765,Postres · Desayunos,Protein Bakes,24200,5900,30100
20973,20974,21-10-2020 16:13:42.306435,Poke,Poke Go,39700,4600,44300
20974,20975,21-10-2020 16:13:42.722461,Saludable · Desayunos,Bawana - Sandwich,34500,3400,37900
20975,20976,21-10-2020 16:13:42.936351,Hamburguesas · Desayunos,El Inglés Gastro Pub,11870,6600,18470
20976,20977,21-10-2020 16:13:43.302510,Hamburguesas · Alitas,Beer,24200,6600,30800
20977,20978,21-10-2020 16:13:43.566438,Postres · Desayunos,Buñuelos nacho,70000,6600,76600
20978,20979,21-10-2020 16:13:43.732496,Hamburguesas,Burger Society,53400,4100,57500
20979,20980,21-10-2020 16:13:44.146264,Mexicana,Cantina La 15,9000,4300,13300
20980,20981,21-10-2020 16:13:44.464292,Típica,Sabrosito,48750,4000,52750
20981,20982,21-10-2020 16:13:44.728475,Típica · Parrilla,El Santandereano,35000,5200,40200
20982,20983,21-10-2020 16:13:44.994270,Pollo · Desayunos,Caserito Gourmet,11870,6700,18570
20983,20984,21-10-2020 16:13:45.258531,Parrilla,Parrilla Pimentón,8900,3400,12300
20984,20985,21-10-2020 16:13:45.674273,Desayunos · Mexicana,La Mera Mera - Mexicana,8900,3100,12000
20985,20986,21-10-2020 16:13:46.087911,Típica,Juan Chorizo,35000,3900,38900
20986,20987,21-10-2020 16:13:46.404031,Parrilla · Café,Gaira Café,39700,4400,44100
20987,20988,21-10-2020 16:13:46.668006,Desayunos · Típica,Criollomania,24300,5200,29500
20988,20989,21-10-2020 16:13:46.834352,Desayunos,Cafetería el Kippe,35000,3200,38200
20989,20990,21-10-2020 16:13:47.249591,Parrilla,Restaurante Bar Mi Ranchito,13600,5200,18800
20990,20991,21-10-2020 16:13:47.615833,Sánduches · Pescados y Mariscos,Pacific Comida de Mar,23000,4000,27000
20991,20992,21-10-2020 16:13:48.030283,Parrilla,Coquitas,17800,5600,23400
20992,20993,21-10-2020 16:13:48.196472,Desayunos · Sánduches,Frutos del Bosque,48750,3500,52250
20993,20994,21-10-2020 16:13:48.360375,Internacional,Rio Sabores y Experiencias,13000,4100,17100
20994,20995,21-10-2020 16:13:48.777180,Saludable · Desayunos,Básico y elemental,24300,5000,29300
20995,20996,21-10-2020 16:13:48.941097,Internacional,Rio Sabores y Experiencias,8900,4100,13000
20996,20997,21-10-2020 16:13:49.106638,Hamburguesas · Desayunos,El Inglés Gastro Pub,70000,6600,76600
20997,20998,21-10-2020 16:13:49.520652,Desayunos,Fratelli - Desayunos,7500,4600,12100
20998,20999,21-10-2020 16:13:49.836752,Postres,La Galeta,39700,3000,42700
20999,21000,21-10-2020 16:13:50.151365,Desayunos,El Corral - Desayunos,29500,5000,34500
21000,21001,21-10-2020 16:13:50.418517,Típica · Parrilla,Mi Ranchito Parrilla,31800,4400,36200
21001,21002,21-10-2020 16:13:50.583465,Pizza · Italiana,Piatto - Pizza,24200,6600,30800
21002,21003,21-10-2020 16:13:50.950335,Parrilla,Parrilla Pimentón,18900,3400,22300
21003,21004,21-10-2020 16:13:51.265276,Desayunos · Típica,Cochon,15000,3300,18300
21004,21005,21-10-2020 16:13:51.482388,Postres · Desayunos,Maria Luisa - Postres,39700,4300,44000
21005,21006,21-10-2020 16:13:51.696764,Desayunos · Típica,Fogón Sangileño,29500,5000,34500
21006,21007,21-10-2020 16:13:51.913837,Pizza,18 Scalini,35000,4300,39300
21007,21008,21-10-2020 16:13:52.328454,Saludable · Típica,Saludable Mrg,24200,5800,30000
21008,21009,21-10-2020 16:13:52.744731,Hamburguesas,Burger Society,34500,4100,38600
21009,21010,21-10-2020 16:13:53.058928,Desayunos · Jugos y Batidos,Frutiwow,48750,4100,52850
21010,21011,21-10-2020 16:13:53.475773,Saludable,Puro Verde,9000,5700,14700
21011,21012,21-10-2020 16:13:53.641512,Postres · Desayunos,Restaurante Cornelia,23000,5500,28500
21012,21013,21-10-2020 16:13:53.908074,Típica,Carbón & Mondongos,37900,6400,44300
21013,21014,21-10-2020 16:13:54.172538,Típica · Parrilla,Parrilla Farandula Gourmet,24300,5100,29400
21014,21015,21-10-2020 16:13:54.488659,Pollo · Pescados y Mariscos,Bang Bang Rice,8900,3400,12300
21015,21016,21-10-2020 16:13:54.802757,Desayunos · Típica,D'Porco - Lechona,29500,6300,35800
21016,21017,21-10-2020 16:13:55.018980,Pollo · Saludable,Yerbabuena,23000,3900,26900
21017,21018,21-10-2020 16:13:55.283349,Típica,El Mondongo y Mucho Mas,13000,5600,18600
21018,21019,21-10-2020 16:13:55.650165,Pescados y Mariscos,Fish Place - Del Mar,24300,5400,29700
21019,21020,21-10-2020 16:13:55.963965,Desayunos · Típica,90 Calentados,12500,3700,16200
21020,21021,21-10-2020 16:13:56.280850,Típica,Cabrito Santandereano,48750,6600,55350
21021,21022,21-10-2020 16:13:56.645896,Desayunos · Sánduches,Garnish,53900,5200,59100
21022,21023,21-10-2020 16:13:56.812242,Parrilla,OAK Ahumado y Brebajes,7500,6000,13500
21023,21024,21-10-2020 16:13:56.976812,Saludable · Desayunos,La Estampilla,34500,6000,40500
21024,21025,21-10-2020 16:13:57.243476,Saludable · Desayunos,Distrito Gourmet,15000,3700,18700
21025,21026,21-10-2020 16:13:57.658372,Pizza · Parrilla,Urban Lunch,35000,4000,39000
21026,21027,21-10-2020 16:13:58.024412,Desayunos · Café,Aromacafé el Placer de Compartir,39700,5000,44700
21027,21028,21-10-2020 16:13:58.439635,Típica,Sabrosito,24300,4000,28300
21028,21029,21-10-2020 16:13:58.755745,China,China Food Col,10700,3600,14300
21029,21030,21-10-2020 16:13:59.170286,Panadería,Boul,29500,3100,32600
21030,21031,21-10-2020 16:13:59.587105,Típica,Salsig,53900,5600,59500
21031,21032,21-10-2020 16:13:59.951641,Desayunos · Café,Matchacha,24300,5900,30200
21032,21033,21-10-2020 16:14:00.317820,Pollo,Chicken House,31800,4200,36000
21033,21034,21-10-2020 16:14:00.632633,Desayunos · Italiana,Rceta By Rausch,35000,3600,38600
21034,21035,21-10-2020 16:14:00.948732,Postres · Helados,Mahé,11870,6000,17870
21035,21036,21-10-2020 16:14:01.262997,Pollo,Chicken House,34500,4200,38700
21036,21037,21-10-2020 16:14:01.529315,Típica · Parrilla,Toya,8900,4200,13100
21037,21038,21-10-2020 16:14:01.793450,Desayunos · Típica,Fogón Sangileño,8900,5000,13900
21038,21039,21-10-2020 16:14:02.160248,Pollo · Saludable,Yerbabuena,53900,3900,57800
21039,21040,21-10-2020 16:14:02.374485,Saludable,Amor Propio saludable,35000,4000,39000
21040,21041,21-10-2020 16:14:02.590443,Desayunos · Típica,Calentao Express,24300,6000,30300
21041,21042,21-10-2020 16:14:02.855087,China,China Food Col,9000,3600,12600
21042,21043,21-10-2020 16:14:03.271270,Desayunos · Pescados y Mariscos,Luzí­a - Mediterranea,13600,5700,19300
21043,21044,21-10-2020 16:14:03.585965,Desayunos,Desayunos en Bogotá,15000,3400,18400
21044,21045,21-10-2020 16:14:03.951946,Postres · Desayunos,Sweet Tale,65000,5800,70800
21045,21046,21-10-2020 16:14:04.365683,Sushi · Asiática,Arigato,35000,5300,40300
21046,21047,21-10-2020 16:14:04.782245,Postres,Toledo Pastelería,11870,6800,18670
21047,21048,21-10-2020 16:14:04.946072,Desayunos,Bagel Shop,53400,3200,56600
21048,21049,21-10-2020 16:14:05.111996,Pescados y Mariscos,Pescadero Héroes del Mar,34500,6600,41100
21049,21050,21-10-2020 16:14:05.526647,Típica,La Olla de Barro,17800,5300,23100
21050,21051,21-10-2020 16:14:05.693404,Pizza,Pastas Laurentina,37900,4800,42700
21051,21052,21-10-2020 16:14:05.858232,Típica,El Cucharón - Tipica,45800,4400,50200
21052,21053,21-10-2020 16:14:06.275215,Saludable · Desayunos,Copacabana Açai Bowls,15000,3000,18000
21053,21054,21-10-2020 16:14:06.689346,Saludable,A2manos,15600,4200,19800
21054,21055,21-10-2020 16:14:06.854926,Pollo,Heart & Cooking,17800,5000,22800
21055,21056,21-10-2020 16:14:07.018596,Postres · Desayunos,Amelie Helados,11870,6400,18270
21056,21057,21-10-2020 16:14:07.185342,Saludable · Desayunos,Fresh Co,13000,5600,18600
21057,21058,21-10-2020 16:14:07.499530,Desayunos · Típica,La Parrilla Dorada Polo,12500,6600,19100
21058,21059,21-10-2020 16:14:07.715792,Desayunos · Típica,Criollomania,23000,5200,28200
21059,21060,21-10-2020 16:14:07.929804,Desayunos · Café,vereda central calle 99,7500,5700,13200
21060,21061,21-10-2020 16:14:08.146547,Desayunos · Típica,D'Porco - Lechona,35000,6300,41300
21061,21062,21-10-2020 16:14:08.411550,Desayunos,Bagel Shop,29500,3200,32700
21062,21063,21-10-2020 16:14:08.628561,Desayunos · Típica,Peninsula Calentados y Parrilla,70000,3400,73400
21063,21064,21-10-2020 16:14:08.842397,Desayunos · Comida Rápida,Chocolatto,65000,3400,68400
21064,21065,21-10-2020 16:14:09.008572,Parrilla,Coquitas,10700,5600,16300
21065,21066,21-10-2020 16:14:09.424043,Desayunos · Panadería,Siena Café,23000,3700,26700
21066,21067,21-10-2020 16:14:09.690979,Desayunos,El Fogón Castellano,7500,3200,10700
21067,21068,21-10-2020 16:14:09.855209,Postres · Desayunos,Buñuelos nacho,65000,6600,71600
21068,21069,21-10-2020 16:14:10.172002,Desayunos · Árabe,Boniato Sabores Vivos,31800,5300,37100
21069,21070,21-10-2020 16:14:10.586063,Asiática,TeT,37900,5900,43800
21070,21071,21-10-2020 16:14:10.752215,Italiana,Bocatto Di Passo,18900,5000,23900
21071,21072,21-10-2020 16:14:11.166286,Postres · Desayunos,Cosmo Cookies,39700,5900,45600
21072,21073,21-10-2020 16:14:11.382497,Desayunos · Café,vereda central calle 99,45800,5700,51500
21073,21074,21-10-2020 16:14:11.747616,Típica · Parrilla,La Parilla de David,48750,3100,51850
21074,21075,21-10-2020 16:14:12.013778,Parrilla,El Tambor,11870,6800,18670
21075,21076,21-10-2020 16:14:12.429957,Poke,Poke Go,35000,4600,39600
21076,21077,21-10-2020 16:14:12.696981,Postres · Desayunos,Maria Luisa - Postres,70000,4300,74300
21077,21078,21-10-2020 16:14:12.910760,Desayunos · Panadería,Ficchi Panadería,24300,3100,27400
21078,21079,21-10-2020 16:14:13.227608,Desayunos · Típica,Parrilla Farandula Típico,53400,5900,59300
21079,21080,21-10-2020 16:14:13.492535,Desayunos · Típica,Casa Vieja,10700,6000,16700
21080,21081,21-10-2020 16:14:13.858608,Crepes,San Crepes,24300,4900,29200
21081,21082,21-10-2020 16:14:14.273446,Desayunos · Helados,San Giorgio Gelateria,70000,3100,73100
21082,21083,21-10-2020 16:14:14.440657,Desayunos · Jugos y Batidos,Kuriwaji,27800,6300,34100
21083,21084,21-10-2020 16:14:14.655065,Hamburguesas · Alitas,Beer,11870,6600,18470
21084,21085,21-10-2020 16:14:14.821105,Postres · Desayunos,Amelie Helados,12500,6400,18900
21085,21086,21-10-2020 16:14:15.185728,Peruana,Masivo,8900,5800,14700
21086,21087,21-10-2020 16:14:15.452496,Mexicana,Mexicanachos,15600,3900,19500
21087,21088,21-10-2020 16:14:15.866842,Típica · Parrilla,Mi Ranchito Parrilla,7500,4400,11900
21088,21089,21-10-2020 16:14:16.233497,Sushi,Kim Pop,24200,5400,29600
21089,21090,21-10-2020 16:14:16.397586,Típica · Pescados y Mariscos,Arroces Mrg,35000,4300,39300
21090,21091,21-10-2020 16:14:16.814096,Saludable · Desayunos,Fresh Co,18900,5600,24500
21091,21092,21-10-2020 16:14:17.178787,Desayunos · Panadería,Limarys,37900,6500,44400
21092,21093,21-10-2020 16:14:17.345307,Postres · Desayunos,Aury Postres - Comidas & Picadas,11870,4700,16570
21093,21094,21-10-2020 16:14:17.560442,Postres · Desayunos,Cosmo Cookies,17800,5900,23700
21094,21095,21-10-2020 16:14:17.977291,Postres · Desayunos,Maltihelado,11870,4500,16370
21095,21096,21-10-2020 16:14:18.242353,Desayunos · Italiana,Rceta By Rausch,29500,3600,33100
21096,21097,21-10-2020 16:14:18.459757,Mexicana,Hidalgo Taquería,53400,4900,58300
21097,21098,21-10-2020 16:14:18.774425,Desayunos,Cafetería el Kippe,35000,3200,38200
21098,21099,21-10-2020 16:14:19.040811,Desayunos · Jugos y Batidos,Frutiwow,27800,4100,31900
21099,21100,21-10-2020 16:14:19.355273,Parrilla,Restaurante Bar Mi Ranchito,18900,5200,24100
21100,21101,21-10-2020 16:14:19.672433,Café · Helados,Sofia heladería y café,12500,5800,18300
21101,21102,21-10-2020 16:14:20.037506,Típica · Parrilla,Mi Ranchito Parrilla,23000,4400,27400
21102,21103,21-10-2020 16:14:20.204135,Hamburguesas · Pescados y Mariscos,El Velero,17800,6500,24300
21103,21104,21-10-2020 16:14:20.469071,Crepes,San Crepes,53900,4900,58800
21104,21105,21-10-2020 16:14:20.885567,Helados,Buon Gelato,45800,4400,50200
21105,21106,21-10-2020 16:14:21.199904,Pollo · Desayunos,Candelina,8900,5300,14200
21106,21107,21-10-2020 16:14:21.467535,Saludable,Hanai - Bowls Saludables,34500,5900,40400
21107,21108,21-10-2020 16:14:21.632611,Panadería,Boul,7500,3100,10600
21108,21109,21-10-2020 16:14:21.848929,Desayunos · Típica,Alce,45800,4900,50700
21109,21110,21-10-2020 16:14:22.063524,Perros Calientes,Dog Shop - Rapida,53900,4900,58800
21110,21111,21-10-2020 16:14:22.331020,Desayunos · Panadería,Juliana Restaurante,34500,6100,40600
21111,21112,21-10-2020 16:14:22.596792,Desayunos · Típica,Criollomania,23000,5200,28200
21112,21113,21-10-2020 16:14:22.812985,Comida Rápida,Fiesta Digital Andrés,18900,3100,22000
21113,21114,21-10-2020 16:14:23.228596,Saludable,Hanai - Bowls Saludables,7500,5900,13400
21114,21115,21-10-2020 16:14:23.545627,Desayunos · Café,Moramia,39700,4700,44400
21115,21116,21-10-2020 16:14:23.710296,Hamburguesas · Saludable,Restaurant Inn,9000,6100,15100
21116,21117,21-10-2020 16:14:23.977105,Postres · Helados,Mahé,35000,6000,41000
21117,21118,21-10-2020 16:14:24.242610,Postres · Desayunos,BagBog Bagels,15000,6400,21400
21118,21119,21-10-2020 16:14:24.409273,Saludable · Desayunos,Malú,18900,3700,22600
21119,21120,21-10-2020 16:14:24.673684,Crepes,La Chabatta,17800,5900,23700
21120,21121,21-10-2020 16:14:25.040385,Parrilla · Café,Figaro Café/ Restaurante Argentino,29500,5800,35300
21121,21122,21-10-2020 16:14:25.255649,Postres,Levelma,13000,6200,19200
21122,21123,21-10-2020 16:14:25.572916,Saludable · Desayunos,Copacabana Açai Bowls,27800,3000,30800
21123,21124,21-10-2020 16:14:25.787565,Pollo,Chicken House,34500,4200,38700
21124,21125,21-10-2020 16:14:26.054016,Comida Rápida,Fiesta Digital Andrés,7500,3100,10600
21125,21126,21-10-2020 16:14:26.468913,Pizza · Italiana,Pisapore - Pizza,35000,6600,41600
21126,21127,21-10-2020 16:14:26.785575,Saludable · Desayunos,Re.al Alimentos Reales,39700,4000,43700
21127,21128,21-10-2020 16:14:26.999595,Pizza · Italiana,Pisapore - Pizza,17800,6600,24400
21128,21129,21-10-2020 16:14:27.266525,Típica,La Cocina,15600,4600,20200
21129,21130,21-10-2020 16:14:27.481174,Típica · Parrilla,Mi Ranchito Parrilla,9000,4400,13400
21130,21131,21-10-2020 16:14:27.848416,Pizza · Italiana,Piatto - Pizza,11870,6600,18470
21131,21132,21-10-2020 16:14:28.112740,Postres · Desayunos,Maltihelado,29500,4500,34000
21132,21133,21-10-2020 16:14:28.279635,Parrilla · Café,Gaira Café,39700,4400,44100
21133,21134,21-10-2020 16:14:28.494266,Desayunos · Típica,D'Porco - Lechona,18900,6300,25200
21134,21135,21-10-2020 16:14:28.760850,Hamburguesas · Pescados y Mariscos,El Velero,53400,6500,59900
21135,21136,21-10-2020 16:14:29.075002,Desayunos · Sánduches,Danilo Colombia,9000,3300,12300
21136,21137,21-10-2020 16:14:29.492248,Saludable,Puro Verde,10700,5700,16400
21137,21138,21-10-2020 16:14:29.807122,Desayunos · Pescados y Mariscos,Luzí­a - Mediterranea,37900,5700,43600
21138,21139,21-10-2020 16:14:29.973334,Desayunos · Panadería,Choclofee,53900,4700,58600
21139,21140,21-10-2020 16:14:30.237972,Postres · Desayunos,Sharmus,29500,6100,35600
21140,21141,21-10-2020 16:14:30.404802,Hamburguesas,Bendito Cordero,70000,5800,75800
21141,21142,21-10-2020 16:14:30.569741,Desayunos · Comida Rápida,Chocolatto,12500,3400,15900
21142,21143,21-10-2020 16:14:30.836281,Desayunos · Típica,La Parrilla Dorada Polo,31800,6600,38400
21143,21144,21-10-2020 16:14:31.000370,Desayunos · Panadería,Le Pain Quotidien,34500,3900,38400
21144,21145,21-10-2020 16:14:31.167301,Pizza · Parrilla,Urban Lunch,15000,4000,19000
21145,21146,21-10-2020 16:14:31.481929,Parrilla,Campocina,13600,4600,18200
21146,21147,21-10-2020 16:14:31.649402,Hamburguesas,Bendito Cordero,18900,5800,24700
21147,21148,21-10-2020 16:14:31.863352,Postres · Desayunos,Maltihelado,23000,4500,27500
21148,21149,21-10-2020 16:14:32.130450,Saludable · Desayunos,Copacabana Açai Bowls,23000,3000,26000
21149,21150,21-10-2020 16:14:32.495593,Parrilla,Parrilla Pimentón,48750,3400,52150
21150,21151,21-10-2020 16:14:32.913499,Postres · Helados,Mahé,39700,6000,45700
21151,21152,21-10-2020 16:14:33.179905,Hamburguesas,Bendito Cordero,7500,5800,13300
21152,21153,21-10-2020 16:14:33.598673,Parrilla · Internacional,Taperia de la Plaza,13600,5700,19300
21153,21154,21-10-2020 16:14:33.763613,Desayunos · Jugos y Batidos,Frutiwow,70000,4100,74100
21154,21155,21-10-2020 16:14:34.131022,Postres · Desayunos,La Folie - Postres,15600,3300,18900
21155,21156,21-10-2020 16:14:34.545910,Postres · Desayunos,Sweet Tale,12500,5800,18300
21156,21157,21-10-2020 16:14:34.811916,Pizza,pizza andante,45800,4200,50000
21157,21158,21-10-2020 16:14:35.075976,Típica,Bandejas Mrg,9000,3800,12800
21158,21159,21-10-2020 16:14:35.242958,Saludable,Hanai - Bowls Saludables,13600,5900,19500
21159,21160,21-10-2020 16:14:35.507282,Desayunos,Sr Buñuelo,29500,6400,35900
21160,21161,21-10-2020 16:14:35.824029,Saludable · Desayunos,Agua Dulce,27800,3700,31500
21161,21162,21-10-2020 16:14:36.188466,Postres · Desayunos,Protein Bakes,23000,5900,28900
21162,21163,21-10-2020 16:14:36.504416,Desayunos · Típica,Desayunadero de la 42,18900,5900,24800
21163,21164,21-10-2020 16:14:36.769231,Desayunos · Típica,La Parrilla Dorada Polo,13600,6600,20200
21164,21165,21-10-2020 16:14:37.186017,Alta Cocina · Parrilla,Criterión,48750,6000,54750
21165,21166,21-10-2020 16:14:37.350910,Desayunos · Pescados y Mariscos,Gypsy Bistro,15000,4500,19500
21166,21167,21-10-2020 16:14:37.718413,Típica,Baondish,53900,5800,59700
21167,21168,21-10-2020 16:14:37.882444,Desayunos · Típica,Desayunadero de la 42,39700,5900,45600
21168,21169,21-10-2020 16:14:38.200096,Parrilla · Café,Figaro Café/ Restaurante Argentino,9000,5800,14800
21169,21170,21-10-2020 16:14:38.364892,Parrilla,Campocina,34500,4600,39100
21170,21171,21-10-2020 16:14:38.681354,Desayunos · Panadería,Choclofee,48750,4700,53450
21171,21172,21-10-2020 16:14:39.045785,Desayunos · Típica,Peninsula Calentados y Parrilla,70000,3400,73400
21172,21173,21-10-2020 16:14:39.312728,Postres · Desayunos,Sharmus,34500,6100,40600
21173,21174,21-10-2020 16:14:39.478530,Saludable · Desayunos,Distrito Gourmet,65000,3700,68700
21174,21175,21-10-2020 16:14:39.796000,Postres · Desayunos,Vivalight Market.,65000,6500,71500
21175,21176,21-10-2020 16:14:40.010917,Saludable · Desayunos,Fresh Co,10700,5600,16300
21176,21177,21-10-2020 16:14:40.328034,Típica,Cabrito Santandereano,65000,6600,71600
21177,21178,21-10-2020 16:14:40.743225,Pollo · China,China Tao,35000,3500,38500
21178,21179,21-10-2020 16:14:41.110565,Saludable · Típica,Sopas Mrg,18900,3100,22000
21179,21180,21-10-2020 16:14:41.426643,Saludable · Desayunos,Bawana - Sandwich,17800,3400,21200
21180,21181,21-10-2020 16:14:41.794628,Desayunos,El Fogón Castellano,9000,3200,12200
21181,21182,21-10-2020 16:14:42.209714,Desayunos,Señor Desayuno,35000,6800,41800
21182,21183,21-10-2020 16:14:42.376458,Típica,Bandejas Mrg,13000,3800,16800
21183,21184,21-10-2020 16:14:42.691408,Desayunos · Café,Moramia,27800,4700,32500
21184,21185,21-10-2020 16:14:43.108598,Helados,Buon Gelato,23000,4400,27400
21185,21186,21-10-2020 16:14:43.424821,Desayunos · Café,Norma's Ice Cream Café,53400,6300,59700
21186,21187,21-10-2020 16:14:43.591704,Sushi,Canoa To Go,23000,5900,28900
21187,21188,21-10-2020 16:14:43.856399,Hamburguesas,Gofi Burger,27800,5100,32900
21188,21189,21-10-2020 16:14:44.123228,Desayunos · Panadería,Pasteleite,29500,5900,35400
21189,21190,21-10-2020 16:14:44.287904,Pizza,18 Scalini,29500,4300,33800
21190,21191,21-10-2020 16:14:44.654624,Comida Rápida · Perros Calientes,Similoa - Comida Rapida,45800,3700,49500
21191,21192,21-10-2020 16:14:45.019033,Desayunos · Jugos y Batidos,Kuriwaji,39700,6300,46000
21192,21193,21-10-2020 16:14:45.335972,Saludable · Desayunos,Copacabana Açai Bowls,70000,3000,73000
21193,21194,21-10-2020 16:14:45.651555,Saludable · Desayunos,Re.al Alimentos Reales,37900,4000,41900
21194,21195,21-10-2020 16:14:45.968440,Pizza,18 Scalini,7500,4300,11800
21195,21196,21-10-2020 16:14:46.383696,Desayunos · Pescados y Mariscos,Gypsy Bistro,53900,4500,58400
21196,21197,21-10-2020 16:14:46.600397,Postres · Desayunos,Maltihelado,53400,4500,57900
21197,21198,21-10-2020 16:14:46.765170,Típica · Parrilla,Typykos,12500,6000,18500
21198,21199,21-10-2020 16:14:47.182256,Desayunos · Sánduches,Danilo Colombia,45800,3300,49100
21199,21200,21-10-2020 16:14:47.447045,Desayunos · Panadería,Ficchi Panadería,24300,3100,27400
21200,21201,21-10-2020 16:14:47.863971,Postres,Toledo Pastelería,70000,6800,76800
21201,21202,21-10-2020 16:14:48.179581,Típica,La Olla de Barro,70000,5300,75300
21202,21203,21-10-2020 16:14:48.397294,Desayunos · Típica,D'Porco - Lechona,53400,6300,59700
21203,21204,21-10-2020 16:14:48.762910,Desayunos · Pescados y Mariscos,Gypsy Bistro,10700,4500,15200
21204,21205,21-10-2020 16:14:48.928901,Desayunos · Helados,San Giorgio Gelateria,35000,3100,38100
21205,21206,21-10-2020 16:14:49.093256,Desayunos,La Frijolada Desayunos,29500,4400,33900
21206,21207,21-10-2020 16:14:49.260256,Saludable,MIMA,7500,3700,11200
21207,21208,21-10-2020 16:14:49.575855,Desayunos · Panadería,Premium Break Bakery,31800,3700,35500
21208,21209,21-10-2020 16:14:49.892482,Pizza · Italiana,Piatto - Pizza,10700,6600,17300
21209,21210,21-10-2020 16:14:50.156917,Saludable · Desayunos,Fresh Co,17800,5600,23400
21210,21211,21-10-2020 16:14:50.323499,Parrilla,Antojo a Domicilio,13600,5000,18600
21211,21212,21-10-2020 16:14:50.738069,Típica,Sabrosito,17800,4000,21800
21212,21213,21-10-2020 16:14:51.156380,Desayunos · Empanadas,Empanadas Doraditas.com,23000,3000,26000
21213,21214,21-10-2020 16:14:51.322700,Desayunos · Comida Rápida,Chocolatto,48750,3400,52150
21214,21215,21-10-2020 16:14:51.589967,Desayunos · Típica,Casa Vieja,53400,6000,59400
21215,21216,21-10-2020 16:14:51.904973,Internacional,Rio Sabores y Experiencias,48750,4100,52850
21216,21217,21-10-2020 16:14:52.072954,Saludable · Desayunos,Bawana - Sandwich,70000,3400,73400
21217,21218,21-10-2020 16:14:52.288131,Sushi,Canoa To Go,23000,5900,28900
21218,21219,21-10-2020 16:14:52.605660,Saludable · Parrilla,The Angels Grill and Drinks,48750,6200,54950
21219,21220,21-10-2020 16:14:52.870751,Sushi,Kim Pop,29500,5400,34900
21220,21221,21-10-2020 16:14:53.288549,Desayunos,El Fogón Castellano,11870,3200,15070
21221,21222,21-10-2020 16:14:53.703864,Típica · Parrilla,Mi Ranchito Parrilla,45800,4400,50200
21222,21223,21-10-2020 16:14:54.022734,Postres · Desayunos,Maltihelados,31800,6200,38000
21223,21224,21-10-2020 16:14:54.188040,Desayunos · Típica,90 Calentados,11870,3700,15570
21224,21225,21-10-2020 16:14:54.605608,Desayunos · Típica,Criollomania,65000,5200,70200
21225,21226,21-10-2020 16:14:54.971437,Postres · Helados,Mahé,48750,6000,54750
21226,21227,21-10-2020 16:14:55.288849,Desayunos · Panadería,Artesanos,12500,4300,16800
21227,21228,21-10-2020 16:14:55.503747,Alta Cocina · Postres,La Pinta,70000,4500,74500
21228,21229,21-10-2020 16:14:55.821570,Saludable · Desayunos,Libre de Culpa,37900,4000,41900
21229,21230,21-10-2020 16:14:55.986514,Desayunos · Panadería,Santa Juana Food Bar,45800,5900,51700
21230,21231,21-10-2020 16:14:56.353724,Parrilla · Internacional,Taperia de la Plaza,10700,5700,16400
21231,21232,21-10-2020 16:14:56.669887,Desayunos · Panadería,El Pan de Phillippe,15000,4600,19600
21232,21233,21-10-2020 16:14:56.936577,Parrilla,Restaurante Bar Mi Ranchito,35000,5200,40200
21233,21234,21-10-2020 16:14:57.352122,Perros Calientes,Dog Shop - Rapida,11870,4900,16770
21234,21235,21-10-2020 16:14:57.620632,Desayunos · Típica,Calentao Express,12500,6000,18500
21235,21236,21-10-2020 16:14:57.836954,Hamburguesas · Alitas,Beer,15000,6600,21600
21236,21237,21-10-2020 16:14:58.156312,Desayunos · Café,Libertario Coffee Roasters,23000,4600,27600
21237,21238,21-10-2020 16:14:58.322982,Pollo · Sánduches,Pollos Century,8900,3000,11900
21238,21239,21-10-2020 16:14:58.541189,Pizza · Parrilla,Urban Lunch,9000,4000,13000
21239,21240,21-10-2020 16:14:58.757073,Internacional,Rio Sabores y Experiencias,53400,4100,57500
21240,21241,21-10-2020 16:14:58.975083,Típica · Parrilla,Typykos,39700,6000,45700
21241,21242,21-10-2020 16:14:59.191651,Desayunos · Típica,Peninsula Calentados y Parrilla,27800,3400,31200
21242,21243,21-10-2020 16:14:59.409593,Parrilla,Carnes la Zarza,45800,4900,50700
21243,21244,21-10-2020 16:14:59.775637,Desayunos · Café,Frambas,9000,3400,12400
21244,21245,21-10-2020 16:15:00.043303,Peruana,Masivo,13600,5800,19400
21245,21246,21-10-2020 16:15:00.309007,Pizza,Pizza Andante,10700,6300,17000
21246,21247,21-10-2020 16:15:00.576409,Desayunos · Típica,90 Calentados,48750,3700,52450
21247,21248,21-10-2020 16:15:00.791712,Saludable,The Good Rice Bowls,11870,3500,15370
21248,21249,21-10-2020 16:15:01.008893,Mexicana,Mexicanachos,12500,3900,16400
21249,21250,21-10-2020 16:15:01.224611,Saludable · Desayunos,Fresh Co,17800,5600,23400
21250,21251,21-10-2020 16:15:01.492459,Sushi · Asiática,Tu Sushi,17800,6400,24200
21251,21252,21-10-2020 16:15:01.907970,Sushi,Canoa To Go,11870,5900,17770
21252,21253,21-10-2020 16:15:02.226139,Desayunos,Señor Desayuno,45800,6800,52600
21253,21254,21-10-2020 16:15:02.390851,Saludable,Ventura Soup y Salad,37900,3800,41700
21254,21255,21-10-2020 16:15:02.607531,Sánduches · China,Peru Mix,24300,5900,30200
21255,21256,21-10-2020 16:15:02.972681,Sushi · Desayunos,Maki Roll,27800,4300,32100
21256,21257,21-10-2020 16:15:03.339690,Desayunos · Panadería,Artesanos,29500,4300,33800
21257,21258,21-10-2020 16:15:03.705157,Típica · Parrilla,Parrilla Farandula Gourmet,9000,5100,14100
21258,21259,21-10-2020 16:15:04.122118,Mexicana,Cantina La 15,29500,4300,33800
21259,21260,21-10-2020 16:15:04.537953,Postres · Desayunos,Gelateria Da Favola,53400,6500,59900
21260,21261,21-10-2020 16:15:04.954849,Pollo · Típica,Auyama,24200,3900,28100
21261,21262,21-10-2020 16:15:05.119527,Hamburguesas · Panadería,NYC Burgers,12500,6200,18700
21262,21263,21-10-2020 16:15:05.437596,Desayunos,El Fogón Castellano,23000,3200,26200
21263,21264,21-10-2020 16:15:05.702081,Postres · Desayunos,Sharmus,23000,6100,29100
21264,21265,21-10-2020 16:15:05.868798,Asiática,TeT,70000,5900,75900
21265,21266,21-10-2020 16:15:06.234722,Postres · Desayunos,Vivalight Market.,39700,6500,46200
21266,21267,21-10-2020 16:15:06.402208,Pizza,Pastas Laurentina,65000,4800,69800
21267,21268,21-10-2020 16:15:06.817363,Desayunos · Típica,Rojo Gourmet,24200,4700,28900
21268,21269,21-10-2020 16:15:07.084127,Desayunos · Típica,Fogón Sangileño,48750,5000,53750
21269,21270,21-10-2020 16:15:07.450667,Desayunos · Café,Libertario Coffee Roasters,15000,4600,19600
21270,21271,21-10-2020 16:15:07.818701,Pollo · Desayunos,Workzone,23000,3100,26100
21271,21272,21-10-2020 16:15:08.134809,Típica,Sopitas y Más,9000,4200,13200
21272,21273,21-10-2020 16:15:08.453495,Desayunos · Café,Aromacafé el Placer de Compartir,24200,5000,29200
21273,21274,21-10-2020 16:15:08.768690,Alta Cocina · Parrilla,Criterión,18900,6000,24900
21274,21275,21-10-2020 16:15:09.185786,Saludable · Desayunos,Agua Dulce,70000,3700,73700
21275,21276,21-10-2020 16:15:09.601905,Parrilla,OAK Ahumado y Brebajes,39700,6000,45700
21276,21277,21-10-2020 16:15:09.819686,Postres · Desayunos,Maltihelados,53400,6200,59600
21277,21278,21-10-2020 16:15:10.135039,Desayunos · Panadería,Pasteleite,15000,5900,20900
21278,21279,21-10-2020 16:15:10.452544,Pizza · Italiana,Piatto - Pizza,11870,6600,18470
21279,21280,21-10-2020 16:15:10.817716,Postres · Desayunos,Cosmo Cookies,35000,5900,40900
21280,21281,21-10-2020 16:15:10.984456,Pollo,Chicken House,70000,4200,74200
21281,21282,21-10-2020 16:15:11.199094,Desayunos · Típica,Cochon,53900,3300,57200
21282,21283,21-10-2020 16:15:11.516459,Sánduches · Pescados y Mariscos,Pacific Comida de Mar,15600,4000,19600
21283,21284,21-10-2020 16:15:11.830933,Desayunos,Archies Desayunos,24300,3100,27400
21284,21285,21-10-2020 16:15:12.248379,Saludable,A2manos,18900,4200,23100
21285,21286,21-10-2020 16:15:12.663897,Desayunos · Árabe,Boniato Sabores Vivos,8900,5300,14200
21286,21287,21-10-2020 16:15:12.930737,Típica · Parrilla,Toya,29500,4200,33700
21287,21288,21-10-2020 16:15:13.146028,Desayunos · Panadería,Siena Café,12500,3700,16200
21288,21289,21-10-2020 16:15:13.464473,Desayunos · Panadería,Artesanos,35000,4300,39300
21289,21290,21-10-2020 16:15:13.729736,Pizza · Parrilla,Urban Lunch,13000,4000,17000
21290,21291,21-10-2020 16:15:14.147263,Desayunos,Bagel Shop,17800,3200,21000
21291,21292,21-10-2020 16:15:14.361694,Pollo,Heart & Cooking,53900,5000,58900
21292,21293,21-10-2020 16:15:14.629857,Desayunos,Cafetería el Kippe,7500,3200,10700
21293,21294,21-10-2020 16:15:14.994692,Desayunos · Típica,Peninsula Calentados y Parrilla,7500,3400,10900
21294,21295,21-10-2020 16:15:15.211761,Postres · Desayunos,Maria Luisa - Postres,53900,4300,58200
21295,21296,21-10-2020 16:15:15.626913,Jugos y Batidos,Pomponio,35000,3600,38600
21296,21297,21-10-2020 16:15:15.944419,Sushi,Canoa To Go,15600,5900,21500
21297,21298,21-10-2020 16:15:16.259809,Italiana,Bocatto Di Passo,10700,5000,15700
21298,21299,21-10-2020 16:15:16.677159,Típica · Parrilla,El Portal de la Antigua,7500,5600,13100
21299,21300,21-10-2020 16:15:17.092662,Saludable · Desayunos,Agua Dulce,31800,3700,35500
21300,21301,21-10-2020 16:15:17.410358,Desayunos · Típica,D'Porco - Lechona,24200,6300,30500
21301,21302,21-10-2020 16:15:17.725740,Desayunos · Típica,Desayunadero de la 42,23000,5900,28900
21302,21303,21-10-2020 16:15:17.942997,Típica · Parrilla,La Ternera Parrilla,70000,5200,75200
21303,21304,21-10-2020 16:15:18.158252,Parrilla,Coquitas,65000,5600,70600
21304,21305,21-10-2020 16:15:18.375301,Desayunos · Típica,Casa Vieja,29500,6000,35500
21305,21306,21-10-2020 16:15:18.540953,Saludable · Desayunos,Re.al Alimentos Reales,13000,4000,17000
21306,21307,21-10-2020 16:15:18.908734,Pollo,Señor Fantástico,12500,4700,17200
21307,21308,21-10-2020 16:15:19.073745,Pizza,Pizza Andante,31800,6300,38100
21308,21309,21-10-2020 16:15:19.441912,Desayunos · Jugos y Batidos,Dont Be Hungry,35000,5600,40600
21309,21310,21-10-2020 16:15:19.758175,Postres · Desayunos,Amelie Helados,13600,6400,20000
21310,21311,21-10-2020 16:15:19.924886,Postres · Desayunos,Café Quindio,18900,5700,24600
21311,21312,21-10-2020 16:15:20.140517,Típica,El Cucharón - Tipica,27800,4400,32200
21312,21313,21-10-2020 16:15:20.457563,Saludable · Desayunos,Re.al Alimentos Reales,23000,4000,27000
21313,21314,21-10-2020 16:15:20.872457,Desayunos · Típica,Criollomania,65000,5200,70200
21314,21315,21-10-2020 16:15:21.240062,Desayunos · Pescados y Mariscos,Gypsy Bistro,29500,4500,34000
21315,21316,21-10-2020 16:15:21.505405,Típica,Campo Victoria,23000,3000,26000
21316,21317,21-10-2020 16:15:21.722846,Parrilla · Café,Gaira Café,35000,4400,39400
21317,21318,21-10-2020 16:15:22.088082,Pollo,Oliva Va,18900,5600,24500
21318,21319,21-10-2020 16:15:22.255116,Crepes,La Chabatta,24300,5900,30200
21319,21320,21-10-2020 16:15:22.620465,Saludable,Puro Verde,15000,5700,20700
21320,21321,21-10-2020 16:15:22.787462,Desayunos · Típica,Cochon,35000,3300,38300
21321,21322,21-10-2020 16:15:23.052109,Pollo · Pescados y Mariscos,Bang Bang Rice,23000,3400,26400
21322,21323,21-10-2020 16:15:23.218651,Desayunos · Empanadas,Empanadas Doraditas.com,45800,3000,48800
21323,21324,21-10-2020 16:15:23.584177,Saludable · Parrilla,Box,23000,3700,26700
21324,21325,21-10-2020 16:15:23.751574,Desayunos · Típica,La Frijolada,34500,4500,39000
21325,21326,21-10-2020 16:15:24.116509,Postres · Desayunos,Maria Luisa - Postres,39700,4300,44000
21326,21327,21-10-2020 16:15:24.383714,Desayunos · Típica,Alce,53900,4900,58800
21327,21328,21-10-2020 16:15:24.799643,Sushi · Desayunos,Maki Roll,37900,4300,42200
21328,21329,21-10-2020 16:15:25.116794,Peruana,Masivo,23000,5800,28800
21329,21330,21-10-2020 16:15:25.331635,Típica,La Olla de Barro,35000,5300,40300
21330,21331,21-10-2020 16:15:25.749059,Sánduches · China,Peru Mix,23000,5900,28900
21331,21332,21-10-2020 16:15:26.114004,Saludable · Desayunos,Básico y elemental,8900,5000,13900
21332,21333,21-10-2020 16:15:26.481783,Italiana,F*cking Good Pizza,17800,4200,22000
21333,21334,21-10-2020 16:15:26.896148,Saludable,Ventura Soup y Salad,8900,3800,12700
21334,21335,21-10-2020 16:15:27.062781,Desayunos · Típica,Cochon,24300,3300,27600
21335,21336,21-10-2020 16:15:27.327271,Postres · Saludable,Ana Rebana,15000,6300,21300
21336,21337,21-10-2020 16:15:27.494600,Parrilla,Arepaisa de Medellín,9000,5600,14600
21337,21338,21-10-2020 16:15:27.759768,Postres,Toledo Pastelería,13600,6800,20400
21338,21339,21-10-2020 16:15:27.976572,Saludable · Desayunos,Básico y elemental,27800,5000,32800
21339,21340,21-10-2020 16:15:28.191740,Pollo,Oliva Va,11870,5600,17470
21340,21341,21-10-2020 16:15:28.609602,Típica · Parrilla,Toya,34500,4200,38700
21341,21342,21-10-2020 16:15:28.975134,Postres · Desayunos,Maria Luisa - Postres,27800,4300,32100
21342,21343,21-10-2020 16:15:29.292541,Hamburguesas,Burger Society,23000,4100,27100
21343,21344,21-10-2020 16:15:29.607911,Pollo · Desayunos,Abasto,8900,3600,12500
21344,21345,21-10-2020 16:15:30.025712,Postres · Desayunos,La Folie - Postres,29500,3300,32800
21345,21346,21-10-2020 16:15:30.441639,Saludable,A2manos,53400,4200,57600
21346,21347,21-10-2020 16:15:30.809020,Parrilla,El Tambor,15600,6800,22400
21347,21348,21-10-2020 16:15:31.024026,Saludable,Ventura Soup y Salad,7500,3800,11300
21348,21349,21-10-2020 16:15:31.441741,Pollo · Pescados y Mariscos,Bang Bang Rice,9000,3400,12400
21349,21350,21-10-2020 16:15:31.607523,Desayunos · Árabe,Boniato Sabores Vivos,13600,5300,18900
21350,21351,21-10-2020 16:15:32.025622,Asiática,TeT,15000,5900,20900
21351,21352,21-10-2020 16:15:32.191431,Parrilla · Café,Figaro Café/ Restaurante Argentino,35000,5800,40800
21352,21353,21-10-2020 16:15:32.559920,Desayunos,Jacinta Arepas de Huevo,24300,4000,28300
21353,21354,21-10-2020 16:15:32.775503,Típica · Pescados y Mariscos,La Vitualla,8900,6300,15200
21354,21355,21-10-2020 16:15:33.193359,Pizza,Pizza Andante,45800,6300,52100
21355,21356,21-10-2020 16:15:33.559050,Pollo,Heart & Cooking,37900,5000,42900
21356,21357,21-10-2020 16:15:33.876668,Pollo · Saludable,Yerbabuena,18900,3900,22800
21357,21358,21-10-2020 16:15:34.091770,Pollo · Desayunos,Candelina,23000,5300,28300
21358,21359,21-10-2020 16:15:34.408924,Desayunos · Típica,Rojo Gourmet,53400,4700,58100
21359,21360,21-10-2020 16:15:34.625672,Postres · Desayunos,Maltihelado,34500,4500,39000
21360,21361,21-10-2020 16:15:34.894481,Pollo · Sánduches,Pollos Century,7500,3000,10500
21361,21362,21-10-2020 16:15:35.212664,Crepes,San Crepes,24300,4900,29200
21362,21363,21-10-2020 16:15:35.480695,Desayunos · Internacional,Camilia,24200,3900,28100
21363,21364,21-10-2020 16:15:35.696343,Típica,Baondish,48750,5800,54550
21364,21365,21-10-2020 16:15:36.014327,Desayunos · Café,Aromacafé el Placer de Compartir,29500,5000,34500
21365,21366,21-10-2020 16:15:36.329575,Saludable · Desayunos,Bawana - Sandwich,13000,3400,16400
21366,21367,21-10-2020 16:15:36.647262,Saludable · Desayunos,Re.al Alimentos Reales,39700,4000,43700
21367,21368,21-10-2020 16:15:36.812741,Típica,Lo Nuestro,39700,3100,42800
21368,21369,21-10-2020 16:15:36.979925,Hamburguesas,Monchis - Hamburguesa,15600,4300,19900
21369,21370,21-10-2020 16:15:37.195467,Típica,La Cocina,7500,4600,12100
21370,21371,21-10-2020 16:15:37.562839,Desayunos · Típica,Criollomania,35000,5200,40200
21371,21372,21-10-2020 16:15:37.978517,Postres,Toledo Pastelería,53900,6800,60700
21372,21373,21-10-2020 16:15:38.396583,Sushi,Canoa To Go,31800,5900,37700
21373,21374,21-10-2020 16:15:38.662464,Típica · Parrilla,La Ternera Parrilla,15000,5200,20200
21374,21375,21-10-2020 16:15:38.979823,Típica,Salsig,65000,5600,70600
21375,21376,21-10-2020 16:15:39.194829,Saludable,A2manos,48750,4200,52950
21376,21377,21-10-2020 16:15:39.462852,Desayunos · Típica,D´Porco,27800,3900,31700
21377,21378,21-10-2020 16:15:39.877813,Desayunos · Panadería,Le Pain Quotidien,15600,3900,19500
21378,21379,21-10-2020 16:15:40.195606,Saludable · Desayunos,Malú,13600,3700,17300
21379,21380,21-10-2020 16:15:40.561509,Parrilla,El Tambor,31800,6800,38600
21380,21381,21-10-2020 16:15:40.778458,Hamburguesas,Burger Society,15600,4100,19700
21381,21382,21-10-2020 16:15:41.193597,Desayunos,Archies Desayunos,35000,3100,38100
21382,21383,21-10-2020 16:15:41.461022,Desayunos,Jacinta Arepas de Huevo,48750,4000,52750
21383,21384,21-10-2020 16:15:41.676188,Helados,Orso To Go,39700,6800,46500
21384,21385,21-10-2020 16:15:41.893824,Desayunos · Café,Matchacha,53400,5900,59300
21385,21386,21-10-2020 16:15:42.058739,Parrilla,Restaurante Bar Mi Ranchito,65000,5200,70200
21386,21387,21-10-2020 16:15:42.476721,Saludable · Desayunos,Agua Dulce,35000,3700,38700
21387,21388,21-10-2020 16:15:42.892082,Desayunos · Panadería,Pasteleite,23000,5900,28900
21388,21389,21-10-2020 16:15:43.109264,Desayunos · Típica,La Parrilla Dorada Polo,35000,6600,41600
21389,21390,21-10-2020 16:15:43.475247,Postres · Saludable,Ana Rebana,13000,6300,19300
21390,21391,21-10-2020 16:15:43.642475,Peruana,Masivo,15000,5800,20800
21391,21392,21-10-2020 16:15:43.907405,Desayunos · Comida Rápida,La Veneca,53900,6300,60200
21392,21393,21-10-2020 16:15:44.276074,Alta Cocina · Parrilla,Criterión,23000,6000,29000
21393,21394,21-10-2020 16:15:44.591056,Típica · Pescados y Mariscos,Arroces Mrg,45800,4300,50100
21394,21395,21-10-2020 16:15:44.758547,Desayunos · Café,El Gualilo,53900,6200,60100
21395,21396,21-10-2020 16:15:45.124027,Desayunos · Pescados y Mariscos,Luzí­a - Mediterranea,23000,5700,28700
21396,21397,21-10-2020 16:15:45.291619,Típica,Salsig,29500,5600,35100
21397,21398,21-10-2020 16:15:45.456721,Típica · Pescados y Mariscos,Arroces Mrg,48750,4300,53050
21398,21399,21-10-2020 16:15:45.674844,Peruana,Masivo,37900,5800,43700
21399,21400,21-10-2020 16:15:45.889960,Pollo · Desayunos,Workzone,45800,3100,48900
21400,21401,21-10-2020 16:15:46.207394,Desayunos · Empanadas,Mis Delicias,13600,3200,16800
21401,21402,21-10-2020 16:15:46.522702,Desayunos · Café,Norma's Ice Cream Café,27800,6300,34100
21402,21403,21-10-2020 16:15:46.940079,Postres · Desayunos,KOKOA & co.,53400,4700,58100
21403,21404,21-10-2020 16:15:47.104906,Desayunos · Comida Rápida,La Veneca,45800,6300,52100
21404,21405,21-10-2020 16:15:47.322591,Sánduches,Submarin,39700,3800,43500
21405,21406,21-10-2020 16:15:47.737964,Saludable · Desayunos,Maracuyá,10700,6700,17400
21406,21407,21-10-2020 16:15:48.155592,Desayunos · Típica,Calentao Express,35000,6000,41000
21407,21408,21-10-2020 16:15:48.470810,Postres · Desayunos,Jacques Pastelería,39700,5900,45600
21408,21409,21-10-2020 16:15:48.638615,Desayunos,Jacinta Arepas de Huevo,23000,4000,27000
21409,21410,21-10-2020 16:15:49.003783,Alta Cocina · Postres,La Pinta,53900,4500,58400
21410,21411,21-10-2020 16:15:49.370685,Desayunos · Típica,Casa Vieja,7500,6000,13500
21411,21412,21-10-2020 16:15:49.685401,Desayunos · Panadería,El Pan de Phillippe,23000,4600,27600
21412,21413,21-10-2020 16:15:50.103015,Postres · Desayunos,KOKOA & co.,15600,4700,20300
21413,21414,21-10-2020 16:15:50.367820,Desayunos,Butter,11870,6700,18570
21414,21415,21-10-2020 16:15:50.686177,Desayunos · Panadería,Premium Break Bakery,7500,3700,11200
21415,21416,21-10-2020 16:15:50.951263,Típica,Lo Nuestro,23000,3100,26100
21416,21417,21-10-2020 16:15:51.168595,Parrilla,Rústico Picadería,24300,3800,28100
21417,21418,21-10-2020 16:15:51.534037,Parrilla,Coquitas,48750,5600,54350
21418,21419,21-10-2020 16:15:51.952727,China,China Food Col,8900,3600,12500
21419,21420,21-10-2020 16:15:52.318322,Desayunos · Panadería,Le Pain Quotidien,27800,3900,31700
21420,21421,21-10-2020 16:15:52.535121,Desayunos,Fratelli - Desayunos,45800,4600,50400
21421,21422,21-10-2020 16:15:52.750158,Desayunos · Panadería,Santa Juana Food Bar,15000,5900,20900
21422,21423,21-10-2020 16:15:53.117287,Saludable,Hanai - Bowls Saludables,39700,5900,45600
21423,21424,21-10-2020 16:15:53.332655,Pollo · Típica,Auyama,45800,3900,49700
21424,21425,21-10-2020 16:15:53.500343,Saludable · Desayunos,Malú,34500,3700,38200
21425,21426,21-10-2020 16:15:53.715857,Postres · Panadería,RIGHT AWAY FOODS,7500,6600,14100
21426,21427,21-10-2020 16:15:54.033112,Sánduches,Submarin,39700,3800,43500
21427,21428,21-10-2020 16:15:54.298442,Saludable · Parrilla,The Angels Grill and Drinks,23000,6200,29200
21428,21429,21-10-2020 16:15:54.515284,Hamburguesas,Gofi Burger,18900,5100,24000
21429,21430,21-10-2020 16:15:54.730757,Pizza,Pastas Laurentina,15600,4800,20400
21430,21431,21-10-2020 16:15:55.098155,Internacional,Rio Sabores y Experiencias,34500,4100,38600
21431,21432,21-10-2020 16:15:55.413701,Desayunos · Mexicana,La Mera Mera - Mexicana,18900,3100,22000
21432,21433,21-10-2020 16:15:55.732830,Saludable,Puro Verde,15600,5700,21300
21433,21434,21-10-2020 16:15:56.098406,Asiática,Thai Station,45800,6000,51800
21434,21435,21-10-2020 16:15:56.265831,Postres · Café,Celestino Café,31800,5900,37700
21435,21436,21-10-2020 16:15:56.681095,Pescados y Mariscos,Fish Place - Del Mar,17800,5400,23200
21436,21437,21-10-2020 16:15:56.898046,Típica,Salsig,23000,5600,28600
21437,21438,21-10-2020 16:15:57.163445,Postres · Desayunos,La Folie - Postres,70000,3300,73300
21438,21439,21-10-2020 16:15:57.330278,Postres · Desayunos,KOKOA & co.,7500,4700,12200
21439,21440,21-10-2020 16:15:57.545520,Italiana,Bocatto Di Passo,17800,5000,22800
21440,21441,21-10-2020 16:15:57.962659,Típica,Salsig,24300,5600,29900
21441,21442,21-10-2020 16:15:58.228513,Comida Rápida · Perros Calientes,Similoa - Comida Rapida,31800,3700,35500
21442,21443,21-10-2020 16:15:58.546178,Pescados y Mariscos,Pescadero Héroes del Mar,24200,6600,30800
21443,21444,21-10-2020 16:15:58.860927,Típica,Sabrosito,35000,4000,39000
21444,21445,21-10-2020 16:15:59.278322,Desayunos · Sánduches,Frutos del Bosque,53900,3500,57400
21445,21446,21-10-2020 16:15:59.493367,Helados,Orso To Go,10700,6800,17500
21446,21447,21-10-2020 16:15:59.710518,Postres · Saludable,Ana Rebana,8900,6300,15200
21447,21448,21-10-2020 16:16:00.075912,Postres · Desayunos,La Folie - Postres,9000,3300,12300
21448,21449,21-10-2020 16:16:00.493367,Peruana · Internacional,La Chifería,17800,6600,24400
21449,21450,21-10-2020 16:16:00.809772,Típica · Parrilla,El Portal de la Antigua,35000,5600,40600
21450,21451,21-10-2020 16:16:01.177610,Parrilla,OAK Ahumado y Brebajes,18900,6000,24900
21451,21452,21-10-2020 16:16:01.594284,Pollo,Señor Fantástico,23000,4700,27700
21452,21453,21-10-2020 16:16:01.962426,Pollo,Señor Fantástico,53900,4700,58600
21453,21454,21-10-2020 16:16:02.178170,Postres · Desayunos,Jacques Pastelería,37900,5900,43800
21454,21455,21-10-2020 16:16:02.395281,Pollo,Oliva Va,53900,5600,59500
21455,21456,21-10-2020 16:16:02.810691,Desayunos · Empanadas,Empanadas Doraditas.com,53400,3000,56400
21456,21457,21-10-2020 16:16:03.228237,Desayunos · Panadería,Pasteleite,65000,5900,70900
21457,21458,21-10-2020 16:16:03.543742,Postres,Beiked,27800,4000,31800
21458,21459,21-10-2020 16:16:03.710741,Postres,Beiked,13000,4000,17000
21459,21460,21-10-2020 16:16:04.126621,Saludable,A2manos,27800,4200,32000
21460,21461,21-10-2020 16:16:04.393791,Desayunos · Café,Frambas,24200,3400,27600
21461,21462,21-10-2020 16:16:04.759346,Típica,Sopitas y Más,24300,4200,28500
21462,21463,21-10-2020 16:16:05.177224,Poke,Poke Go,12500,4600,17100
21463,21464,21-10-2020 16:16:05.592789,Desayunos · Pescados y Mariscos,Gypsy Bistro,53400,4500,57900
21464,21465,21-10-2020 16:16:05.811280,Desayunos · Panadería,Limarys,29500,6500,36000
21465,21466,21-10-2020 16:16:06.177295,Saludable · Desayunos,Fresh Co,9000,5600,14600
21466,21467,21-10-2020 16:16:06.394706,Desayunos · Italiana,Rceta By Rausch,34500,3600,38100
21467,21468,21-10-2020 16:16:06.710303,Italiana,Bocatto Di Passo,45800,5000,50800
21468,21469,21-10-2020 16:16:07.027596,Sushi · Desayunos,Maki Roll,45800,4300,50100
21469,21470,21-10-2020 16:16:07.343154,Postres · Desayunos,La Folie - Postres,15600,3300,18900
21470,21471,21-10-2020 16:16:07.760708,Desayunos · Típica,Casa Vieja,15000,6000,21000
21471,21472,21-10-2020 16:16:07.976333,Saludable,MIMA,12500,3700,16200
21472,21473,21-10-2020 16:16:08.193454,Desayunos,Desayunos en Bogotá,13600,3400,17000
21473,21474,21-10-2020 16:16:08.409468,Pollo · Saludable,Gratina,48750,4200,52950
21474,21475,21-10-2020 16:16:08.777652,Saludable · Desayunos,Fresh Co,48750,5600,54350
21475,21476,21-10-2020 16:16:09.143511,Pollo · Desayunos,Candelina,53400,5300,58700
21476,21477,21-10-2020 16:16:09.511624,Saludable · Desayunos,Copacabana Açai Bowls,70000,3000,73000
21477,21478,21-10-2020 16:16:09.827796,Desayunos · Italiana,Rceta By Rausch,37900,3600,41500
21478,21479,21-10-2020 16:16:10.146028,Italiana,F*cking Good Pizza,23000,4200,27200
21479,21480,21-10-2020 16:16:10.411815,Postres,Toledo Pastelería,35000,6800,41800
21480,21481,21-10-2020 16:16:10.629045,Postres · Desayunos,Restaurante Cornelia,45800,5500,51300
21481,21482,21-10-2020 16:16:10.845189,Desayunos · Típica,Fogón Sangileño,15600,5000,20600
21482,21483,21-10-2020 16:16:11.112386,Desayunos · Café,Aromacafé el Placer de Compartir,18900,5000,23900
21483,21484,21-10-2020 16:16:11.527780,Parrilla · Café,Figaro Café/ Restaurante Argentino,23000,5800,28800
21484,21485,21-10-2020 16:16:11.745500,Parrilla,Coquitas,24300,5600,29900
21485,21486,21-10-2020 16:16:12.060730,Postres,Toledo Pastelería,70000,6800,76800
21486,21487,21-10-2020 16:16:12.378240,Parrilla · Café,Figaro Café/ Restaurante Argentino,70000,5800,75800
21487,21488,21-10-2020 16:16:12.743248,Típica,Lo Nuestro,35000,3100,38100
21488,21489,21-10-2020 16:16:12.960832,Pizza · Italiana,Pisapore - Pizza,70000,6600,76600
21489,21490,21-10-2020 16:16:13.226001,Saludable · Desayunos,Copacabana Açai Bowls,45800,3000,48800
21490,21491,21-10-2020 16:16:13.493975,Parrilla,Carnes la Zarza,12500,4900,17400
21491,21492,21-10-2020 16:16:13.709808,Internacional,La Esquina con Sabor Parrilla,39700,3000,42700
21492,21493,21-10-2020 16:16:13.977051,Postres,La Galeta,53900,3000,56900
21493,21494,21-10-2020 16:16:14.142447,Postres · Desayunos,KOKOA & co.,37900,4700,42600
21494,21495,21-10-2020 16:16:14.509933,Postres · Desayunos,Gelateria Da Favola,65000,6500,71500
21495,21496,21-10-2020 16:16:14.775320,Desayunos · Panadería,Siena Café,10700,3700,14400
21496,21497,21-10-2020 16:16:15.143560,Desayunos · Típica,Rojo Gourmet,31800,4700,36500
21497,21498,21-10-2020 16:16:15.308644,Desayunos · Café,Frambas,18900,3400,22300
21498,21499,21-10-2020 16:16:15.576235,Alta Cocina · Italiana,Trattoria de la Plaza,70000,6000,76000
21499,21500,21-10-2020 16:16:15.741789,Pollo · Típica,Auyama,37900,3900,41800
21500,21501,21-10-2020 16:16:15.959456,Postres · Desayunos,Amelie Helados,39700,6400,46100
21501,21502,21-10-2020 16:16:16.275485,Típica,La Herencia,35000,5900,40900
21502,21503,21-10-2020 16:16:16.444178,Parrilla · Café,Gaira Café,13000,4400,17400
21503,21504,21-10-2020 16:16:16.709388,Crepes,La Chabatta,34500,5900,40400
21504,21505,21-10-2020 16:16:16.977048,Típica,Sabores De Mi Tierra,31800,5400,37200
21505,21506,21-10-2020 16:16:17.242750,Pizza · Parrilla,Urban Lunch,39700,4000,43700
21506,21507,21-10-2020 16:16:17.610889,Parrilla,OAK Ahumado y Brebajes,35000,6000,41000
21507,21508,21-10-2020 16:16:17.926354,Parrilla,Carnes la Zarza,9000,4900,13900
21508,21509,21-10-2020 16:16:18.093489,Hamburguesas,Monchis - Hamburguesa,15600,4300,19900
21509,21510,21-10-2020 16:16:18.308847,Saludable · Desayunos,Agua Dulce,31800,3700,35500
21510,21511,21-10-2020 16:16:18.626824,Desayunos · Italiana,Rceta By Rausch,18900,3600,22500
21511,21512,21-10-2020 16:16:18.892279,Desayunos · Panadería,Juliana Restaurante,18900,6100,25000
21512,21513,21-10-2020 16:16:19.259897,Postres,La Galeta,65000,3000,68000
21513,21514,21-10-2020 16:16:19.425684,Desayunos · Jugos y Batidos,Frutiwow,11870,4100,15970
21514,21515,21-10-2020 16:16:19.843484,Postres · Helados,Mahé,23000,6000,29000
21515,21516,21-10-2020 16:16:20.158897,Sushi · Asiática,Arigato,9000,5300,14300
21516,21517,21-10-2020 16:16:20.326353,Típica · Parrilla,La Ternera Parrilla,70000,5200,75200
21517,21518,21-10-2020 16:16:20.591703,Sushi,Sushi Reel,23000,4700,27700
21518,21519,21-10-2020 16:16:20.908344,Sánduches,Submarin,34500,3800,38300
21519,21520,21-10-2020 16:16:21.223897,Saludable · Típica,Sopas Mrg,53900,3100,57000
21520,21521,21-10-2020 16:16:21.641702,Postres · Desayunos,Aury Postres - Comidas & Picadas,48750,4700,53450
21521,21522,21-10-2020 16:16:22.007895,Típica,Carbón & Mondongos,8900,6400,15300
21522,21523,21-10-2020 16:16:22.226274,Postres · Desayunos,Maltihelado,34500,4500,39000
21523,21524,21-10-2020 16:16:22.391995,Saludable · Desayunos,Malú,31800,3700,35500
21524,21525,21-10-2020 16:16:22.660708,Parrilla,Arepaisa de Medellín,34500,5600,40100
21525,21526,21-10-2020 16:16:22.826339,Desayunos · Café,Matchacha,7500,5900,13400
21526,21527,21-10-2020 16:16:23.093985,Mexicana,La leyenda mexican kitchen,11870,3200,15070
21527,21528,21-10-2020 16:16:23.409757,Saludable · Desayunos,Fresh Co,8900,5600,14500
21528,21529,21-10-2020 16:16:23.777720,Típica,Juan Chorizo,45800,3900,49700
21529,21530,21-10-2020 16:16:24.093024,Panadería,Boul,24200,3100,27300
21530,21531,21-10-2020 16:16:24.410814,Desayunos · Típica,Parrilla Farandula Típico,11870,5900,17770
21531,21532,21-10-2020 16:16:24.725989,Café · Helados,Sofia heladería y café,24300,5800,30100
21532,21533,21-10-2020 16:16:24.943419,Desayunos · Panadería,Le Pain Quotidien,23000,3900,26900
21533,21534,21-10-2020 16:16:25.158551,Pollo · Sánduches,Pollos Century,48750,3000,51750
21534,21535,21-10-2020 16:16:25.477668,Postres,Toledo Pastelería,17800,6800,24600
21535,21536,21-10-2020 16:16:25.792954,Pollo,Heart & Cooking,9000,5000,14000
21536,21537,21-10-2020 16:16:26.060173,Desayunos · Panadería,El Pan de Phillippe,10700,4600,15300
21537,21538,21-10-2020 16:16:26.226545,Típica · Parrilla,La Ternera Parrilla,35000,5200,40200
21538,21539,21-10-2020 16:16:26.494296,Desayunos · Panadería,Decofruta,34500,4700,39200
21539,21540,21-10-2020 16:16:26.659361,Postres · Desayunos,Amelie Helados,13600,6400,20000
21540,21541,21-10-2020 16:16:27.026810,Alta Cocina · Postres,La Pinta,48750,4500,53250
21541,21542,21-10-2020 16:16:27.192622,Desayunos · Panadería,Premium Break Bakery,23000,3700,26700
21542,21543,21-10-2020 16:16:27.610007,Desayunos · Panadería,Le Pain Quotidien,24300,3900,28200
21543,21544,21-10-2020 16:16:27.775175,Saludable · Típica,Saludable Mrg,13000,5800,18800
21544,21545,21-10-2020 16:16:27.992718,Típica,Juan Chorizo,53400,3900,57300
21545,21546,21-10-2020 16:16:28.308157,Postres · Desayunos,Restaurante Cornelia,8900,5500,14400
21546,21547,21-10-2020 16:16:28.626602,Hamburguesas,Burger Society,13000,4100,17100
21547,21548,21-10-2020 16:16:28.841711,Pollo · Saludable,Gratina,39700,4200,43900
21548,21549,21-10-2020 16:16:29.209798,Mexicana,Cantina La 15,17800,4300,22100
21549,21550,21-10-2020 16:16:29.626646,Asiática,TeT,15000,5900,20900
21550,21551,21-10-2020 16:16:29.844665,Pizza · Parrilla,Urban Lunch,45800,4000,49800
21551,21552,21-10-2020 16:16:30.110844,Pescados y Mariscos,La Gran Cazuela,39700,3200,42900
21552,21553,21-10-2020 16:16:30.379251,Parrilla · Café,Figaro Café/ Restaurante Argentino,35000,5800,40800
21553,21554,21-10-2020 16:16:30.544600,Desayunos · Pescados y Mariscos,Luzí­a - Mediterranea,17800,5700,23500
21554,21555,21-10-2020 16:16:30.912330,Pizza,Pastas Laurentina,23000,4800,27800
21555,21556,21-10-2020 16:16:31.329383,Típica · Pescados y Mariscos,La Vitualla,10700,6300,17000
21556,21557,21-10-2020 16:16:31.747502,Postres,La Tertulia,15000,3400,18400
21557,21558,21-10-2020 16:16:32.163422,Típica,El Cucharón - Tipica,39700,4400,44100
21558,21559,21-10-2020 16:16:32.331661,Sushi · Asiática,Arigato,35000,5300,40300
21559,21560,21-10-2020 16:16:32.597208,Desayunos · Internacional,Camilia,15600,3900,19500
21560,21561,21-10-2020 16:16:33.015298,Saludable · Desayunos,Bon Eat - Saludable,17800,4800,22600
21561,21562,21-10-2020 16:16:33.181034,Italiana,F*cking Good Pizza,10700,4200,14900
21562,21563,21-10-2020 16:16:33.549206,Desayunos,Don Leo,13000,6000,19000
21563,21564,21-10-2020 16:16:33.965861,Desayunos,Butter,27800,6700,34500
21564,21565,21-10-2020 16:16:34.335644,Desayunos · Panadería,Juliana Restaurante,29500,6100,35600
21565,21566,21-10-2020 16:16:34.701561,Hamburguesas · Desayunos,El Inglés Gastro Pub,17800,6600,24400
21566,21567,21-10-2020 16:16:34.919083,Pollo · Típica,Auyama,34500,3900,38400
21567,21568,21-10-2020 16:16:35.185001,Pollo · Sánduches,Pollos Century,45800,3000,48800
21568,21569,21-10-2020 16:16:35.403171,Pizza,pizza andante,31800,4200,36000
21569,21570,21-10-2020 16:16:35.769482,Postres · Café,Loló Coffee & Snacks,65000,4600,69600
21570,21571,21-10-2020 16:16:36.138008,Hamburguesas · Saludable,Restaurant Inn,65000,6100,71100
21571,21572,21-10-2020 16:16:36.504256,Jugos y Batidos,Pomponio,39700,3600,43300
21572,21573,21-10-2020 16:16:36.821531,Peruana · Internacional,La Chifería,70000,6600,76600
21573,21574,21-10-2020 16:16:37.187337,Saludable · Desayunos,Guadalupe - Fruteria,7500,5900,13400
21574,21575,21-10-2020 16:16:37.605298,Alta Cocina · Italiana,Trattoria de la Plaza,12500,6000,18500
21575,21576,21-10-2020 16:16:38.021360,Parrilla,Parrilla Pimentón,27800,3400,31200
21576,21577,21-10-2020 16:16:38.289523,Desayunos · Panadería,Choclofee,17800,4700,22500
21577,21578,21-10-2020 16:16:38.455179,Desayunos,Sunny Breakfast Brunch,15600,4300,19900
21578,21579,21-10-2020 16:16:38.873473,Saludable,A2manos,39700,4200,43900
21579,21580,21-10-2020 16:16:39.189018,Saludable · Desayunos,La Cesta,7500,4700,12200
21580,21581,21-10-2020 16:16:39.457524,Saludable · Desayunos,Bawana - Sandwich,9000,3400,12400
21581,21582,21-10-2020 16:16:39.873974,Postres · Desayunos,Vivalight Market.,24200,6500,30700
21582,21583,21-10-2020 16:16:40.142517,Desayunos · Típica,Papadió - Colombianas,7500,5700,13200
21583,21584,21-10-2020 16:16:40.307765,Saludable · Desayunos,Re.al Alimentos Reales,12500,4000,16500
21584,21585,21-10-2020 16:16:40.575247,Pollo · Pescados y Mariscos,Bang Bang Rice,23000,3400,26400
21585,21586,21-10-2020 16:16:40.840917,Postres · Desayunos,BagBog Bagels,13600,6400,20000
21586,21587,21-10-2020 16:16:41.259151,Desayunos · Panadería,Limarys,35000,6500,41500
21587,21588,21-10-2020 16:16:41.626642,Postres · Desayunos,Café Quindio,37900,5700,43600
21588,21589,21-10-2020 16:16:41.795658,Postres,La Galeta,39700,3000,42700
21589,21590,21-10-2020 16:16:42.011451,Saludable · Desayunos,Bawana - Sandwich,35000,3400,38400
21590,21591,21-10-2020 16:16:42.179124,Desayunos · Panadería,Premium Break Bakery,53900,3700,57600
21591,21592,21-10-2020 16:16:42.394739,Típica · Pescados y Mariscos,Arroces Mrg,12500,4300,16800
21592,21593,21-10-2020 16:16:42.663199,Peruana,Masivo,70000,5800,75800
21593,21594,21-10-2020 16:16:42.878585,Desayunos,Cafetería el Kippe,39700,3200,42900
21594,21595,21-10-2020 16:16:43.196679,Postres · Desayunos,Café Quindio,27800,5700,33500
21595,21596,21-10-2020 16:16:43.612699,Saludable · Desayunos,Malú,18900,3700,22600
21596,21597,21-10-2020 16:16:43.831789,Hamburguesas,Bendito Cordero,31800,5800,37600
21597,21598,21-10-2020 16:16:44.248164,Parrilla,Restaurante Bar Mi Ranchito,12500,5200,17700
21598,21599,21-10-2020 16:16:44.566405,Desayunos · Típica,La Parrilla Dorada Polo,23000,6600,29600
21599,21600,21-10-2020 16:16:44.782694,Parrilla · Internacional,Taperia de la Plaza,34500,5700,40200
21600,21601,21-10-2020 16:16:44.950760,Internacional,Rio Sabores y Experiencias,31800,4100,35900
21601,21602,21-10-2020 16:16:45.316604,Mexicana,Cantina La 15,15600,4300,19900
21602,21603,21-10-2020 16:16:45.485230,Sushi,Umi,13600,5600,19200
21603,21604,21-10-2020 16:16:45.801420,Asiática,TeT,10700,5900,16600
21604,21605,21-10-2020 16:16:46.069081,Desayunos,El Corral - Desayunos,18900,5000,23900
21605,21606,21-10-2020 16:16:46.485210,Desayunos,Fratelli - Desayunos,45800,4600,50400
21606,21607,21-10-2020 16:16:46.853544,Saludable,MIMA,35000,3700,38700
21607,21608,21-10-2020 16:16:47.069234,Mexicana,Cantina La 15,17800,4300,22100
21608,21609,21-10-2020 16:16:47.287783,Desayunos · Típica,D'Porco - Lechona,24200,6300,30500
21609,21610,21-10-2020 16:16:47.553478,Helados,Orso To Go,70000,6800,76800
21610,21611,21-10-2020 16:16:47.721781,Postres · Desayunos,Protein Bakes,12500,5900,18400
21611,21612,21-10-2020 16:16:48.138009,Pizza,18 Scalini,23000,4300,27300
21612,21613,21-10-2020 16:16:48.505766,Asiática,TeT,27800,5900,33700
21613,21614,21-10-2020 16:16:48.721658,Saludable,Puro Verde,13000,5700,18700
21614,21615,21-10-2020 16:16:49.090146,Hamburguesas,Burger Society,53900,4100,58000
21615,21616,21-10-2020 16:16:49.456590,Desayunos · Internacional,Camilia,27800,3900,31700
21616,21617,21-10-2020 16:16:49.624602,Postres · Desayunos,Vivalight Market.,27800,6500,34300
21617,21618,21-10-2020 16:16:50.040600,Típica · Parrilla,El Portal de la Antigua,53400,5600,59000
21618,21619,21-10-2020 16:16:50.409600,Sushi · Asiática,Tu Sushi,18900,6400,25300
21619,21620,21-10-2020 16:16:50.825796,Parrilla,Campocina,13000,4600,17600
21620,21621,21-10-2020 16:16:51.244088,Sánduches,Submarin,24300,3800,28100
21621,21622,21-10-2020 16:16:51.510025,Desayunos · Panadería,Limarys,24300,6500,30800
21622,21623,21-10-2020 16:16:51.828144,Típica · Pescados y Mariscos,La Vitualla,70000,6300,76300
21623,21624,21-10-2020 16:16:52.194516,Típica,Sabores De Mi Tierra,24300,5400,29700
21624,21625,21-10-2020 16:16:52.363103,Pollo · Desayunos,Workzone,12500,3100,15600
21625,21626,21-10-2020 16:16:52.728924,Desayunos · Café,Matchacha,10700,5900,16600
21626,21627,21-10-2020 16:16:52.996475,Hamburguesas,Bendito Cordero,29500,5800,35300
21627,21628,21-10-2020 16:16:53.162611,Pizza · Italiana,Pisapore - Pizza,45800,6600,52400
21628,21629,21-10-2020 16:16:53.530807,Pollo · Típica,Auyama,45800,3900,49700
21629,21630,21-10-2020 16:16:53.946706,Peruana · Internacional,La Chifería,35000,6600,41600
21630,21631,21-10-2020 16:16:54.265553,Desayunos,Bagel Shop,35000,3200,38200
21631,21632,21-10-2020 16:16:54.681620,Típica,Sabores De Mi Tierra,31800,5400,37200
21632,21633,21-10-2020 16:16:54.899499,Postres · Desayunos,Vivalight Market.,37900,6500,44400
21633,21634,21-10-2020 16:16:55.064937,Saludable,Hanai - Bowls Saludables,12500,5900,18400
21634,21635,21-10-2020 16:16:55.232978,Típica,El Mondongo y Mucho Mas,35000,5600,40600
21635,21636,21-10-2020 16:16:55.498910,Postres · Desayunos,La Folie - Postres,70000,3300,73300
21636,21637,21-10-2020 16:16:55.867148,Pizza,pizza andante,70000,4200,74200
21637,21638,21-10-2020 16:16:56.235182,Desayunos,La Frijolada Desayunos,17800,4400,22200
21638,21639,21-10-2020 16:16:56.653820,Postres · Desayunos,Maltihelados,11870,6200,18070
21639,21640,21-10-2020 16:16:56.832371,Desayunos · Jugos y Batidos,Frutiwow,27800,4100,31900
21640,21641,21-10-2020 16:16:57.150388,Crepes,San Crepes,24200,4900,29100
21641,21642,21-10-2020 16:16:57.417308,Desayunos · Café,Norma's Ice Cream Café,8900,6300,15200
21642,21643,21-10-2020 16:16:57.584984,Alta Cocina · Parrilla,Criterión,11870,6000,17870
21643,21644,21-10-2020 16:16:57.800567,Pollo · China,China Tao,45800,3500,49300
21644,21645,21-10-2020 16:16:58.168692,Típica,La Herencia,18900,5900,24800
21645,21646,21-10-2020 16:16:58.435728,Postres · Helados,Mahé,53900,6000,59900
21646,21647,21-10-2020 16:16:58.804104,Desayunos · Café,Norma's Ice Cream Café,24300,6300,30600
21647,21648,21-10-2020 16:16:59.219885,Desayunos · Café,Moramia,11870,4700,16570
21648,21649,21-10-2020 16:16:59.488600,Típica · Parrilla,El Portal de la Antigua,48750,5600,54350
21649,21650,21-10-2020 16:16:59.754641,Postres · Desayunos,Vivalight Market.,15600,6500,22100
21650,21651,21-10-2020 16:17:00.074129,Parrilla,Arroces Maria Paula,8900,6800,15700
21651,21652,21-10-2020 16:17:00.240644,Parrilla,Carnes la Zarza,23000,4900,27900
21652,21653,21-10-2020 16:17:00.409278,Típica · Parrilla,El Portal de la Antigua,24200,5600,29800
21653,21654,21-10-2020 16:17:00.774997,Típica,La Cocina,29500,4600,34100
21654,21655,21-10-2020 16:17:01.143503,Pollo · China,China Tao,9000,3500,12500
21655,21656,21-10-2020 16:17:01.510011,Desayunos · Típica,Fogón Sangileño,23000,5000,28000
21656,21657,21-10-2020 16:17:01.778066,Postres · Desayunos,Maltihelado,8900,4500,13400
21657,21658,21-10-2020 16:17:02.043628,Saludable,Ventura Soup y Salad,24300,3800,28100
21658,21659,21-10-2020 16:17:02.361515,Típica · Parrilla,La Ternera Parrilla,24200,5200,29400
21659,21660,21-10-2020 16:17:02.677256,Desayunos,El Corral - Desayunos,10700,5000,15700
21660,21661,21-10-2020 16:17:02.895045,Postres · Desayunos,Gelateria Da Favola,53900,6500,60400
21661,21662,21-10-2020 16:17:03.210673,Panadería,Boul,7500,3100,10600
21662,21663,21-10-2020 16:17:03.378936,Pollo · Típica,Auyama,31800,3900,35700
21663,21664,21-10-2020 16:17:03.795091,Peruana,Masivo,23000,5800,28800
21664,21665,21-10-2020 16:17:03.962653,Desayunos · Café,El Gualilo,12500,6200,18700
21665,21666,21-10-2020 16:17:04.278329,Desayunos · Panadería,Juliana Restaurante,12500,6100,18600
21666,21667,21-10-2020 16:17:04.596086,Desayunos · Típica,Criollomania,15000,5200,20200
21667,21668,21-10-2020 16:17:04.911806,Pollo · Típica,Auyama,7500,3900,11400
21668,21669,21-10-2020 16:17:05.129458,Desayunos · Típica,Calentao Express,53400,6000,59400
21669,21670,21-10-2020 16:17:05.396200,Saludable · Desayunos,Bawana - Sandwich,15600,3400,19000
21670,21671,21-10-2020 16:17:05.814402,Asiática,Thai Station,53400,6000,59400
21671,21672,21-10-2020 16:17:06.079470,Saludable · Desayunos,La Estampilla,13000,6000,19000
21672,21673,21-10-2020 16:17:06.247768,Desayunos · Parrilla,Mi Patria,53900,4600,58500
21673,21674,21-10-2020 16:17:06.564699,Desayunos · Panadería,Decofruta,35000,4700,39700
21674,21675,21-10-2020 16:17:06.882488,Desayunos · Italiana,Rceta By Rausch,13000,3600,16600
21675,21676,21-10-2020 16:17:07.198229,Pizza,pizza andante,31800,4200,36000
21676,21677,21-10-2020 16:17:07.466609,Desayunos,Fratelli - Desayunos,23000,4600,27600
21677,21678,21-10-2020 16:17:07.632079,Parrilla,Parrilla Pimentón,35000,3400,38400
21678,21679,21-10-2020 16:17:07.850307,Saludable · Desayunos,Bon Eat - Saludable,12500,4800,17300
21679,21680,21-10-2020 16:17:08.066170,Desayunos · Helados,San Giorgio Gelateria,48750,3100,51850
21680,21681,21-10-2020 16:17:08.485056,Saludable · Desayunos,Bawana - Sandwich,39700,3400,43100
21681,21682,21-10-2020 16:17:08.851485,Desayunos · Sánduches,Danilo Colombia,12500,3300,15800
21682,21683,21-10-2020 16:17:09.019699,Típica · Pescados y Mariscos,Arroces Mrg,34500,4300,38800
21683,21684,21-10-2020 16:17:09.235598,Saludable · Desayunos,La Estampilla,24300,6000,30300
21684,21685,21-10-2020 16:17:09.554387,Típica,Bandejas Mrg,35000,3800,38800
21685,21686,21-10-2020 16:17:09.720610,Peruana · Internacional,La Chifería,9000,6600,15600
21686,21687,21-10-2020 16:17:09.938409,Típica,La Olla de Barro,31800,5300,37100
21687,21688,21-10-2020 16:17:10.305117,Saludable · Parrilla,Box,9000,3700,12700
21688,21689,21-10-2020 16:17:10.523320,Postres,La Tertulia,39700,3400,43100
21689,21690,21-10-2020 16:17:10.889987,Saludable · Típica,Sopas Mrg,45800,3100,48900
21690,21691,21-10-2020 16:17:11.107592,Desayunos · Típica,Casa Vieja,23000,6000,29000
21691,21692,21-10-2020 16:17:11.322823,Asiática,TeT,15000,5900,20900
21692,21693,21-10-2020 16:17:11.742927,Mexicana,Mexicanachos,39700,3900,43600
21693,21694,21-10-2020 16:17:12.059110,Postres · Desayunos,BagBog Bagels,24200,6400,30600
21694,21695,21-10-2020 16:17:12.227231,Pollo · Saludable,Tremenda Sal y Dulce,34500,6500,41000
21695,21696,21-10-2020 16:17:12.443266,Postres · Panadería,RIGHT AWAY FOODS,27800,6600,34400
21696,21697,21-10-2020 16:17:12.761984,Sánduches · Pescados y Mariscos,Pacific Comida de Mar,23000,4000,27000
21697,21698,21-10-2020 16:17:13.027498,Desayunos · Café,Norma's Ice Cream Café,53900,6300,60200
21698,21699,21-10-2020 16:17:13.396045,Saludable · Típica,Sopas Mrg,35000,3100,38100
21699,21700,21-10-2020 16:17:13.613094,Crepes,San Crepes,24300,4900,29200
21700,21701,21-10-2020 16:17:13.831255,Hamburguesas,Monchis - Hamburguesa,9000,4300,13300
21701,21702,21-10-2020 16:17:14.247897,Saludable,Puro Verde,70000,5700,75700
21702,21703,21-10-2020 16:17:14.516740,Hamburguesas · Alitas,Beer,35000,6600,41600
21703,21704,21-10-2020 16:17:14.883098,Pizza,18 Scalini,34500,4300,38800
21704,21705,21-10-2020 16:17:15.201232,Desayunos · Mexicana,La Mera Mera - Mexicana,48750,3100,51850
21705,21706,21-10-2020 16:17:15.517458,Desayunos · Típica,90 Calentados,37900,3700,41600
21706,21707,21-10-2020 16:17:15.935688,Internacional,La Esquina con Sabor Parrilla,34500,3000,37500
21707,21708,21-10-2020 16:17:16.202455,Desayunos · Empanadas,Mis Delicias,10700,3200,13900
21708,21709,21-10-2020 16:17:16.370927,Parrilla,Coquitas,23000,5600,28600
21709,21710,21-10-2020 16:17:16.586687,Pizza · Italiana,Piatto - Pizza,34500,6600,41100
21710,21711,21-10-2020 16:17:16.905465,Alta Cocina · Parrilla,Criterión,17800,6000,23800
21711,21712,21-10-2020 16:17:17.071179,Panadería,Boul,45800,3100,48900
21712,21713,21-10-2020 16:17:17.289077,Helados,Buon Gelato,12500,4400,16900
21713,21714,21-10-2020 16:17:17.554712,Pollo,Chicken House,15000,4200,19200
21714,21715,21-10-2020 16:17:17.823304,Saludable,Puro Verde,65000,5700,70700
21715,21716,21-10-2020 16:17:18.139729,Saludable,Puro Verde,35000,5700,40700
21716,21717,21-10-2020 16:17:18.308003,Postres · Desayunos,Jacques Pastelería,35000,5900,40900
21717,21718,21-10-2020 16:17:18.474481,Postres · Desayunos,Protein Bakes,70000,5900,75900
21718,21719,21-10-2020 16:17:18.642705,Hamburguesas · Pescados y Mariscos,El Velero,27800,6500,34300
21719,21720,21-10-2020 16:17:19.058608,Desayunos · Árabe,Boniato Sabores Vivos,18900,5300,24200
21720,21721,21-10-2020 16:17:19.227275,Hamburguesas · Panadería,NYC Burgers,12500,6200,18700
21721,21722,21-10-2020 16:17:19.593831,Desayunos · Italiana,Rceta By Rausch,24300,3600,27900
21722,21723,21-10-2020 16:17:19.962863,Postres · Desayunos,Amelie Helados,15600,6400,22000
21723,21724,21-10-2020 16:17:20.378859,Parrilla,Arepaisa de Medellín,29500,5600,35100
21724,21725,21-10-2020 16:17:20.747628,Desayunos,Bagel Shop,48750,3200,51950
21725,21726,21-10-2020 16:17:21.014374,Pollo,Chicken House,23000,4200,27200
21726,21727,21-10-2020 16:17:21.182317,Parrilla,El Tambor,8900,6800,15700
21727,21728,21-10-2020 16:17:21.398934,Saludable · Desayunos,Guadalupe - Fruteria,39700,5900,45600
21728,21729,21-10-2020 16:17:21.668158,Internacional,La Esquina con Sabor Parrilla,15600,3000,18600
21729,21730,21-10-2020 16:17:21.884080,Pollo · Desayunos,Candelina,24300,5300,29600
21730,21731,21-10-2020 16:17:22.102731,Desayunos · Sánduches,Frutos del Bosque,53400,3500,56900
21731,21732,21-10-2020 16:17:22.368819,Desayunos,Butter,35000,6700,41700
21732,21733,21-10-2020 16:17:22.737573,Desayunos · Café,Norma's Ice Cream Café,53400,6300,59700
21733,21734,21-10-2020 16:17:23.103111,Comida Rápida,Fiesta Digital Andrés,24200,3100,27300
21734,21735,21-10-2020 16:17:23.472730,Saludable · Desayunos,Guadalupe - Fruteria,31800,5900,37700
21735,21736,21-10-2020 16:17:23.839208,Parrilla,El Tambor,65000,6800,71800
21736,21737,21-10-2020 16:17:24.007688,Desayunos · Café,Norma's Ice Cream Café,23000,6300,29300
21737,21738,21-10-2020 16:17:24.424441,Desayunos · Panadería,Juliana Restaurante,45800,6100,51900
21738,21739,21-10-2020 16:17:24.742695,Desayunos · Café,Frambas,7500,3400,10900
21739,21740,21-10-2020 16:17:25.058716,Desayunos,Don Leo,9000,6000,15000
21740,21741,21-10-2020 16:17:25.427647,Pollo · China,China Tao,12500,3500,16000
21741,21742,21-10-2020 16:17:25.643867,Pollo · China,China Tao,24300,3500,27800
21742,21743,21-10-2020 16:17:26.062362,Desayunos · Café,Aromacafé el Placer de Compartir,53900,5000,58900
21743,21744,21-10-2020 16:17:26.228697,Pizza,Pastas Laurentina,13600,4800,18400
21744,21745,21-10-2020 16:17:26.647184,Parrilla,Antojo a Domicilio,11870,5000,16870
21745,21746,21-10-2020 16:17:26.863335,Peruana · Internacional,La Chifería,11870,6600,18470
21746,21747,21-10-2020 16:17:27.182335,Postres · Desayunos,Buñuelos nacho,53900,6600,60500
21747,21748,21-10-2020 16:17:27.348120,Típica,Sabores De Mi Tierra,39700,5400,45100
21748,21749,21-10-2020 16:17:27.766225,Hamburguesas,Bendito Cordero,15600,5800,21400
21749,21750,21-10-2020 16:17:28.183004,Hamburguesas · Pescados y Mariscos,El Velero,12500,6500,19000
21750,21751,21-10-2020 16:17:28.351298,Postres · Desayunos,KOKOA & co.,53900,4700,58600
21751,21752,21-10-2020 16:17:28.567611,Desayunos · Empanadas,Mis Delicias,27800,3200,31000
21752,21753,21-10-2020 16:17:28.735680,Desayunos · Panadería,Decofruta,23000,4700,27700
21753,21754,21-10-2020 16:17:28.900929,Pizza · Parrilla,Urban Lunch,35000,4000,39000
21754,21755,21-10-2020 16:17:29.270503,Desayunos · Panadería,Ficchi Panadería,70000,3100,73100
21755,21756,21-10-2020 16:17:29.438029,Pizza,Pizza Andante,24200,6300,30500
21756,21757,21-10-2020 16:17:29.756650,Desayunos · Panadería,Limarys,53400,6500,59900
21757,21758,21-10-2020 16:17:30.172799,Saludable · Desayunos,Básico y Elemental,9000,5900,14900
21758,21759,21-10-2020 16:17:30.340508,Parrilla,Antojo a Domicilio,13000,5000,18000
21759,21760,21-10-2020 16:17:30.607357,Sánduches,Submarin,23000,3800,26800
21760,21761,21-10-2020 16:17:30.825466,Postres · Desayunos,KOKOA & co.,11870,4700,16570
21761,21762,21-10-2020 16:17:31.241781,Parrilla,Campocina,23000,4600,27600
21762,21763,21-10-2020 16:17:31.510434,Asiática,Thai Station,70000,6000,76000
21763,21764,21-10-2020 16:17:31.926530,Desayunos · Típica,Criollomania,8900,5200,14100
21764,21765,21-10-2020 16:17:32.094483,Pizza,Pizza Andante,12500,6300,18800
21765,21766,21-10-2020 16:17:32.511896,Parrilla,Arroces Maria Paula,53900,6800,60700
21766,21767,21-10-2020 16:17:32.930318,Pescados y Mariscos,Fish Place - Del Mar,15000,5400,20400
21767,21768,21-10-2020 16:17:33.196440,Hamburguesas · Panadería,NYC Burgers,34500,6200,40700
21768,21769,21-10-2020 16:17:33.365357,Postres · Desayunos,La Folie - Postres,23000,3300,26300
21769,21770,21-10-2020 16:17:33.732206,Desayunos · Mexicana,La Mera Mera - Mexicana,35000,3100,38100
21770,21771,21-10-2020 16:17:34.150905,Pescados y Mariscos,Fish Place - Del Mar,13000,5400,18400
21771,21772,21-10-2020 16:17:34.417792,Sushi · Asiática,Tu Sushi,11870,6400,18270
21772,21773,21-10-2020 16:17:34.585944,Saludable · Parrilla,Box,12500,3700,16200
21773,21774,21-10-2020 16:17:34.802255,Desayunos · Panadería,Limarys,53900,6500,60400
21774,21775,21-10-2020 16:17:35.171599,Pizza,pizza andante,7500,4200,11700
21775,21776,21-10-2020 16:17:35.389333,Hamburguesas · Desayunos,El Inglés Gastro Pub,13000,6600,19600
21776,21777,21-10-2020 16:17:35.608483,Parrilla,Arroces Maria Paula,9000,6800,15800
21777,21778,21-10-2020 16:17:35.775831,Hamburguesas · Pescados y Mariscos,El Velero,10700,6500,17200
21778,21779,21-10-2020 16:17:36.145264,Típica,Lo Nuestro,35000,3100,38100
21779,21780,21-10-2020 16:17:36.412013,Hamburguesas,Bendito Cordero,7500,5800,13300
21780,21781,21-10-2020 16:17:36.829807,Pollo · Pescados y Mariscos,Bang Bang Rice,24200,3400,27600
21781,21782,21-10-2020 16:17:37.146210,Italiana,F*cking Good Pizza,34500,4200,38700
21782,21783,21-10-2020 16:17:37.364389,Postres · Desayunos,Vivalight Market.,15000,6500,21500
21783,21784,21-10-2020 16:17:37.681669,Asiática,TeT,27800,5900,33700
21784,21785,21-10-2020 16:17:38.100119,Típica,Sabrosito,11870,4000,15870
21785,21786,21-10-2020 16:17:38.316025,Saludable · Desayunos,Malú,7500,3700,11200
21786,21787,21-10-2020 16:17:38.735140,Sánduches · Pescados y Mariscos,Pacific Comida de Mar,17800,4000,21800
21787,21788,21-10-2020 16:17:39.151788,Postres · Desayunos,Protein Bakes,37900,5900,43800
21788,21789,21-10-2020 16:17:39.420617,Parrilla,Parrilla Pimentón,18900,3400,22300
21789,21790,21-10-2020 16:17:39.587248,Desayunos · Típica,Alce,35000,4900,39900
21790,21791,21-10-2020 16:17:39.805962,Saludable,Amor Propio saludable,23000,4000,27000
21791,21792,21-10-2020 16:17:40.172117,Pizza · Parrilla,Urban Lunch,31800,4000,35800
21792,21793,21-10-2020 16:17:40.590550,Postres · Desayunos,Aury Postres - Comidas & Picadas,8900,4700,13600
21793,21794,21-10-2020 16:17:40.756918,Saludable · Desayunos,Malú,13600,3700,17300
21794,21795,21-10-2020 16:17:41.125365,Desayunos · Empanadas,Empanadas Doraditas.com,31800,3000,34800
21795,21796,21-10-2020 16:17:41.542184,Desayunos · Mexicana,La Mera Mera - Mexicana,34500,3100,37600
21796,21797,21-10-2020 16:17:41.711137,Pollo · Pescados y Mariscos,Bang Bang Rice,18900,3400,22300
21797,21798,21-10-2020 16:17:42.027333,Pollo,Señor Fantástico,9000,4700,13700
21798,21799,21-10-2020 16:17:42.246435,Mexicana,La leyenda mexican kitchen,8900,3200,12100
21799,21800,21-10-2020 16:17:42.663142,Peruana,Uma Cantina Peruana,23000,3200,26200
21800,21801,21-10-2020 16:17:42.932499,Saludable · Desayunos,Agua Dulce,37900,3700,41600
21801,21802,21-10-2020 16:17:43.299360,Mexicana,La leyenda mexican kitchen,29500,3200,32700
21802,21803,21-10-2020 16:17:43.568522,Saludable,Puro Verde,15600,5700,21300
21803,21804,21-10-2020 16:17:43.734491,Pizza · Parrilla,Urban Lunch,37900,4000,41900
21804,21805,21-10-2020 16:17:43.952668,Desayunos,Don Leo,15600,6000,21600
21805,21806,21-10-2020 16:17:44.218692,Típica,Salsig,18900,5600,24500
21806,21807,21-10-2020 16:17:44.587502,Pescados y Mariscos,Fish Place - Del Mar,31800,5400,37200
21807,21808,21-10-2020 16:17:44.903634,Parrilla,Beraca Parrilla Bbq,8900,5600,14500
21808,21809,21-10-2020 16:17:45.222737,Parrilla,Antojo a Domicilio,39700,5000,44700
21809,21810,21-10-2020 16:17:45.489805,Saludable · Típica,Saludable Mrg,23000,5800,28800
21810,21811,21-10-2020 16:17:45.808766,Crepes,La Chabatta,39700,5900,45600
21811,21812,21-10-2020 16:17:45.975564,Típica,Carbón & Mondongos,12500,6400,18900
21812,21813,21-10-2020 16:17:46.344167,Postres · Desayunos,Restaurante Cornelia,17800,5500,23300
21813,21814,21-10-2020 16:17:46.511962,Jugos y Batidos,Pomponio,27800,3600,31400
21814,21815,21-10-2020 16:17:46.830333,Saludable · Desayunos,Fresh Co,9000,5600,14600
21815,21816,21-10-2020 16:17:46.996188,Sushi,Umi,35000,5600,40600
21816,21817,21-10-2020 16:17:47.365216,Típica,Lo Nuestro,8900,3100,12000
21817,21818,21-10-2020 16:17:47.581788,Comida Rápida · Perros Calientes,Similoa - Comida Rapida,17800,3700,21500
21818,21819,21-10-2020 16:17:48.002182,Peruana,Masivo,35000,5800,40800
21819,21820,21-10-2020 16:17:48.369392,Saludable · Desayunos,Bon Eat - Saludable,15600,4800,20400
21820,21821,21-10-2020 16:17:48.788019,Pollo,Señor Fantástico,31800,4700,36500
21821,21822,21-10-2020 16:17:49.003890,Crepes,La Chabatta,39700,5900,45600
21822,21823,21-10-2020 16:17:49.172339,Desayunos,Butter,7500,6700,14200
21823,21824,21-10-2020 16:17:49.388539,Postres · Desayunos,Maltihelado,15600,4500,20100
21824,21825,21-10-2020 16:17:49.707660,Pollo · China,China Tao,17800,3500,21300
21825,21826,21-10-2020 16:17:50.074346,Postres · Desayunos,Sweet Tale,7500,5800,13300
21826,21827,21-10-2020 16:17:50.443213,Postres · Desayunos,Sweet Tale,12500,5800,18300
21827,21828,21-10-2020 16:17:50.809639,Postres · Saludable,Ana Rebana,17800,6300,24100
21828,21829,21-10-2020 16:17:51.028039,Desayunos · Parrilla,Mi Patria,7500,4600,12100
21829,21830,21-10-2020 16:17:51.395094,Desayunos · Mexicana,La Mera Mera - Mexicana,17800,3100,20900
21830,21831,21-10-2020 16:17:51.764151,Saludable · Jugos y Batidos,Berdes Drinks & Salads,9000,3500,12500
21831,21832,21-10-2020 16:17:52.132216,Típica · Parrilla,Toya,23000,4200,27200
21832,21833,21-10-2020 16:17:52.401244,Sushi,Umi,8900,5600,14500
21833,21834,21-10-2020 16:17:52.717728,Desayunos · Típica,Casa Vieja,15000,6000,21000
21834,21835,21-10-2020 16:17:52.885807,Parrilla,Antojo a Domicilio,13600,5000,18600
21835,21836,21-10-2020 16:17:53.302918,Típica · Parrilla,El Portal de la Antigua,24300,5600,29900
21836,21837,21-10-2020 16:17:53.521673,Pollo · Saludable,Tremenda Sal y Dulce,31800,6500,38300
21837,21838,21-10-2020 16:17:53.738056,Desayunos · Pescados y Mariscos,Gypsy Bistro,13600,4500,18100
21838,21839,21-10-2020 16:17:54.006295,Desayunos,Bagel Shop,48750,3200,51950
21839,21840,21-10-2020 16:17:54.172532,Hamburguesas · Panadería,NYC Burgers,9000,6200,15200
21840,21841,21-10-2020 16:17:54.591322,Postres · Desayunos,KOKOA & co.,45800,4700,50500
21841,21842,21-10-2020 16:17:54.807211,Café · Helados,Sofia heladería y café,18900,5800,24700
21842,21843,21-10-2020 16:17:54.975127,Típica,Carbón & Mondongos,65000,6400,71400
21843,21844,21-10-2020 16:17:55.141275,Internacional,La Esquina con Sabor Parrilla,39700,3000,42700
21844,21845,21-10-2020 16:17:55.409713,Desayunos · Café,Libertario Coffee Roasters,23000,4600,27600
21845,21846,21-10-2020 16:17:55.775626,Italiana,F*cking Good Pizza,7500,4200,11700
21846,21847,21-10-2020 16:17:55.943627,Saludable · Desayunos,Bawana - Sandwich,23000,3400,26400
21847,21848,21-10-2020 16:17:56.260340,Saludable · Típica,Saludable Mrg,15600,5800,21400
21848,21849,21-10-2020 16:17:56.478907,Típica,La Cocina,48750,4600,53350
21849,21850,21-10-2020 16:17:56.845146,Desayunos · Típica,Criollomania,15600,5200,20800
21850,21851,21-10-2020 16:17:57.014509,Desayunos,El Fogón Castellano,35000,3200,38200
21851,21852,21-10-2020 16:17:57.381360,Típica,Sopitas y Más,23000,4200,27200
21852,21853,21-10-2020 16:17:57.650351,Postres · Desayunos,Vivalight Market.,17800,6500,24300
21853,21854,21-10-2020 16:17:57.866366,Hamburguesas,Monchis - Hamburguesa,31800,4300,36100
21854,21855,21-10-2020 16:17:58.285149,Postres · Desayunos,Protein Bakes,70000,5900,75900
21855,21856,21-10-2020 16:17:58.652712,Postres · Desayunos,Gelateria Da Favola,15000,6500,21500
21856,21857,21-10-2020 16:17:58.922876,Saludable · Típica,Saludable Mrg,35000,5800,40800
21857,21858,21-10-2020 16:17:59.289487,Desayunos · Típica,La Frijolada,24300,4500,28800
21858,21859,21-10-2020 16:17:59.708166,Parrilla · Café,Figaro Café/ Restaurante Argentino,10700,5800,16500
21859,21860,21-10-2020 16:17:59.974321,Desayunos · Jugos y Batidos,Kuriwaji,10700,6300,17000
21860,21861,21-10-2020 16:18:00.143240,Típica,Carbón & Mondongos,65000,6400,71400
21861,21862,21-10-2020 16:18:00.410502,Típica,Campo Victoria,24300,3000,27300
21862,21863,21-10-2020 16:18:00.679681,Saludable · Desayunos,La Cesta,27800,4700,32500
21863,21864,21-10-2020 16:18:00.895848,Desayunos · Jugos y Batidos,Dont Be Hungry,23000,5600,28600
21864,21865,21-10-2020 16:18:01.214040,Desayunos,Sr Buñuelo,35000,6400,41400
21865,21866,21-10-2020 16:18:01.480875,Hamburguesas,Monchis - Hamburguesa,23000,4300,27300
21866,21867,21-10-2020 16:18:01.899731,Internacional,Rio Sabores y Experiencias,70000,4100,74100
21867,21868,21-10-2020 16:18:02.266900,Saludable · Desayunos,Raices Bienestar Gourmet,70000,6600,76600
21868,21869,21-10-2020 16:18:02.536140,Postres · Café,Loló Coffee & Snacks,13000,4600,17600
21869,21870,21-10-2020 16:18:02.752765,Saludable · Desayunos,Bon Eat - Saludable,15000,4800,19800
21870,21871,21-10-2020 16:18:02.920932,Típica · Parrilla,Toya,24200,4200,28400
21871,21872,21-10-2020 16:18:03.337749,Típica · Parrilla,El Portal de la Antigua,24300,5600,29900
21872,21873,21-10-2020 16:18:03.758039,Mexicana,Mexicanachos,23000,3900,26900
21873,21874,21-10-2020 16:18:03.974787,Sushi · Desayunos,Maki Roll,11870,4300,16170
21874,21875,21-10-2020 16:18:04.343492,Postres · Desayunos,Sharmus,23000,6100,29100
21875,21876,21-10-2020 16:18:04.760213,Desayunos · Panadería,Siena Café,24200,3700,27900
21876,21877,21-10-2020 16:18:04.979181,Saludable · Desayunos,Libre de Culpa,27800,4000,31800
21877,21878,21-10-2020 16:18:05.145637,Desayunos · Pescados y Mariscos,Luzí­a - Mediterranea,24200,5700,29900
21878,21879,21-10-2020 16:18:05.314590,Pizza,18 Scalini,37900,4300,42200
21879,21880,21-10-2020 16:18:05.580734,Típica,Bandejas Mrg,35000,3800,38800
21880,21881,21-10-2020 16:18:05.799457,Helados,Orso To Go,13600,6800,20400
21881,21882,21-10-2020 16:18:06.115840,Desayunos · Parrilla,Mi Patria,23000,4600,27600
21882,21883,21-10-2020 16:18:06.384678,Desayunos,Jacinta Arepas de Huevo,45800,4000,49800
21883,21884,21-10-2020 16:18:06.700933,Pollo · China,China Tao,39700,3500,43200
21884,21885,21-10-2020 16:18:07.070178,Sánduches · Pescados y Mariscos,Pacific Comida de Mar,34500,4000,38500
21885,21886,21-10-2020 16:18:07.487548,Postres · Desayunos,Protein Bakes,35000,5900,40900
21886,21887,21-10-2020 16:18:07.857000,Típica,La Herencia,8900,5900,14800
21887,21888,21-10-2020 16:18:08.224489,Desayunos,Fratelli - Desayunos,34500,4600,39100
21888,21889,21-10-2020 16:18:08.644052,Pollo · Desayunos,Candelina,12500,5300,17800
21889,21890,21-10-2020 16:18:08.962290,Típica,El Cucharón - Tipica,13000,4400,17400
21890,21891,21-10-2020 16:18:09.381151,Saludable · Jugos y Batidos,Berdes Drinks & Salads,48750,3500,52250
21891,21892,21-10-2020 16:18:09.748575,Desayunos · Típica,Fogón Sangileño,24200,5000,29200
21892,21893,21-10-2020 16:18:10.067273,Postres · Desayunos,Restaurante Cornelia,8900,5500,14400
21893,21894,21-10-2020 16:18:10.384056,Saludable · Jugos y Batidos,Berdes Drinks & Salads,39700,3500,43200
21894,21895,21-10-2020 16:18:10.753378,Desayunos · Típica,D´Porco,18900,3900,22800
21895,21896,21-10-2020 16:18:11.120605,Desayunos,Fratelli - Desayunos,23000,4600,27600
21896,21897,21-10-2020 16:18:11.490355,Mexicana,Cantina La 15,39700,4300,44000
21897,21898,21-10-2020 16:18:11.706727,Desayunos · Panadería,El Pan de Phillippe,45800,4600,50400
21898,21899,21-10-2020 16:18:12.026188,Parrilla,Restaurante Bar Mi Ranchito,24200,5200,29400
21899,21900,21-10-2020 16:18:12.193242,Café · Helados,Sofia heladería y café,15000,5800,20800
21900,21901,21-10-2020 16:18:12.462583,Desayunos · Jugos y Batidos,Frutiwow,9000,4100,13100
21901,21902,21-10-2020 16:18:12.779561,Pizza,18 Scalini,27800,4300,32100
21902,21903,21-10-2020 16:18:13.048403,Parrilla,Arroces Maria Paula,24300,6800,31100
21903,21904,21-10-2020 16:18:13.264341,Pollo,Oliva Va,9000,5600,14600
21904,21905,21-10-2020 16:18:13.433519,Desayunos · Café,Libertario Coffee Roasters,11870,4600,16470
21905,21906,21-10-2020 16:18:13.799757,Postres · Desayunos,Protein Bakes,29500,5900,35400
21906,21907,21-10-2020 16:18:13.968707,Desayunos,Fratelli - Desayunos,37900,4600,42500
21907,21908,21-10-2020 16:18:14.385494,Mexicana,La leyenda mexican kitchen,7500,3200,10700
21908,21909,21-10-2020 16:18:14.604011,Desayunos · Empanadas,Mis Delicias,35000,3200,38200
21909,21910,21-10-2020 16:18:14.820214,Desayunos · Típica,Rojo Gourmet,53400,4700,58100
21910,21911,21-10-2020 16:18:15.188990,Postres · Desayunos,Restaurante Cornelia,7500,5500,13000
21911,21912,21-10-2020 16:18:15.455577,Postres · Desayunos,BagBog Bagels,53900,6400,60300
21912,21913,21-10-2020 16:18:15.774254,Parrilla,El Tambor,53400,6800,60200
21913,21914,21-10-2020 16:18:16.190917,Postres · Saludable,Ana Rebana,45800,6300,52100
21914,21915,21-10-2020 16:18:16.409886,Hamburguesas · Alitas,Beer,70000,6600,76600
21915,21916,21-10-2020 16:18:16.776721,Comida Rápida,Fiesta Digital Andrés,53900,3100,57000
21916,21917,21-10-2020 16:18:16.996141,Típica · Pescados y Mariscos,La Vitualla,65000,6300,71300
21917,21918,21-10-2020 16:18:17.313231,Pollo · Desayunos,Abasto,53900,3600,57500
21918,21919,21-10-2020 16:18:17.732983,Desayunos · Café,Moramia,13600,4700,18300
21919,21920,21-10-2020 16:18:17.999893,Sánduches,Submarin,15600,3800,19400
21920,21921,21-10-2020 16:18:18.169397,Desayunos · Panadería,Santa Juana Food Bar,10700,5900,16600
21921,21922,21-10-2020 16:18:18.486241,Típica · Parrilla,Mi Ranchito Parrilla,9000,4400,13400
21922,21923,21-10-2020 16:18:18.854720,Parrilla,Restaurante Bar Mi Ranchito,8900,5200,14100
21923,21924,21-10-2020 16:18:19.271819,Típica,Sabores De Mi Tierra,24200,5400,29600
21924,21925,21-10-2020 16:18:19.540798,Desayunos · Típica,Desayunadero de la 42,70000,5900,75900
21925,21926,21-10-2020 16:18:19.857674,Pollo · Saludable,Tremenda Sal y Dulce,23000,6500,29500
21926,21927,21-10-2020 16:18:20.026552,Alta Cocina · Parrilla,Criterión,53900,6000,59900
21927,21928,21-10-2020 16:18:20.343070,Saludable · Parrilla,Box,7500,3700,11200
21928,21929,21-10-2020 16:18:20.612832,Típica,Sabrosito,29500,4000,33500
21929,21930,21-10-2020 16:18:20.981596,Postres · Desayunos,Amelie Helados,10700,6400,17100
21930,21931,21-10-2020 16:18:21.401811,Típica · Parrilla,La Ternera Parrilla,13000,5200,18200
21931,21932,21-10-2020 16:18:21.719602,Peruana,Uma Cantina Peruana,70000,3200,73200
21932,21933,21-10-2020 16:18:22.090020,Parrilla · Internacional,Taperia de la Plaza,8900,5700,14600
21933,21934,21-10-2020 16:18:22.508379,Sushi,Sushi Reel,31800,4700,36500
21934,21935,21-10-2020 16:18:22.678609,Parrilla · Café,Gaira Café,24300,4400,28700
21935,21936,21-10-2020 16:18:22.845390,Desayunos · Panadería,Decofruta,37900,4700,42600
21936,21937,21-10-2020 16:18:23.214572,Pizza,18 Scalini,29500,4300,33800
21937,21938,21-10-2020 16:18:23.532330,Parrilla · Internacional,Taperia de la Plaza,45800,5700,51500
21938,21939,21-10-2020 16:18:23.901889,Típica,La Olla de Barro,48750,5300,54050
21939,21940,21-10-2020 16:18:24.069673,Pollo,Oliva Va,27800,5600,33400
21940,21941,21-10-2020 16:18:24.240958,Desayunos · Italiana,Rceta By Rausch,15000,3600,18600
21941,21942,21-10-2020 16:18:24.410132,Desayunos · Típica,Peninsula Calentados y Parrilla,15600,3400,19000
21942,21943,21-10-2020 16:18:24.730168,Desayunos · Sánduches,Danilo Colombia,53900,3300,57200
21943,21944,21-10-2020 16:18:25.048072,Desayunos · Panadería,El Pan de Phillippe,27800,4600,32400
21944,21945,21-10-2020 16:18:25.367882,Típica,Sabrosito,15600,4000,19600
21945,21946,21-10-2020 16:18:25.585373,Típica,La Herencia,18900,5900,24800
21946,21947,21-10-2020 16:18:25.755502,Postres · Desayunos,Sweet Tale,8900,5800,14700
21947,21948,21-10-2020 16:18:26.022865,Sushi,Sushi Reel,18900,4700,23600
21948,21949,21-10-2020 16:18:26.442105,Panadería,Boul,23000,3100,26100
21949,21950,21-10-2020 16:18:26.759365,Parrilla,Arepaisa de Medellín,12500,5600,18100
21950,21951,21-10-2020 16:18:27.078225,Típica,Cabrito Santandereano,53400,6600,60000
21951,21952,21-10-2020 16:18:27.344895,Saludable · Desayunos,Básico y Elemental,9000,5900,14900
21952,21953,21-10-2020 16:18:27.664200,Helados,Buon Gelato,34500,4400,38900
21953,21954,21-10-2020 16:18:27.980360,Hamburguesas · Desayunos,El Inglés Gastro Pub,34500,6600,41100
21954,21955,21-10-2020 16:18:28.199343,Alta Cocina · Parrilla,Criterión,29500,6000,35500
21955,21956,21-10-2020 16:18:28.365768,Parrilla,OAK Ahumado y Brebajes,45800,6000,51800
21956,21957,21-10-2020 16:18:28.784643,Parrilla · Internacional,Taperia de la Plaza,31800,5700,37500
21957,21958,21-10-2020 16:18:29.151671,Típica,Baondish,65000,5800,70800
21958,21959,21-10-2020 16:18:29.421742,Postres,Levelma,35000,6200,41200
21959,21960,21-10-2020 16:18:29.738577,Saludable · Desayunos,Raices Bienestar Gourmet,13600,6600,20200
21960,21961,21-10-2020 16:18:29.906790,Desayunos,Sunny Breakfast Brunch,45800,4300,50100
21961,21962,21-10-2020 16:18:30.224013,Pollo · Desayunos,Candelina,9000,5300,14300
21962,21963,21-10-2020 16:18:30.542467,Saludable,Ventura Soup y Salad,34500,3800,38300
21963,21964,21-10-2020 16:18:30.959507,Desayunos · Árabe,Boniato Sabores Vivos,34500,5300,39800
21964,21965,21-10-2020 16:18:31.228110,Desayunos,Fratelli - Desayunos,23000,4600,27600
21965,21966,21-10-2020 16:18:31.544844,Típica · Parrilla,El Portal de la Antigua,10700,5600,16300
21966,21967,21-10-2020 16:18:31.964022,Típica · Parrilla,Typykos,8900,6000,14900
21967,21968,21-10-2020 16:18:32.180417,Desayunos · Típica,Cochon,31800,3300,35100
21968,21969,21-10-2020 16:18:32.349260,Típica · Parrilla,Mi Ranchito Parrilla,18900,4400,23300
21969,21970,21-10-2020 16:18:32.565675,Desayunos · Panadería,Artesanos,65000,4300,69300
21970,21971,21-10-2020 16:18:32.784129,Típica · Parrilla,El Portal de la Antigua,15600,5600,21200
21971,21972,21-10-2020 16:18:33.000444,Alta Cocina · Postres,La Pinta,23000,4500,27500
21972,21973,21-10-2020 16:18:33.269776,Pollo · Saludable,Gratina,23000,4200,27200
21973,21974,21-10-2020 16:18:33.437789,Desayunos · Panadería,Siena Café,7500,3700,11200
21974,21975,21-10-2020 16:18:33.657511,Saludable,MIMA,34500,3700,38200
21975,21976,21-10-2020 16:18:33.923844,Parrilla,OAK Ahumado y Brebajes,34500,6000,40500
21976,21977,21-10-2020 16:18:34.192653,Sánduches · Pescados y Mariscos,Pacific Comida de Mar,17800,4000,21800
21977,21978,21-10-2020 16:18:34.610860,Hamburguesas,Gofi Burger,13000,5100,18100
21978,21979,21-10-2020 16:18:34.930850,Pizza,18 Scalini,9000,4300,13300
21979,21980,21-10-2020 16:18:35.198551,Hamburguesas,Bendito Cordero,15000,5800,20800
21980,21981,21-10-2020 16:18:35.617567,Asiática,TeT,18900,5900,24800
21981,21982,21-10-2020 16:18:35.934234,Desayunos · Típica,D´Porco,29500,3900,33400
21982,21983,21-10-2020 16:18:36.253738,Comida Rápida · Perros Calientes,Similoa - Comida Rapida,65000,3700,68700
21983,21984,21-10-2020 16:18:36.571019,Típica,El Mondongo y Mucho Mas,17800,5600,23400
21984,21985,21-10-2020 16:18:36.890000,Pollo · Saludable,Gratina,15600,4200,19800
21985,21986,21-10-2020 16:18:37.055918,Pollo,Oliva Va,18900,5600,24500
21986,21987,21-10-2020 16:18:37.275618,Desayunos · Café,Aromacafé el Placer de Compartir,34500,5000,39500
21987,21988,21-10-2020 16:18:37.492765,Hamburguesas,Gofi Burger,70000,5100,75100
21988,21989,21-10-2020 16:18:37.661728,Pollo · Pescados y Mariscos,Bang Bang Rice,11870,3400,15270
21989,21990,21-10-2020 16:18:37.928178,Alta Cocina · Italiana,Trattoria de la Plaza,18900,6000,24900
21990,21991,21-10-2020 16:18:38.197587,Típica · Parrilla,Typykos,24300,6000,30300
21991,21992,21-10-2020 16:18:38.464905,Desayunos · Típica,90 Calentados,34500,3700,38200
21992,21993,21-10-2020 16:18:38.784822,Postres · Desayunos,Maltihelado,24200,4500,28700
21993,21994,21-10-2020 16:18:39.151750,Desayunos · Típica,La Parrilla Dorada Polo,10700,6600,17300
21994,21995,21-10-2020 16:18:39.471243,Postres · Panadería,RIGHT AWAY FOODS,17800,6600,24400
21995,21996,21-10-2020 16:18:39.789267,Saludable · Típica,Saludable Mrg,39700,5800,45500
21996,21997,21-10-2020 16:18:40.158341,Postres · Desayunos,Gelateria Da Favola,23000,6500,29500
21997,21998,21-10-2020 16:18:40.525488,Desayunos · Jugos y Batidos,Kuriwaji,27800,6300,34100
21998,21999,21-10-2020 16:18:40.844354,Comida Rápida,Fiesta Digital Andrés,45800,3100,48900
21999,22000,21-10-2020 16:18:41.211548,Desayunos,El Corral - Desayunos,13000,5000,18000
22000,22001,21-10-2020 16:18:41.631945,Parrilla,Campocina,27800,4600,32400
22001,22002,21-10-2020 16:18:42.049341,Internacional,Rio Sabores y Experiencias,15000,4100,19100
22002,22003,21-10-2020 16:18:42.368536,Postres · Desayunos,Maria Luisa - Postres,70000,4300,74300
22003,22004,21-10-2020 16:18:42.785477,Desayunos · Panadería,Santa Juana Food Bar,23000,5900,28900
22004,22005,21-10-2020 16:18:43.104708,Desayunos · Comida Rápida,La Veneca,70000,6300,76300
22005,22006,21-10-2020 16:18:43.271409,Típica · Parrilla,El Portal de la Antigua,53400,5600,59000
22006,22007,21-10-2020 16:18:43.640786,Típica · Parrilla,La Ternera Parrilla,48750,5200,53950
22007,22008,21-10-2020 16:18:43.857173,Hamburguesas · Saludable,Restaurant Inn,11870,6100,17970
22008,22009,21-10-2020 16:18:44.276842,Desayunos · Panadería,El Pan de Phillippe,8900,4600,13500
22009,22010,21-10-2020 16:18:44.693485,Desayunos · Comida Rápida,Chocolatto,34500,3400,37900
22010,22011,21-10-2020 16:18:44.962789,Típica,Cabrito Santandereano,15000,6600,21600
22011,22012,21-10-2020 16:18:45.329314,Crepes,La Chabatta,53900,5900,59800
22012,22013,21-10-2020 16:18:45.748223,Desayunos,Desayunos en Bogotá,31800,3400,35200
22013,22014,21-10-2020 16:18:46.165892,Desayunos · Café,Matchacha,34500,5900,40400
22014,22015,21-10-2020 16:18:46.585243,Saludable · Jugos y Batidos,Berdes Drinks & Salads,31800,3500,35300
22015,22016,21-10-2020 16:18:46.952035,Desayunos · Panadería,El Pan de Phillippe,17800,4600,22400
22016,22017,21-10-2020 16:18:47.120885,Internacional,La Esquina con Sabor Parrilla,53900,3000,56900
22017,22018,21-10-2020 16:18:47.388003,Peruana · Internacional,La Chifería,9000,6600,15600
22018,22019,21-10-2020 16:18:47.556695,Desayunos · Café,Norma's Ice Cream Café,7500,6300,13800
22019,22020,21-10-2020 16:18:47.974435,Parrilla,Rústico Picadería,23000,3800,26800
22020,22021,21-10-2020 16:18:48.293501,Postres · Saludable,Ana Rebana,23000,6300,29300
22021,22022,21-10-2020 16:18:48.710960,Desayunos · Panadería,Premium Break Bakery,7500,3700,11200
22022,22023,21-10-2020 16:18:49.029762,Típica · Parrilla,El Santandereano,35000,5200,40200
22023,22024,21-10-2020 16:18:49.396925,Postres · Desayunos,KOKOA & co.,31800,4700,36500
22024,22025,21-10-2020 16:18:49.565855,Desayunos · Pescados y Mariscos,Luzí­a - Mediterranea,35000,5700,40700
22025,22026,21-10-2020 16:18:49.932403,Típica,Carbón & Mondongos,7500,6400,13900
22026,22027,21-10-2020 16:18:50.251764,Postres · Desayunos,Jacques Pastelería,27800,5900,33700
22027,22028,21-10-2020 16:18:50.418908,Desayunos · Típica,Casa Vieja,48750,6000,54750
22028,22029,21-10-2020 16:18:50.788571,Saludable · Desayunos,Libre de Culpa,10700,4000,14700
22029,22030,21-10-2020 16:18:51.054611,Pollo · Desayunos,Candelina,29500,5300,34800
22030,22031,21-10-2020 16:18:51.324110,Parrilla,Beraca Parrilla Bbq,23000,5600,28600
22031,22032,21-10-2020 16:18:51.540412,Postres · Desayunos,Sharmus,35000,6100,41100
22032,22033,21-10-2020 16:18:51.809307,Desayunos · Panadería,Ficchi Panadería,8900,3100,12000
22033,22034,21-10-2020 16:18:52.026370,Desayunos · Café,Norma's Ice Cream Café,29500,6300,35800
22034,22035,21-10-2020 16:18:52.395592,Sushi,Canoa To Go,48750,5900,54650
22035,22036,21-10-2020 16:18:52.763619,Típica · Pescados y Mariscos,Arroces Mrg,15000,4300,19300
22036,22037,21-10-2020 16:18:52.932903,Asiática,Thai Station,37900,6000,43900
22037,22038,21-10-2020 16:18:53.199959,Sánduches,Submarin,8900,3800,12700
22038,22039,21-10-2020 16:18:53.569833,Postres · Desayunos,BagBog Bagels,24300,6400,30700
22039,22040,21-10-2020 16:18:53.936936,Desayunos · Típica,Papadió - Colombianas,11870,5700,17570
22040,22041,21-10-2020 16:18:54.256398,Sánduches · China,Peru Mix,70000,5900,75900
22041,22042,21-10-2020 16:18:54.624397,Mexicana,Hidalgo Taquería,13600,4900,18500
22042,22043,21-10-2020 16:18:54.793671,Mexicana,Cantina La 15,23000,4300,27300
22043,22044,21-10-2020 16:18:55.110692,Parrilla · Café,Gaira Café,18900,4400,23300
22044,22045,21-10-2020 16:18:55.531959,Saludable · Desayunos,Básico y elemental,15600,5000,20600
22045,22046,21-10-2020 16:18:55.700024,Típica · Parrilla,El Portal de la Antigua,15000,5600,20600
22046,22047,21-10-2020 16:18:56.069639,Típica,Lo Nuestro,70000,3100,73100
22047,22048,21-10-2020 16:18:56.487087,Sánduches,Submarin,23000,3800,26800
22048,22049,21-10-2020 16:18:56.855774,Parrilla · Café,Figaro Café/ Restaurante Argentino,24200,5800,30000
22049,22050,21-10-2020 16:18:57.022816,Saludable,The Good Rice Bowls,23000,3500,26500
22050,22051,21-10-2020 16:18:57.443350,Saludable,A2manos,7500,4200,11700
22051,22052,21-10-2020 16:18:57.860599,Típica,Bendita S,23000,4600,27600
22052,22053,21-10-2020 16:18:58.230561,Desayunos · Italiana,Rceta By Rausch,8900,3600,12500
22053,22054,21-10-2020 16:18:58.448782,Desayunos · Helados,San Giorgio Gelateria,17800,3100,20900
22054,22055,21-10-2020 16:18:58.768160,Postres,Beiked,13000,4000,17000
22055,22056,21-10-2020 16:18:59.035013,Pescados y Mariscos,La Gran Cazuela,35000,3200,38200
22056,22057,21-10-2020 16:18:59.305999,Típica,Carbón & Mondongos,18900,6400,25300
22057,22058,21-10-2020 16:18:59.574247,Postres,Toledo Pastelería,24200,6800,31000
22058,22059,21-10-2020 16:18:59.942969,Parrilla · Café,Gaira Café,34500,4400,38900
22059,22060,21-10-2020 16:19:00.310142,Mexicana,La leyenda mexican kitchen,53400,3200,56600
22060,22061,21-10-2020 16:19:00.680595,Pollo · Desayunos,Candelina,13600,5300,18900
22061,22062,21-10-2020 16:19:00.847595,Típica,La Olla de Barro,13600,5300,18900
22062,22063,21-10-2020 16:19:01.216659,Pollo · Saludable,Tremenda Sal y Dulce,65000,6500,71500
22063,22064,21-10-2020 16:19:01.434056,Pollo · Desayunos,Abasto,70000,3600,73600
22064,22065,21-10-2020 16:19:01.853402,Desayunos · Típica,Parrilla Farandula Típico,7500,5900,13400
22065,22066,21-10-2020 16:19:02.069837,Sushi,Canoa To Go,13000,5900,18900
22066,22067,21-10-2020 16:19:02.239819,Postres · Desayunos,Buñuelos nacho,31800,6600,38400
22067,22068,21-10-2020 16:19:02.459019,Desayunos · Típica,Criollomania,23000,5200,28200
22068,22069,21-10-2020 16:19:02.878614,Postres · Desayunos,Maltihelados,27800,6200,34000
22069,22070,21-10-2020 16:19:03.195511,Saludable · Desayunos,Bawana - Sandwich,37900,3400,41300
22070,22071,21-10-2020 16:19:03.415273,Típica · Parrilla,La Ternera Parrilla,13600,5200,18800
22071,22072,21-10-2020 16:19:03.832700,Alta Cocina · Parrilla,Criterión,23000,6000,29000
22072,22073,21-10-2020 16:19:04.001660,Desayunos · Típica,Fogón Sangileño,15000,5000,20000
22073,22074,21-10-2020 16:19:04.419447,Típica,Juan Chorizo,27800,3900,31700
22074,22075,21-10-2020 16:19:04.788898,Típica,Salsig,8900,5600,14500
22075,22076,21-10-2020 16:19:05.055531,Desayunos · Café,El Gualilo,17800,6200,24000
22076,22077,21-10-2020 16:19:05.374763,Saludable · Desayunos,Agua Dulce,23000,3700,26700
22077,22078,21-10-2020 16:19:05.742790,Postres · Saludable,Ana Rebana,45800,6300,52100
22078,22079,21-10-2020 16:19:06.111619,Postres · Desayunos,Buñuelos nacho,65000,6600,71600
22079,22080,21-10-2020 16:19:06.528598,Postres · Desayunos,Vivalight Market.,37900,6500,44400
22080,22081,21-10-2020 16:19:06.748365,Sánduches · Pescados y Mariscos,Pacific Comida de Mar,27800,4000,31800
22081,22082,21-10-2020 16:19:07.115418,Parrilla,El Tambor,53900,6800,60700
22082,22083,21-10-2020 16:19:07.485186,Desayunos,El Fogón Castellano,31800,3200,35000
22083,22084,21-10-2020 16:19:07.701967,Jugos y Batidos,Pomponio,17800,3600,21400
22084,22085,21-10-2020 16:19:07.920876,Pescados y Mariscos,La Gran Cazuela,53900,3200,57100
22085,22086,21-10-2020 16:19:08.087997,Pollo · Desayunos,Workzone,12500,3100,15600
22086,22087,21-10-2020 16:19:08.307816,Desayunos · Típica,La Frijolada,48750,4500,53250
22087,22088,21-10-2020 16:19:08.475794,Desayunos · Panadería,Decofruta,48750,4700,53450
22088,22089,21-10-2020 16:19:08.645689,Sushi · Asiática,Arigato,24300,5300,29600
22089,22090,21-10-2020 16:19:08.912962,Desayunos · Panadería,Limarys,65000,6500,71500
22090,22091,21-10-2020 16:19:09.282486,Peruana,Uma Cantina Peruana,27800,3200,31000
22091,22092,21-10-2020 16:19:09.499668,Postres · Desayunos,BagBog Bagels,65000,6400,71400
22092,22093,21-10-2020 16:19:09.768912,Desayunos · Café,Aromacafé el Placer de Compartir,13600,5000,18600
22093,22094,21-10-2020 16:19:10.036035,Hamburguesas,Gofi Burger,34500,5100,39600
22094,22095,21-10-2020 16:19:10.205260,Saludable,Puro Verde,29500,5700,35200
22095,22096,21-10-2020 16:19:10.572482,Saludable,Amor Propio saludable,24300,4000,28300
22096,22097,21-10-2020 16:19:10.892838,Mexicana,Cantina La 15,35000,4300,39300
22097,22098,21-10-2020 16:19:11.160225,Hamburguesas,Bendito Cordero,23000,5800,28800
22098,22099,21-10-2020 16:19:11.529690,Desayunos · Panadería,Le Pain Quotidien,45800,3900,49700
22099,22100,21-10-2020 16:19:11.747193,Postres · Desayunos,Vivalight Market.,13000,6500,19500
22100,22101,21-10-2020 16:19:11.966894,Crepes,La Chabatta,11870,5900,17770
22101,22102,21-10-2020 16:19:12.334504,Típica,Sabores De Mi Tierra,13600,5400,19000
22102,22103,21-10-2020 16:19:12.604584,Mexicana,Mexicanachos,17800,3900,21700
22103,22104,21-10-2020 16:19:12.972454,Típica,Sopitas y Más,24300,4200,28500
22104,22105,21-10-2020 16:19:13.341868,Típica · Parrilla,El Portal de la Antigua,35000,5600,40600
22105,22106,21-10-2020 16:19:13.659974,Saludable · Desayunos,La Estampilla,24300,6000,30300
22106,22107,21-10-2020 16:19:14.079476,Desayunos,Don Leo,8900,6000,14900
22107,22108,21-10-2020 16:19:14.448007,Pollo,Señor Fantástico,12500,4700,17200
22108,22109,21-10-2020 16:19:14.718123,Típica,Cazuelitas 93,45800,3900,49700
22109,22110,21-10-2020 16:19:14.896681,Desayunos,Fratelli - Desayunos,12500,4600,17100
22110,22111,21-10-2020 16:19:15.216265,Típica · Parrilla,La Ternera Parrilla,7500,5200,12700
22111,22112,21-10-2020 16:19:15.633786,Postres · Desayunos,Maltihelados,7500,6200,13700
22112,22113,21-10-2020 16:19:16.054768,Parrilla · Café,Gaira Café,11870,4400,16270
22113,22114,21-10-2020 16:19:16.323107,Postres · Desayunos,Jacques Pastelería,8900,5900,14800
22114,22115,21-10-2020 16:19:16.492281,Desayunos · Panadería,Choclofee,12500,4700,17200
22115,22116,21-10-2020 16:19:16.859288,Postres · Desayunos,BagBog Bagels,35000,6400,41400
22116,22117,21-10-2020 16:19:17.078650,Sánduches · Pescados y Mariscos,Pacific Comida de Mar,35000,4000,39000
22117,22118,21-10-2020 16:19:17.296179,Peruana,Uma Cantina Peruana,39700,3200,42900
22118,22119,21-10-2020 16:19:17.665814,Desayunos · Empanadas,Empanadas Doraditas.com,9000,3000,12000
22119,22120,21-10-2020 16:19:18.033957,Pizza · Parrilla,Urban Lunch,70000,4000,74000
22120,22121,21-10-2020 16:19:18.403691,Sánduches · China,Peru Mix,13000,5900,18900
22121,22122,21-10-2020 16:19:18.771701,Desayunos · Panadería,El Pan de Phillippe,35000,4600,39600
22122,22123,21-10-2020 16:19:18.992034,Jugos y Batidos,Pomponio,10700,3600,14300
22123,22124,21-10-2020 16:19:19.159256,Sushi,Umi,27800,5600,33400
22124,22125,21-10-2020 16:19:19.328825,Típica · Parrilla,El Santandereano,12500,5200,17700
22125,22126,21-10-2020 16:19:19.746165,Desayunos · Comida Rápida,Chocolatto,48750,3400,52150
22126,22127,21-10-2020 16:19:20.115331,Parrilla,El Tambor,35000,6800,41800
22127,22128,21-10-2020 16:19:20.383080,Típica · Parrilla,El Santandereano,13000,5200,18200
22128,22129,21-10-2020 16:19:20.603372,Pizza · Italiana,Piatto - Pizza,23000,6600,29600
22129,22130,21-10-2020 16:19:20.920677,Desayunos · Típica,Casa Vieja,24300,6000,30300
22130,22131,21-10-2020 16:19:21.191169,Saludable · Parrilla,Box,27800,3700,31500
22131,22132,21-10-2020 16:19:21.558286,Desayunos · Mexicana,La Mera Mera - Mexicana,29500,3100,32600
22132,22133,21-10-2020 16:19:21.778063,Mexicana,Cantina La 15,13000,4300,17300
22133,22134,21-10-2020 16:19:22.045662,Desayunos · Italiana,Rceta By Rausch,70000,3600,73600
22134,22135,21-10-2020 16:19:22.465644,Helados,Buon Gelato,65000,4400,69400
22135,22136,21-10-2020 16:19:22.633732,Desayunos,Jacinta Arepas de Huevo,24300,4000,28300
22136,22137,21-10-2020 16:19:22.853442,Desayunos · Típica,D'Porco - Lechona,24300,6300,30600
22137,22138,21-10-2020 16:19:23.120984,Desayunos,Fratelli - Desayunos,24200,4600,28800
22138,22139,21-10-2020 16:19:23.390927,Saludable · Desayunos,Guadalupe - Fruteria,23000,5900,28900
22139,22140,21-10-2020 16:19:23.658635,Desayunos · Panadería,Artesanos,39700,4300,44000
22140,22141,21-10-2020 16:19:23.828114,Típica,Baondish,13000,5800,18800
22141,22142,21-10-2020 16:19:23.996346,Postres · Desayunos,BagBog Bagels,10700,6400,17100
22142,22143,21-10-2020 16:19:24.215908,Pollo · Saludable,Gratina,12500,4200,16700
22143,22144,21-10-2020 16:19:24.582832,Pizza,pizza andante,9000,4200,13200
22144,22145,21-10-2020 16:19:24.802401,Saludable,Ventura Soup y Salad,53400,3800,57200
22145,22146,21-10-2020 16:19:25.219778,Comida Rápida · Perros Calientes,Similoa - Comida Rapida,23000,3700,26700
22146,22147,21-10-2020 16:19:25.490229,Típica,Sopitas y Más,37900,4200,42100
22147,22148,21-10-2020 16:19:25.907716,Desayunos · Panadería,Le Pain Quotidien,17800,3900,21700
22148,22149,21-10-2020 16:19:26.177036,Típica · Parrilla,La Parilla de David,15600,3100,18700
22149,22150,21-10-2020 16:19:26.495479,Pollo · Desayunos,Abasto,65000,3600,68600
22150,22151,21-10-2020 16:19:26.815413,Postres · Desayunos,KOKOA & co.,23000,4700,27700
22151,22152,21-10-2020 16:19:27.133663,Desayunos · Café,Aromacafé el Placer de Compartir,48750,5000,53750
22152,22153,21-10-2020 16:19:27.454210,Postres · Desayunos,Amelie Helados,10700,6400,17100
22153,22154,21-10-2020 16:19:27.621267,Pizza · Italiana,Pisapore - Pizza,7500,6600,14100
22154,22155,21-10-2020 16:19:28.041631,Típica,Bandejas Mrg,17800,3800,21600
22155,22156,21-10-2020 16:19:28.359589,Saludable · Desayunos,Bon Eat - Saludable,24200,4800,29000
22156,22157,21-10-2020 16:19:28.579262,Desayunos · Empanadas,Empanadas Doraditas.com,35000,3000,38000
22157,22158,21-10-2020 16:19:28.896542,Postres · Desayunos,KOKOA & co.,35000,4700,39700
22158,22159,21-10-2020 16:19:29.115964,Típica · Parrilla,El Portal de la Antigua,23000,5600,28600
22159,22160,21-10-2020 16:19:29.333302,Hamburguesas,Gofi Burger,70000,5100,75100
22160,22161,21-10-2020 16:19:29.703239,Parrilla · Café,Gaira Café,11870,4400,16270
22161,22162,21-10-2020 16:19:29.970497,Desayunos · Comida Rápida,Chocolatto,8900,3400,12300
22162,22163,21-10-2020 16:19:30.240774,Pollo · Típica,Auyama,53400,3900,57300
22163,22164,21-10-2020 16:19:30.608281,Parrilla,Parrilla Pimentón,53400,3400,56800
22164,22165,21-10-2020 16:19:30.877568,Desayunos,Señor Desayuno,34500,6800,41300
22165,22166,21-10-2020 16:19:31.295304,Saludable · Desayunos,Raices Bienestar Gourmet,15600,6600,22200
22166,22167,21-10-2020 16:19:31.716067,Alta Cocina · Parrilla,Criterión,9000,6000,15000
22167,22168,21-10-2020 16:19:31.982875,Saludable · Desayunos,La Cesta,12500,4700,17200
22168,22169,21-10-2020 16:19:32.152815,Típica,Sabores De Mi Tierra,24200,5400,29600
22169,22170,21-10-2020 16:19:32.319931,Desayunos · Parrilla,Mi Patria,8900,4600,13500
22170,22171,21-10-2020 16:19:32.689769,Desayunos · Panadería,Choclofee,23000,4700,27700
22171,22172,21-10-2020 16:19:33.107084,Comida Rápida,Fiesta Digital Andrés,9000,3100,12100
22172,22173,21-10-2020 16:19:33.426772,Típica · Parrilla,El Portal de la Antigua,65000,5600,70600
22173,22174,21-10-2020 16:19:33.696140,Saludable,Amor Propio saludable,53400,4000,57400
22174,22175,21-10-2020 16:19:33.965935,Desayunos · Café,Aromacafé el Placer de Compartir,53400,5000,58400
22175,22176,21-10-2020 16:19:34.333068,Desayunos · Panadería,El Pan de Phillippe,31800,4600,36400
22176,22177,21-10-2020 16:19:34.752740,Saludable · Desayunos,Fresh Co,9000,5600,14600
22177,22178,21-10-2020 16:19:34.919852,Saludable · Desayunos,La Estampilla,29500,6000,35500
22178,22179,21-10-2020 16:19:35.339746,Jugos y Batidos,Pomponio,53900,3600,57500
22179,22180,21-10-2020 16:19:35.657584,Saludable · Desayunos,Re.al Alimentos Reales,70000,4000,74000
22180,22181,21-10-2020 16:19:35.877772,Hamburguesas,Bendito Cordero,34500,5800,40300
22181,22182,21-10-2020 16:19:36.197157,Hamburguesas · Panadería,NYC Burgers,24300,6200,30500
22182,22183,21-10-2020 16:19:36.518148,Pollo,Heart & Cooking,53400,5000,58400
22183,22184,21-10-2020 16:19:36.937882,Desayunos,Señor Desayuno,34500,6800,41300
22184,22185,21-10-2020 16:19:37.107203,Parrilla · Internacional,Taperia de la Plaza,29500,5700,35200
22185,22186,21-10-2020 16:19:37.425511,Hamburguesas,Monchis - Hamburguesa,23000,4300,27300
22186,22187,21-10-2020 16:19:37.695106,Pollo · Desayunos,Caserito Gourmet,35000,6700,41700
22187,22188,21-10-2020 16:19:37.962465,Desayunos · Café,Aromacafé el Placer de Compartir,10700,5000,15700
22188,22189,21-10-2020 16:19:38.382316,Parrilla,Rústico Picadería,15000,3800,18800
22189,22190,21-10-2020 16:19:38.699332,Postres,Toledo Pastelería,17800,6800,24600
22190,22191,21-10-2020 16:19:38.968982,Postres,Beiked,48750,4000,52750
22191,22192,21-10-2020 16:19:39.386643,Hamburguesas · Pescados y Mariscos,El Velero,17800,6500,24300
22192,22193,21-10-2020 16:19:39.656808,Desayunos · Parrilla,Mi Patria,17800,4600,22400
22193,22194,21-10-2020 16:19:39.973934,Pollo · Desayunos,Workzone,34500,3100,37600
22194,22195,21-10-2020 16:19:40.194013,Postres,La Tertulia,45800,3400,49200
22195,22196,21-10-2020 16:19:40.411863,Sánduches,Submarin,70000,3800,73800
22196,22197,21-10-2020 16:19:40.832072,Pizza · Italiana,Piatto - Pizza,45800,6600,52400
22197,22198,21-10-2020 16:19:41.199813,Desayunos · Internacional,Camilia,27800,3900,31700
22198,22199,21-10-2020 16:19:41.369304,Sushi · Asiática,Arigato,29500,5300,34800
22199,22200,21-10-2020 16:19:41.787408,Parrilla,Antojo a Domicilio,24300,5000,29300
22200,22201,21-10-2020 16:19:42.157787,Desayunos,Cafetería el Kippe,35000,3200,38200
22201,22202,21-10-2020 16:19:42.525941,Pollo · Desayunos,Candelina,53400,5300,58700
22202,22203,21-10-2020 16:19:42.946128,Hamburguesas,Burger Society,23000,4100,27100
22203,22204,21-10-2020 16:19:43.364149,Pollo · Desayunos,Workzone,39700,3100,42800
22204,22205,21-10-2020 16:19:43.533750,Parrilla,Rústico Picadería,15600,3800,19400
22205,22206,21-10-2020 16:19:43.951177,Parrilla,Campocina,15600,4600,20200
22206,22207,21-10-2020 16:19:44.321638,Saludable · Desayunos,Básico y Elemental,48750,5900,54650
22207,22208,21-10-2020 16:19:44.639273,Desayunos · Mexicana,La Mera Mera - Mexicana,23000,3100,26100
22208,22209,21-10-2020 16:19:44.959469,Desayunos · Sánduches,Danilo Colombia,53400,3300,56700
22209,22210,21-10-2020 16:19:45.177062,Pizza,Pizza Andante,12500,6300,18800
22210,22211,21-10-2020 16:19:45.346579,Saludable,A2manos,8900,4200,13100
22211,22212,21-10-2020 16:19:45.563807,Parrilla · Internacional,Taperia de la Plaza,65000,5700,70700
22212,22213,21-10-2020 16:19:45.733771,Saludable · Desayunos,La Estampilla,34500,6000,40500
22213,22214,21-10-2020 16:19:46.151718,Desayunos · Típica,Casa Vieja,35000,6000,41000
22214,22215,21-10-2020 16:19:46.421716,Postres · Desayunos,Protein Bakes,27800,5900,33700
22215,22216,21-10-2020 16:19:46.789223,Desayunos · Café,El Gualilo,53400,6200,59600
22216,22217,21-10-2020 16:19:47.108610,Saludable · Desayunos,Re.al Alimentos Reales,65000,4000,69000
22217,22218,21-10-2020 16:19:47.326791,Comida Rápida · Perros Calientes,Similoa - Comida Rapida,24300,3700,28000
22218,22219,21-10-2020 16:19:47.496597,Desayunos,Jacinta Arepas de Huevo,53900,4000,57900
22219,22220,21-10-2020 16:19:47.813814,Saludable · Típica,Saludable Mrg,15000,5800,20800
22220,22221,21-10-2020 16:19:48.082667,Desayunos,Desayunos en Bogotá,13000,3400,16400
22221,22222,21-10-2020 16:19:48.400468,Desayunos · Panadería,Artesanos,27800,4300,32100
22222,22223,21-10-2020 16:19:48.719761,Desayunos · Café,Frambas,70000,3400,73400
22223,22224,21-10-2020 16:19:49.137408,Desayunos · Típica,Desayunadero de la 42,8900,5900,14800
22224,22225,21-10-2020 16:19:49.507486,Desayunos · Panadería,Artesanos,29500,4300,33800
22225,22226,21-10-2020 16:19:49.725442,Desayunos · Típica,Casa Vieja,18900,6000,24900
22226,22227,21-10-2020 16:19:50.044922,Desayunos · Típica,D'Porco - Lechona,70000,6300,76300
22227,22228,21-10-2020 16:19:50.414102,Jugos y Batidos,Pomponio,13600,3600,17200
22228,22229,21-10-2020 16:19:50.783906,Típica,Carbón & Mondongos,45800,6400,52200
22229,22230,21-10-2020 16:19:51.201833,Postres · Desayunos,Jacques Pastelería,18900,5900,24800
22230,22231,21-10-2020 16:19:51.622271,Alta Cocina · Italiana,Trattoria de la Plaza,23000,6000,29000
22231,22232,21-10-2020 16:19:51.789475,Pollo · Desayunos,Workzone,45800,3100,48900
22232,22233,21-10-2020 16:19:52.009175,Pollo,Chicken House,23000,4200,27200
22233,22234,21-10-2020 16:19:52.377307,Desayunos,Desayunos en Bogotá,27800,3400,31200
22234,22235,21-10-2020 16:19:52.547788,Postres · Desayunos,KOKOA & co.,24200,4700,28900
22235,22236,21-10-2020 16:19:52.814889,Desayunos · Típica,90 Calentados,39700,3700,43400
22236,22237,21-10-2020 16:19:52.984850,Postres,Toledo Pastelería,37900,6800,44700
22237,22238,21-10-2020 16:19:53.251747,Café · Helados,Sofia heladería y café,48750,5800,54550
22238,22239,21-10-2020 16:19:53.472741,Típica,Juan Chorizo,13600,3900,17500
22239,22240,21-10-2020 16:19:53.740293,Típica,Juan Chorizo,15000,3900,18900
22240,22241,21-10-2020 16:19:54.060495,Saludable · Típica,Saludable Mrg,34500,5800,40300
22241,22242,21-10-2020 16:19:54.227934,Pollo,Chicken House,31800,4200,36000
22242,22243,21-10-2020 16:19:54.649450,Pollo,Chicken House,27800,4200,32000
22243,22244,21-10-2020 16:19:54.816920,Típica · Pescados y Mariscos,La Vitualla,53900,6300,60200
22244,22245,21-10-2020 16:19:55.186464,Típica · Parrilla,Mi Ranchito Parrilla,27800,4400,32200
22245,22246,21-10-2020 16:19:55.353687,Desayunos · Típica,Peninsula Calentados y Parrilla,39700,3400,43100
22246,22247,21-10-2020 16:19:55.673063,Hamburguesas · Desayunos,El Inglés Gastro Pub,13000,6600,19600
22247,22248,21-10-2020 16:19:55.889951,Postres · Desayunos,Vivalight Market.,8900,6500,15400
22248,22249,21-10-2020 16:19:56.209905,Desayunos,Bagel Shop,7500,3200,10700
22249,22250,21-10-2020 16:19:56.377558,China,China Food Col,23000,3600,26600
22250,22251,21-10-2020 16:19:56.798326,Desayunos,Don Leo,48750,6000,54750
22251,22252,21-10-2020 16:19:57.116164,Hamburguesas · Alitas,Beer,53400,6600,60000
22252,22253,21-10-2020 16:19:57.337199,Desayunos · Panadería,Juliana Restaurante,9000,6100,15100
22253,22254,21-10-2020 16:19:57.656138,Parrilla,Campocina,53400,4600,58000
22254,22255,21-10-2020 16:19:57.875691,Postres · Café,Loló Coffee & Snacks,10700,4600,15300
22255,22256,21-10-2020 16:19:58.143670,Pollo · Saludable,Tremenda Sal y Dulce,65000,6500,71500
22256,22257,21-10-2020 16:19:58.513803,Perros Calientes,Dog Shop - Rapida,53900,4900,58800
22257,22258,21-10-2020 16:19:58.680823,Parrilla,Rústico Picadería,23000,3800,26800
22258,22259,21-10-2020 16:19:59.000428,Parrilla · Internacional,Taperia de la Plaza,24300,5700,30000
22259,22260,21-10-2020 16:19:59.217472,Pescados y Mariscos,Pescadero Héroes del Mar,45800,6600,52400
22260,22261,21-10-2020 16:19:59.487750,Desayunos · Café,Aromacafé el Placer de Compartir,7500,5000,12500
22261,22262,21-10-2020 16:19:59.905236,Desayunos · Panadería,Limarys,24200,6500,30700
22262,22263,21-10-2020 16:20:00.274734,Desayunos · Típica,La Frijolada,39700,4500,44200
22263,22264,21-10-2020 16:20:00.493109,Típica,Bandejas Mrg,53400,3800,57200
22264,22265,21-10-2020 16:20:00.812556,Desayunos · Mexicana,La Mera Mera - Mexicana,24300,3100,27400
22265,22266,21-10-2020 16:20:00.979316,Alta Cocina · Postres,La Pinta,7500,4500,12000
22266,22267,21-10-2020 16:20:01.149831,Desayunos · Panadería,Pasteleite,35000,5900,40900
22267,22268,21-10-2020 16:20:01.417796,Típica · Parrilla,La Parilla de David,35000,3100,38100
22268,22269,21-10-2020 16:20:01.688174,Típica · Parrilla,La Ternera Parrilla,37900,5200,43100
22269,22270,21-10-2020 16:20:02.006786,Saludable,Amor Propio saludable,7500,4000,11500
22270,22271,21-10-2020 16:20:02.377452,Desayunos · Comida Rápida,Chocolatto,35000,3400,38400
22271,22272,21-10-2020 16:20:02.747372,Desayunos · Panadería,Ficchi Panadería,65000,3100,68100
22272,22273,21-10-2020 16:20:03.018113,Hamburguesas · Desayunos,El Inglés Gastro Pub,15000,6600,21600
22273,22274,21-10-2020 16:20:03.286841,Pollo · Desayunos,Abasto,10700,3600,14300
22274,22275,21-10-2020 16:20:03.558055,Saludable · Desayunos,Libre de Culpa,34500,4000,38500
22275,22276,21-10-2020 16:20:03.876690,Desayunos · Típica,Calentao Express,10700,6000,16700
22276,22277,21-10-2020 16:20:04.046818,Hamburguesas,Gofi Burger,13000,5100,18100
22277,22278,21-10-2020 16:20:04.315114,Hamburguesas,Bendito Cordero,53400,5800,59200
22278,22279,21-10-2020 16:20:04.635767,Pizza · Italiana,Pisapore - Pizza,70000,6600,76600
22279,22280,21-10-2020 16:20:04.853445,Desayunos · Café,El Gualilo,35000,6200,41200
22280,22281,21-10-2020 16:20:05.174373,Postres · Desayunos,Gelateria Da Favola,39700,6500,46200
22281,22282,21-10-2020 16:20:05.542258,Helados,Orso To Go,17800,6800,24600
22282,22283,21-10-2020 16:20:05.912215,Desayunos · Sánduches,Danilo Colombia,11870,3300,15170
22283,22284,21-10-2020 16:20:06.230256,Desayunos · Panadería,Siena Café,37900,3700,41600
22284,22285,21-10-2020 16:20:06.600609,Típica,Salsig,34500,5600,40100
22285,22286,21-10-2020 16:20:06.818571,Sánduches · Pescados y Mariscos,Pacific Comida de Mar,37900,4000,41900
22286,22287,21-10-2020 16:20:07.139406,Pizza · Parrilla,Urban Lunch,29500,4000,33500
22287,22288,21-10-2020 16:20:07.507644,Pollo · Desayunos,Piaf,27800,6500,34300
22288,22289,21-10-2020 16:20:07.779241,China,China Food Col,23000,3600,26600
22289,22290,21-10-2020 16:20:08.046807,Alta Cocina · Parrilla,Criterión,17800,6000,23800
22290,22291,21-10-2020 16:20:08.468011,Postres · Desayunos,Vivalight Market.,18900,6500,25400
22291,22292,21-10-2020 16:20:08.685848,Postres · Desayunos,Buñuelos nacho,70000,6600,76600
22292,22293,21-10-2020 16:20:09.006356,Desayunos,Señor Desayuno,29500,6800,36300
22293,22294,21-10-2020 16:20:09.174702,Típica · Parrilla,La Ternera Parrilla,13600,5200,18800
22294,22295,21-10-2020 16:20:09.345061,Desayunos · Típica,D'Porco - Lechona,53900,6300,60200
22295,22296,21-10-2020 16:20:09.763283,Postres · Desayunos,BagBog Bagels,24200,6400,30600
22296,22297,21-10-2020 16:20:09.983808,Desayunos · Café,Norma's Ice Cream Café,15000,6300,21300
22297,22298,21-10-2020 16:20:10.252741,Helados,Orso To Go,48750,6800,55550
22298,22299,21-10-2020 16:20:10.572762,Panadería,Boul,13000,3100,16100
22299,22300,21-10-2020 16:20:10.841053,Postres · Desayunos,Sweet Tale,7500,5800,13300
22300,22301,21-10-2020 16:20:11.111426,Pizza · Italiana,Piatto - Pizza,23000,6600,29600
22301,22302,21-10-2020 16:20:11.279800,Postres · Desayunos,Aury Postres - Comidas & Picadas,27800,4700,32500
22302,22303,21-10-2020 16:20:11.650988,Postres,Beiked,31800,4000,35800
22303,22304,21-10-2020 16:20:12.019363,Desayunos · Café,vereda central calle 99,10700,5700,16400
22304,22305,21-10-2020 16:20:12.190546,Saludable · Desayunos,Básico y Elemental,37900,5900,43800
22305,22306,21-10-2020 16:20:12.358190,Mexicana,Mexicanachos,45800,3900,49700
22306,22307,21-10-2020 16:20:12.577939,Saludable · Desayunos,Maracuyá,13000,6700,19700
22307,22308,21-10-2020 16:20:12.896344,Desayunos · Jugos y Batidos,Dont Be Hungry,13000,5600,18600
22308,22309,21-10-2020 16:20:13.166263,Desayunos · Comida Rápida,Chocolatto,35000,3400,38400
22309,22310,21-10-2020 16:20:13.485024,Desayunos · Jugos y Batidos,Frutiwow,12500,4100,16600
22310,22311,21-10-2020 16:20:13.704960,Pizza,Pastas Laurentina,23000,4800,27800
22311,22312,21-10-2020 16:20:13.972287,Desayunos,La Frijolada Desayunos,65000,4400,69400
22312,22313,21-10-2020 16:20:14.392514,Helados,Buon Gelato,15000,4400,19400
22313,22314,21-10-2020 16:20:14.610583,Pizza,Pastas Laurentina,39700,4800,44500
22314,22315,21-10-2020 16:20:14.980594,Desayunos · Panadería,Santa Juana Food Bar,53400,5900,59300
22315,22316,21-10-2020 16:20:15.298508,Saludable · Desayunos,Copacabana Açai Bowls,7500,3000,10500
22316,22317,21-10-2020 16:20:15.718387,Típica,Sabores De Mi Tierra,35000,5400,40400
22317,22318,21-10-2020 16:20:16.086355,Desayunos · Típica,Casa Vieja,13000,6000,19000
22318,22319,21-10-2020 16:20:16.506372,Desayunos · Panadería,Ficchi Panadería,35000,3100,38100
22319,22320,21-10-2020 16:20:16.873918,Pescados y Mariscos,Pescadero Héroes del Mar,10700,6600,17300
22320,22321,21-10-2020 16:20:17.194002,Comida Rápida · Perros Calientes,Similoa - Comida Rapida,37900,3700,41600
22321,22322,21-10-2020 16:20:17.611446,Desayunos,Bagel Shop,17800,3200,21000
22322,22323,21-10-2020 16:20:17.881376,Pollo · China,China Tao,15000,3500,18500
22323,22324,21-10-2020 16:20:18.248913,Sushi,Sushi Reel,13000,4700,17700
22324,22325,21-10-2020 16:20:18.618899,Desayunos · Café,Libertario Coffee Roasters,29500,4600,34100
22325,22326,21-10-2020 16:20:18.986441,Sushi,Sushi Reel,9000,4700,13700
22326,22327,21-10-2020 16:20:19.256744,Saludable · Desayunos,Copacabana Açai Bowls,23000,3000,26000
22327,22328,21-10-2020 16:20:19.474962,Parrilla,OAK Ahumado y Brebajes,29500,6000,35500
22328,22329,21-10-2020 16:20:19.844764,Desayunos · Típica,Criollomania,70000,5200,75200
22329,22330,21-10-2020 16:20:20.012242,Saludable,MIMA,31800,3700,35500
22330,22331,21-10-2020 16:20:20.232528,Comida Rápida · Perros Calientes,Similoa - Comida Rapida,29500,3700,33200
22331,22332,21-10-2020 16:20:20.650591,Desayunos · Típica,Parrilla Farandula Típico,29500,5900,35400
22332,22333,21-10-2020 16:20:20.870294,Desayunos · Jugos y Batidos,Frutiwow,29500,4100,33600
22333,22334,21-10-2020 16:20:21.288466,Parrilla · Café,Gaira Café,8900,4400,13300
22334,22335,21-10-2020 16:20:21.507953,Parrilla,Arepaisa de Medellín,11870,5600,17470
22335,22336,21-10-2020 16:20:21.875508,Pollo,Señor Fantástico,13600,4700,18300
22336,22337,21-10-2020 16:20:22.095498,Desayunos · Típica,Fogón Sangileño,53900,5000,58900
22337,22338,21-10-2020 16:20:22.263526,Desayunos · Sánduches,Frutos del Bosque,12500,3500,16000
22338,22339,21-10-2020 16:20:22.583579,Típica,Baondish,24300,5800,30100
22339,22340,21-10-2020 16:20:22.850828,Típica,Baondish,11870,5800,17670
22340,22341,21-10-2020 16:20:23.271825,Sushi,Sushi Reel,13000,4700,17700
22341,22342,21-10-2020 16:20:23.540076,Pescados y Mariscos,Fish Place - Del Mar,11870,5400,17270
22342,22343,21-10-2020 16:20:23.810106,Saludable · Parrilla,Box,18900,3700,22600
22343,22344,21-10-2020 16:20:24.077729,Saludable · Desayunos,Copacabana Açai Bowls,12500,3000,15500
22344,22345,21-10-2020 16:20:24.398254,Peruana,Uma Cantina Peruana,18900,3200,22100
22345,22346,21-10-2020 16:20:24.766766,Desayunos · Típica,Calentao Express,24200,6000,30200
22346,22347,21-10-2020 16:20:24.936093,Saludable · Desayunos,Básico y Elemental,45800,5900,51700
22347,22348,21-10-2020 16:20:25.103920,Saludable · Desayunos,Distrito Gourmet,12500,3700,16200
22348,22349,21-10-2020 16:20:25.275156,Saludable · Desayunos,Básico y Elemental,27800,5900,33700
22349,22350,21-10-2020 16:20:25.643829,Desayunos · Sánduches,Garnish,13600,5200,18800
22350,22351,21-10-2020 16:20:25.913917,Hamburguesas,Monchis - Hamburguesa,7500,4300,11800
22351,22352,21-10-2020 16:20:26.283282,Comida Rápida · Perros Calientes,Similoa - Comida Rapida,15600,3700,19300
22352,22353,21-10-2020 16:20:26.654247,Postres · Desayunos,Jacques Pastelería,35000,5900,40900
22353,22354,21-10-2020 16:20:26.871751,Típica · Pescados y Mariscos,La Vitualla,12500,6300,18800
22354,22355,21-10-2020 16:20:27.241777,Hamburguesas · Panadería,NYC Burgers,15600,6200,21800
22355,22356,21-10-2020 16:20:27.659474,Desayunos · Mexicana,La Mera Mera - Mexicana,45800,3100,48900
22356,22357,21-10-2020 16:20:28.079318,Mexicana,Mexicanachos,39700,3900,43600
22357,22358,21-10-2020 16:20:28.449547,Postres · Desayunos,Protein Bakes,18900,5900,24800
22358,22359,21-10-2020 16:20:28.619742,Desayunos,La Frijolada Desayunos,24300,4400,28700
22359,22360,21-10-2020 16:20:28.988002,Parrilla,Antojo a Domicilio,34500,5000,39500
22360,22361,21-10-2020 16:20:29.307933,Parrilla · Café,Gaira Café,35000,4400,39400
22361,22362,21-10-2020 16:20:29.475913,Saludable,The Good Rice Bowls,34500,3500,38000
22362,22363,21-10-2020 16:20:29.845826,Saludable · Desayunos,Malú,39700,3700,43400
22363,22364,21-10-2020 16:20:30.264058,Desayunos · Sánduches,Danilo Colombia,13600,3300,16900
22364,22365,21-10-2020 16:20:30.534411,Parrilla · Café,Gaira Café,35000,4400,39400
22365,22366,21-10-2020 16:20:30.952136,Comida Rápida,Fiesta Digital Andrés,24200,3100,27300
22366,22367,21-10-2020 16:20:31.121833,Saludable · Parrilla,The Angels Grill and Drinks,27800,6200,34000
22367,22368,21-10-2020 16:20:31.390017,Típica,La Cocina,18900,4600,23500
22368,22369,21-10-2020 16:20:31.660204,Postres · Desayunos,Buñuelos nacho,35000,6600,41600
22369,22370,21-10-2020 16:20:32.027898,Pollo · Saludable,Tremenda Sal y Dulce,48750,6500,55250
22370,22371,21-10-2020 16:20:32.398193,Típica,Baondish,53900,5800,59700
22371,22372,21-10-2020 16:20:32.816804,Saludable · Desayunos,Re.al Alimentos Reales,24300,4000,28300
22372,22373,21-10-2020 16:20:33.187854,Postres · Desayunos,Protein Bakes,10700,5900,16600
22373,22374,21-10-2020 16:20:33.557879,Saludable · Desayunos,Fresh Co,15000,5600,20600
22374,22375,21-10-2020 16:20:33.728176,Asiática,TeT,29500,5900,35400
22375,22376,21-10-2020 16:20:34.046134,Desayunos · Sánduches,Danilo Colombia,37900,3300,41200
22376,22377,21-10-2020 16:20:34.266622,Postres · Café,Loló Coffee & Snacks,48750,4600,53350
22377,22378,21-10-2020 16:20:34.635384,Pizza,Pizza Andante,37900,6300,44200
22378,22379,21-10-2020 16:20:34.905721,Saludable,A2manos,13000,4200,17200
22379,22380,21-10-2020 16:20:35.174554,Desayunos · Típica,Papadió - Colombianas,18900,5700,24600
22380,22381,21-10-2020 16:20:35.596028,Pescados y Mariscos,Fish Place - Del Mar,53400,5400,58800
22381,22382,21-10-2020 16:20:35.865210,Típica · Parrilla,El Portal de la Antigua,70000,5600,75600
22382,22383,21-10-2020 16:20:36.137032,Desayunos · Café,Norma's Ice Cream Café,15000,6300,21300
22383,22384,21-10-2020 16:20:36.555658,Típica,Sabores De Mi Tierra,23000,5400,28400
22384,22385,21-10-2020 16:20:36.975782,Desayunos · Parrilla,Mi Patria,10700,4600,15300
22385,22386,21-10-2020 16:20:37.144005,Típica,Salsig,24300,5600,29900
22386,22387,21-10-2020 16:20:37.415166,Saludable,Hanai - Bowls Saludables,39700,5900,45600
22387,22388,21-10-2020 16:20:37.783637,Parrilla,Restaurante Bar Mi Ranchito,45800,5200,51000
22388,22389,21-10-2020 16:20:38.054515,Postres · Desayunos,Gelateria Da Favola,12500,6500,19000
22389,22390,21-10-2020 16:20:38.322495,Típica · Parrilla,Parrilla Farandula Gourmet,7500,5100,12600
22390,22391,21-10-2020 16:20:38.644276,Postres · Desayunos,BagBog Bagels,48750,6400,55150
22391,22392,21-10-2020 16:20:39.062775,Desayunos · Jugos y Batidos,Kuriwaji,27800,6300,34100
22392,22393,21-10-2020 16:20:39.233377,Pollo · Saludable,Gratina,15000,4200,19200
22393,22394,21-10-2020 16:20:39.452393,Desayunos,Don Leo,45800,6000,51800
22394,22395,21-10-2020 16:20:39.822853,Desayunos,La Frijolada Desayunos,13000,4400,17400
22395,22396,21-10-2020 16:20:40.040862,Helados,Orso To Go,9000,6800,15800
22396,22397,21-10-2020 16:20:40.461510,Pollo,Oliva Va,11870,5600,17470
22397,22398,21-10-2020 16:20:40.679345,Pollo · Saludable,Yerbabuena,9000,3900,12900
22398,22399,21-10-2020 16:20:41.099409,Desayunos,Don Leo,7500,6000,13500
22399,22400,21-10-2020 16:20:41.317072,Típica · Pescados y Mariscos,La Vitualla,27800,6300,34100
22400,22401,21-10-2020 16:20:41.487450,Postres · Helados,Mahé,11870,6000,17870
22401,22402,21-10-2020 16:20:41.655734,Típica,Lo Nuestro,31800,3100,34900
22402,22403,21-10-2020 16:20:41.925946,Postres · Desayunos,Aury Postres - Comidas & Picadas,23000,4700,27700
22403,22404,21-10-2020 16:20:42.243695,Saludable · Desayunos,Básico y Elemental,29500,5900,35400
22404,22405,21-10-2020 16:20:42.414474,Desayunos · Pescados y Mariscos,Gypsy Bistro,65000,4500,69500
22405,22406,21-10-2020 16:20:42.782566,Mexicana,La leyenda mexican kitchen,23000,3200,26200
22406,22407,21-10-2020 16:20:42.952445,Postres · Desayunos,La Folie - Postres,53900,3300,57200
22407,22408,21-10-2020 16:20:43.220652,Saludable · Desayunos,Guadalupe - Fruteria,35000,5900,40900
22408,22409,21-10-2020 16:20:43.590939,Típica · Pescados y Mariscos,La Vitualla,39700,6300,46000
22409,22410,21-10-2020 16:20:43.810275,Postres · Desayunos,Maltihelado,8900,4500,13400
22410,22411,21-10-2020 16:20:44.130795,Desayunos · Panadería,Decofruta,35000,4700,39700
22411,22412,21-10-2020 16:20:44.450077,Pizza · Italiana,Pisapore - Pizza,24200,6600,30800
22412,22413,21-10-2020 16:20:44.770339,Saludable · Desayunos,La Estampilla,18900,6000,24900
22413,22414,21-10-2020 16:20:45.139417,Desayunos · Café,Matchacha,34500,5900,40400
22414,22415,21-10-2020 16:20:45.559378,Típica,Bandejas Mrg,53400,3800,57200
22415,22416,21-10-2020 16:20:45.927130,Desayunos · Típica,Cochon,17800,3300,21100
22416,22417,21-10-2020 16:20:46.248012,Saludable,A2manos,45800,4200,50000
22417,22418,21-10-2020 16:20:46.615771,Sushi · Asiática,Arigato,27800,5300,33100
22418,22419,21-10-2020 16:20:46.885723,Desayunos · Típica,90 Calentados,13000,3700,16700
22419,22420,21-10-2020 16:20:47.103458,Típica,Sopitas y Más,45800,4200,50000
22420,22421,21-10-2020 16:20:47.324039,Pollo · Saludable,Yerbabuena,15000,3900,18900
22421,22422,21-10-2020 16:20:47.742584,Típica · Parrilla,Mi Ranchito Parrilla,17800,4400,22200
22422,22423,21-10-2020 16:20:48.013082,Desayunos · Árabe,Boniato Sabores Vivos,24200,5300,29500
22423,22424,21-10-2020 16:20:48.330733,Desayunos · Internacional,Camilia,48750,3900,52650
22424,22425,21-10-2020 16:20:48.700769,Saludable · Desayunos,Guadalupe - Fruteria,37900,5900,43800
22425,22426,21-10-2020 16:20:48.869041,Internacional,Rio Sabores y Experiencias,29500,4100,33600
22426,22427,21-10-2020 16:20:49.189396,Saludable · Desayunos,Malú,12500,3700,16200
22427,22428,21-10-2020 16:20:49.356608,Parrilla,OAK Ahumado y Brebajes,39700,6000,45700
22428,22429,21-10-2020 16:20:49.577021,Sánduches,Submarin,18900,3800,22700
22429,22430,21-10-2020 16:20:49.795589,Postres · Café,Celestino Café,11870,5900,17770
22430,22431,21-10-2020 16:20:50.115716,Desayunos · Helados,San Giorgio Gelateria,70000,3100,73100
22431,22432,21-10-2020 16:20:50.484595,Desayunos · Típica,Calentao Express,15600,6000,21600
22432,22433,21-10-2020 16:20:50.805190,Pizza,18 Scalini,15000,4300,19300
22433,22434,21-10-2020 16:20:50.972832,Pollo,Heart & Cooking,24300,5000,29300
22434,22435,21-10-2020 16:20:51.393776,Desayunos · Típica,Parrilla Farandula Típico,48750,5900,54650
22435,22436,21-10-2020 16:20:51.662525,Desayunos,Señor Desayuno,37900,6800,44700
22436,22437,21-10-2020 16:20:52.082761,Desayunos · Café,Frambas,35000,3400,38400
22437,22438,21-10-2020 16:20:52.300658,Postres · Desayunos,Maria Luisa - Postres,24300,4300,28600
22438,22439,21-10-2020 16:20:52.471193,Saludable · Desayunos,Fresh Co,24300,5600,29900
22439,22440,21-10-2020 16:20:52.789646,Desayunos,Don Leo,8900,6000,14900
22440,22441,21-10-2020 16:20:53.059990,Desayunos · Internacional,Camilia,70000,3900,73900
22441,22442,21-10-2020 16:20:53.278303,Típica · Parrilla,El Santandereano,29500,5200,34700
22442,22443,21-10-2020 16:20:53.649245,Pollo · Desayunos,Workzone,31800,3100,34900
22443,22444,21-10-2020 16:20:53.917968,Desayunos,El Corral - Desayunos,34500,5000,39500
22444,22445,21-10-2020 16:20:54.188239,Desayunos,Señor Desayuno,34500,6800,41300
22445,22446,21-10-2020 16:20:54.456918,Típica · Parrilla,El Portal de la Antigua,15000,5600,20600
22446,22447,21-10-2020 16:20:54.777833,Saludable · Desayunos,Raices Bienestar Gourmet,24200,6600,30800
22447,22448,21-10-2020 16:20:55.195866,Pollo · Saludable,Tremenda Sal y Dulce,70000,6500,76500
22448,22449,21-10-2020 16:20:55.416237,Saludable · Desayunos,Maracuyá,35000,6700,41700
22449,22450,21-10-2020 16:20:55.735244,Pollo · Desayunos,Workzone,10700,3100,13800
22450,22451,21-10-2020 16:20:56.105644,Postres · Desayunos,Protein Bakes,24300,5900,30200
22451,22452,21-10-2020 16:20:56.474677,Desayunos,Butter,34500,6700,41200
22452,22453,21-10-2020 16:20:56.695029,Típica,La Cocina,53400,4600,58000
22453,22454,21-10-2020 16:20:56.962543,Sushi · Desayunos,Maki Roll,29500,4300,33800
22454,22455,21-10-2020 16:20:57.232889,Desayunos · Panadería,Juliana Restaurante,53400,6100,59500
22455,22456,21-10-2020 16:20:57.451055,Desayunos · Café,Aromacafé el Placer de Compartir,35000,5000,40000
22456,22457,21-10-2020 16:20:57.721220,Parrilla,Carnes la Zarza,31800,4900,36700
22457,22458,21-10-2020 16:20:57.938457,Pollo,Heart & Cooking,45800,5000,50800
22458,22459,21-10-2020 16:20:58.108745,Sushi,Canoa To Go,35000,5900,40900
22459,22460,21-10-2020 16:20:58.476955,Saludable · Desayunos,Re.al Alimentos Reales,34500,4000,38500
22460,22461,21-10-2020 16:20:58.647753,Desayunos · Helados,San Giorgio Gelateria,13600,3100,16700
22461,22462,21-10-2020 16:20:59.066582,Hamburguesas · Pescados y Mariscos,El Velero,70000,6500,76500
22462,22463,21-10-2020 16:20:59.287299,Desayunos · Café,vereda central calle 99,53900,5700,59600
22463,22464,21-10-2020 16:20:59.454962,Postres · Desayunos,Gelateria Da Favola,31800,6500,38300
22464,22465,21-10-2020 16:20:59.725857,Desayunos,Sr Buñuelo,7500,6400,13900
22465,22466,21-10-2020 16:20:59.893815,Pollo · Desayunos,Caserito Gourmet,17800,6700,24500
22466,22467,21-10-2020 16:21:00.165658,Típica,Carbón & Mondongos,29500,6400,35900
22467,22468,21-10-2020 16:21:00.484855,Pescados y Mariscos,Pescadero Héroes del Mar,37900,6600,44500
22468,22469,21-10-2020 16:21:00.656551,Saludable · Típica,Saludable Mrg,23000,5800,28800
22469,22470,21-10-2020 16:21:00.873937,Comida Rápida · Perros Calientes,Similoa - Comida Rapida,15600,3700,19300
22470,22471,21-10-2020 16:21:01.044678,Desayunos · Panadería,El Pan de Phillippe,8900,4600,13500
22471,22472,21-10-2020 16:21:01.363387,Parrilla,Carnes la Zarza,53900,4900,58800
22472,22473,21-10-2020 16:21:01.683892,Saludable · Desayunos,Malú,15600,3700,19300
22473,22474,21-10-2020 16:21:01.951884,Desayunos,Don Leo,37900,6000,43900
22474,22475,21-10-2020 16:21:02.222580,Saludable,Hanai - Bowls Saludables,45800,5900,51700
22475,22476,21-10-2020 16:21:02.540726,Postres · Desayunos,Aury Postres - Comidas & Picadas,23000,4700,27700
22476,22477,21-10-2020 16:21:02.710458,Jugos y Batidos,Pomponio,37900,3600,41500
22477,22478,21-10-2020 16:21:02.878306,Típica · Parrilla,El Santandereano,13000,5200,18200
22478,22479,21-10-2020 16:21:03.248924,Crepes,La Chabatta,37900,5900,43800
22479,22480,21-10-2020 16:21:03.468033,Internacional,Rio Sabores y Experiencias,23000,4100,27100
22480,22481,21-10-2020 16:21:03.838640,Alta Cocina · Parrilla,Criterión,39700,6000,45700
22481,22482,21-10-2020 16:21:04.107094,Típica · Parrilla,La Ternera Parrilla,10700,5200,15900
22482,22483,21-10-2020 16:21:04.527743,Desayunos · Comida Rápida,La Veneca,29500,6300,35800
22483,22484,21-10-2020 16:21:04.796074,Típica,La Herencia,65000,5900,70900
22484,22485,21-10-2020 16:21:05.016552,Saludable · Jugos y Batidos,Berdes Drinks & Salads,31800,3500,35300
22485,22486,21-10-2020 16:21:05.285718,Perros Calientes,Dog Shop - Rapida,31800,4900,36700
22486,22487,21-10-2020 16:21:05.505704,Pizza,Pastas Laurentina,23000,4800,27800
22487,22488,21-10-2020 16:21:05.724651,Parrilla,Arepaisa de Medellín,15600,5600,21200
22488,22489,21-10-2020 16:21:05.995316,Típica · Parrilla,Parrilla Farandula Gourmet,37900,5100,43000
22489,22490,21-10-2020 16:21:06.212824,Desayunos · Internacional,Camilia,10700,3900,14600
22490,22491,21-10-2020 16:21:06.533324,Postres · Desayunos,Amelie Helados,31800,6400,38200
22491,22492,21-10-2020 16:21:06.801864,Comida Rápida · Perros Calientes,Similoa - Comida Rapida,37900,3700,41600
22492,22493,21-10-2020 16:21:07.172761,Desayunos · Café,Aromacafé el Placer de Compartir,12500,5000,17500
22493,22494,21-10-2020 16:21:07.340966,Desayunos · Típica,D'Porco - Lechona,65000,6300,71300
22494,22495,21-10-2020 16:21:07.661421,Postres · Desayunos,Restaurante Cornelia,27800,5500,33300
22495,22496,21-10-2020 16:21:08.030814,Típica · Pescados y Mariscos,La Vitualla,10700,6300,17000
22496,22497,21-10-2020 16:21:08.201563,Asiática,TeT,70000,5900,75900
22497,22498,21-10-2020 16:21:08.570403,Sushi,Umi,48750,5600,54350
22498,22499,21-10-2020 16:21:08.840781,Mexicana,Cantina La 15,10700,4300,15000
22499,22500,21-10-2020 16:21:09.210729,Pollo · Saludable,Tremenda Sal y Dulce,53400,6500,59900
22500,22501,21-10-2020 16:21:09.532671,Pizza,18 Scalini,8900,4300,13200
22501,22502,21-10-2020 16:21:09.751959,Desayunos · Típica,Casa Vieja,9000,6000,15000
22502,22503,21-10-2020 16:21:10.123146,Jugos y Batidos,Pomponio,24200,3600,27800
22503,22504,21-10-2020 16:21:10.341324,Postres · Desayunos,Maltihelado,65000,4500,69500
22504,22505,21-10-2020 16:21:10.663236,Típica,Sabrosito,45800,4000,49800
22505,22506,21-10-2020 16:21:11.081263,Desayunos · Parrilla,Mi Patria,13000,4600,17600
22506,22507,21-10-2020 16:21:11.302358,Postres · Panadería,RIGHT AWAY FOODS,65000,6600,71600
22507,22508,21-10-2020 16:21:11.521102,Poke,Poke Go,13600,4600,18200
22508,22509,21-10-2020 16:21:11.742402,Desayunos,Sunny Breakfast Brunch,27800,4300,32100
22509,22510,21-10-2020 16:21:12.011121,Mexicana,Mexicanachos,8900,3900,12800
22510,22511,21-10-2020 16:21:12.231609,Típica · Parrilla,El Portal de la Antigua,34500,5600,40100
22511,22512,21-10-2020 16:21:12.600219,Parrilla,Beraca Parrilla Bbq,39700,5600,45300
22512,22513,21-10-2020 16:21:12.920753,Típica · Parrilla,La Parilla de David,13000,3100,16100
22513,22514,21-10-2020 16:21:13.239859,Postres · Desayunos,Restaurante Cornelia,12500,5500,18000
22514,22515,21-10-2020 16:21:13.410873,Sushi · Asiática,Arigato,39700,5300,45000
22515,22516,21-10-2020 16:21:13.829859,Saludable · Desayunos,Maracuyá,29500,6700,36200
22516,22517,21-10-2020 16:21:14.252074,Mexicana,La leyenda mexican kitchen,13000,3200,16200
22517,22518,21-10-2020 16:21:14.421117,Hamburguesas,Gofi Burger,24200,5100,29300
22518,22519,21-10-2020 16:21:14.692299,Típica,La Olla de Barro,8900,5300,14200
22519,22520,21-10-2020 16:21:15.009984,Parrilla,Arroces Maria Paula,13600,6800,20400
22520,22521,21-10-2020 16:21:15.330406,Comida Rápida,Fiesta Digital Andrés,48750,3100,51850
22521,22522,21-10-2020 16:21:15.548339,Saludable,The Good Rice Bowls,35000,3500,38500
22522,22523,21-10-2020 16:21:15.768686,Saludable · Parrilla,Box,15000,3700,18700
22523,22524,21-10-2020 16:21:16.086458,Desayunos · Panadería,Santa Juana Food Bar,7500,5900,13400
22524,22525,21-10-2020 16:21:16.458002,Café · Helados,Sofia heladería y café,24300,5800,30100
22525,22526,21-10-2020 16:21:16.776328,Saludable · Desayunos,Básico y elemental,53400,5000,58400
22526,22527,21-10-2020 16:21:16.946881,Saludable · Desayunos,Copacabana Açai Bowls,18900,3000,21900
22527,22528,21-10-2020 16:21:17.214692,Hamburguesas,Monchis - Hamburguesa,23000,4300,27300
22528,22529,21-10-2020 16:21:17.435812,Hamburguesas,Bendito Cordero,8900,5800,14700
22529,22530,21-10-2020 16:21:17.804520,Parrilla,Carnes la Zarza,39700,4900,44600
22530,22531,21-10-2020 16:21:17.974835,Hamburguesas · Panadería,NYC Burgers,10700,6200,16900
22531,22532,21-10-2020 16:21:18.143765,Saludable,MIMA,53400,3700,57100
22532,22533,21-10-2020 16:21:18.414587,Típica,Sabrosito,13000,4000,17000
22533,22534,21-10-2020 16:21:18.633623,Pizza,Pastas Laurentina,65000,4800,69800
22534,22535,21-10-2020 16:21:18.803729,Pizza · Italiana,Piatto - Pizza,70000,6600,76600
22535,22536,21-10-2020 16:21:19.121574,Desayunos · Panadería,Pasteleite,37900,5900,43800
22536,22537,21-10-2020 16:21:19.493173,Sushi,Canoa To Go,7500,5900,13400
22537,22538,21-10-2020 16:21:19.911642,Desayunos · Panadería,Pasteleite,23000,5900,28900
22538,22539,21-10-2020 16:21:20.332714,Saludable,Puro Verde,23000,5700,28700
22539,22540,21-10-2020 16:21:20.701502,Postres · Desayunos,Maria Luisa - Postres,10700,4300,15000
22540,22541,21-10-2020 16:21:20.972697,Desayunos · Típica,Fogón Sangileño,39700,5000,44700
22541,22542,21-10-2020 16:21:21.191219,Alta Cocina · Postres,La Pinta,11870,4500,16370
22542,22543,21-10-2020 16:21:21.412101,Mexicana,Mexicanachos,17800,3900,21700
22543,22544,21-10-2020 16:21:21.730992,Saludable · Parrilla,Box,18900,3700,22600
22544,22545,21-10-2020 16:21:22.102012,Saludable · Desayunos,Distrito Gourmet,7500,3700,11200
22545,22546,21-10-2020 16:21:22.270298,Desayunos · Café,Frambas,31800,3400,35200
22546,22547,21-10-2020 16:21:22.691528,Saludable · Parrilla,The Angels Grill and Drinks,11870,6200,18070
22547,22548,21-10-2020 16:21:23.110405,Alta Cocina · Italiana,Trattoria de la Plaza,24300,6000,30300
22548,22549,21-10-2020 16:21:23.432178,Pizza,Pastas Laurentina,35000,4800,39800
22549,22550,21-10-2020 16:21:23.801272,Hamburguesas · Alitas,Beer,65000,6600,71600
22550,22551,21-10-2020 16:21:24.222510,Desayunos · Comida Rápida,La Veneca,27800,6300,34100
22551,22552,21-10-2020 16:21:24.643068,Desayunos,El Fogón Castellano,29500,3200,32700
22552,22553,21-10-2020 16:21:24.914123,Desayunos · Mexicana,La Mera Mera - Mexicana,17800,3100,20900
22553,22554,21-10-2020 16:21:25.081997,Desayunos · Típica,Rojo Gourmet,10700,4700,15400
22554,22555,21-10-2020 16:21:25.252940,Saludable,Hanai - Bowls Saludables,17800,5900,23700
22555,22556,21-10-2020 16:21:25.621711,Típica,Campo Victoria,45800,3000,48800
22556,22557,21-10-2020 16:21:25.891718,Pollo · Sánduches,Pollos Century,35000,3000,38000
22557,22558,21-10-2020 16:21:26.109936,Pollo · Saludable,Tremenda Sal y Dulce,13000,6500,19500
22558,22559,21-10-2020 16:21:26.280915,Sushi · Asiática,Tu Sushi,70000,6400,76400
22559,22560,21-10-2020 16:21:26.649189,Desayunos,El Fogón Castellano,27800,3200,31000
22560,22561,21-10-2020 16:21:26.920369,Crepes,San Crepes,27800,4900,32700
22561,22562,21-10-2020 16:21:27.088905,Desayunos · Panadería,Choclofee,12500,4700,17200
22562,22563,21-10-2020 16:21:27.459985,Desayunos · Panadería,Premium Break Bakery,53900,3700,57600
22563,22564,21-10-2020 16:21:27.728749,Desayunos · Café,vereda central calle 99,12500,5700,18200
22564,22565,21-10-2020 16:21:28.150582,Desayunos · Típica,Parrilla Farandula Típico,53400,5900,59300
22565,22566,21-10-2020 16:21:28.419902,Desayunos · Sánduches,Danilo Colombia,70000,3300,73300
22566,22567,21-10-2020 16:21:28.840665,Saludable · Desayunos,Básico y Elemental,31800,5900,37700
22567,22568,21-10-2020 16:21:29.109086,Postres · Desayunos,Café Quindio,8900,5700,14600
22568,22569,21-10-2020 16:21:29.380204,Saludable · Típica,Saludable Mrg,31800,5800,37600
22569,22570,21-10-2020 16:21:29.700162,Parrilla · Café,Figaro Café/ Restaurante Argentino,27800,5800,33600
22570,22571,21-10-2020 16:21:29.870939,Parrilla,Coquitas,13600,5600,19200
22571,22572,21-10-2020 16:21:30.038789,Típica,La Cocina,15000,4600,19600
22572,22573,21-10-2020 16:21:30.461259,Peruana,Masivo,70000,5800,75800
22573,22574,21-10-2020 16:21:30.831098,Pollo · Saludable,Tremenda Sal y Dulce,70000,6500,76500
22574,22575,21-10-2020 16:21:31.101935,Desayunos · Sánduches,Garnish,70000,5200,75200
22575,22576,21-10-2020 16:21:31.320125,Sánduches · China,Peru Mix,23000,5900,28900
22576,22577,21-10-2020 16:21:31.641616,Típica · Pescados y Mariscos,Arroces Mrg,39700,4300,44000
22577,22578,21-10-2020 16:21:31.959571,Parrilla,Antojo a Domicilio,13600,5000,18600
22578,22579,21-10-2020 16:21:32.281388,Pescados y Mariscos,Fish Place - Del Mar,24200,5400,29600
22579,22580,21-10-2020 16:21:32.650431,Saludable,Amor Propio saludable,10700,4000,14700
22580,22581,21-10-2020 16:21:33.020918,Postres · Desayunos,Amelie Helados,13000,6400,19400
22581,22582,21-10-2020 16:21:33.189822,Postres · Desayunos,Gelateria Da Favola,45800,6500,52300
22582,22583,21-10-2020 16:21:33.460909,Desayunos · Café,Moramia,11870,4700,16570
22583,22584,21-10-2020 16:21:33.878799,Desayunos · Café,Norma's Ice Cream Café,45800,6300,52100
22584,22585,21-10-2020 16:21:34.149705,Típica · Parrilla,Typykos,18900,6000,24900
22585,22586,21-10-2020 16:21:34.367738,Postres · Desayunos,Maria Luisa - Postres,37900,4300,42200
22586,22587,21-10-2020 16:21:34.538410,Desayunos · Pescados y Mariscos,Luzí­a - Mediterranea,24300,5700,30000
22587,22588,21-10-2020 16:21:34.707733,Saludable · Desayunos,Re.al Alimentos Reales,18900,4000,22900
22588,22589,21-10-2020 16:21:34.877888,Pizza · Parrilla,Urban Lunch,37900,4000,41900
22589,22590,21-10-2020 16:21:35.196384,Típica · Parrilla,Typykos,13600,6000,19600
22590,22591,21-10-2020 16:21:35.517583,Saludable · Desayunos,Básico y elemental,10700,5000,15700
22591,22592,21-10-2020 16:21:35.885671,Desayunos · Panadería,Siena Café,53900,3700,57600
22592,22593,21-10-2020 16:21:36.306977,Típica,La Cocina,7500,4600,12100
22593,22594,21-10-2020 16:21:36.676535,Desayunos · Empanadas,Empanadas Doraditas.com,15000,3000,18000
22594,22595,21-10-2020 16:21:37.049347,Desayunos · Panadería,Siena Café,34500,3700,38200
22595,22596,21-10-2020 16:21:37.369690,Desayunos · Panadería,El Pan de Phillippe,9000,4600,13600
22596,22597,21-10-2020 16:21:37.641819,Parrilla,Arepaisa de Medellín,9000,5600,14600
22597,22598,21-10-2020 16:21:37.810338,Pollo · Desayunos,Caserito Gourmet,35000,6700,41700
22598,22599,21-10-2020 16:21:38.180951,Pollo,Señor Fantástico,13000,4700,17700
22599,22600,21-10-2020 16:21:38.349608,Típica,Sopitas y Más,29500,4200,33700
22600,22601,21-10-2020 16:21:38.671642,Desayunos · Pescados y Mariscos,Luzí­a - Mediterranea,9000,5700,14700
22601,22602,21-10-2020 16:21:38.991480,Desayunos · Sánduches,Danilo Colombia,17800,3300,21100
22602,22603,21-10-2020 16:21:39.362641,Postres,Beiked,15000,4000,19000
22603,22604,21-10-2020 16:21:39.631573,Típica · Parrilla,La Ternera Parrilla,34500,5200,39700
22604,22605,21-10-2020 16:21:39.803752,Café · Helados,Sofia heladería y café,7500,5800,13300
22605,22606,21-10-2020 16:21:39.971922,Desayunos · Italiana,Rceta By Rausch,24200,3600,27800
22606,22607,21-10-2020 16:21:40.393026,Pollo · Desayunos,Workzone,70000,3100,73100
22607,22608,21-10-2020 16:21:40.611409,Desayunos · Mexicana,La Mera Mera - Mexicana,9000,3100,12100
22608,22609,21-10-2020 16:21:41.031996,Pollo · Pescados y Mariscos,Bang Bang Rice,15600,3400,19000
22609,22610,21-10-2020 16:21:41.400805,Desayunos,El Corral - Desayunos,10700,5000,15700
22610,22611,21-10-2020 16:21:41.821894,Saludable · Desayunos,Maracuyá,11870,6700,18570
22611,22612,21-10-2020 16:21:42.191073,Saludable · Desayunos,La Cesta,15000,4700,19700
22612,22613,21-10-2020 16:21:42.412261,Desayunos · Café,El Gualilo,23000,6200,29200
22613,22614,21-10-2020 16:21:42.631498,Desayunos · Café,Matchacha,35000,5900,40900
22614,22615,21-10-2020 16:21:43.052716,Saludable · Desayunos,Re.al Alimentos Reales,17800,4000,21800
22615,22616,21-10-2020 16:21:43.271978,Postres · Desayunos,KOKOA & co.,13000,4700,17700
22616,22617,21-10-2020 16:21:43.693558,Jugos y Batidos,Pomponio,15600,3600,19200
22617,22618,21-10-2020 16:21:43.911967,Helados,Orso To Go,27800,6800,34600
22618,22619,21-10-2020 16:21:44.332972,Típica · Parrilla,El Santandereano,8900,5200,14100
22619,22620,21-10-2020 16:21:44.601583,Desayunos · Panadería,Juliana Restaurante,8900,6100,15000
22620,22621,21-10-2020 16:21:44.823378,Saludable,Hanai - Bowls Saludables,13600,5900,19500
22621,22622,21-10-2020 16:21:45.092024,Desayunos,El Fogón Castellano,27800,3200,31000
22622,22623,21-10-2020 16:21:45.313367,Típica,Juan Chorizo,37900,3900,41800
22623,22624,21-10-2020 16:21:45.681782,Pizza,Pastas Laurentina,23000,4800,27800
22624,22625,21-10-2020 16:21:45.952424,Típica,Sabores De Mi Tierra,39700,5400,45100
22625,22626,21-10-2020 16:21:46.371438,Desayunos · Jugos y Batidos,Frutiwow,18900,4100,23000
22626,22627,21-10-2020 16:21:46.743024,Desayunos,Bagel Shop,27800,3200,31000
22627,22628,21-10-2020 16:21:47.162801,Postres · Café,Loló Coffee & Snacks,12500,4600,17100
22628,22629,21-10-2020 16:21:47.434309,Saludable,A2manos,37900,4200,42100
22629,22630,21-10-2020 16:21:47.753508,Desayunos · Pescados y Mariscos,Luzí­a - Mediterranea,37900,5700,43600
22630,22631,21-10-2020 16:21:48.124952,Desayunos · Café,Norma's Ice Cream Café,12500,6300,18800
22631,22632,21-10-2020 16:21:48.444370,Parrilla,OAK Ahumado y Brebajes,27800,6000,33800
22632,22633,21-10-2020 16:21:48.815685,Desayunos · Café,Moramia,8900,4700,13600
22633,22634,21-10-2020 16:21:49.234843,Desayunos · Comida Rápida,Chocolatto,70000,3400,73400
22634,22635,21-10-2020 16:21:49.506074,Saludable · Jugos y Batidos,Berdes Drinks & Salads,34500,3500,38000
22635,22636,21-10-2020 16:21:49.725576,Saludable · Desayunos,Básico y elemental,35000,5000,40000
22636,22637,21-10-2020 16:21:50.147844,Típica,La Olla de Barro,17800,5300,23100
22637,22638,21-10-2020 16:21:50.416805,Postres · Desayunos,KOKOA & co.,27800,4700,32500
22638,22639,21-10-2020 16:21:50.837988,Postres · Desayunos,Maria Luisa - Postres,48750,4300,53050
22639,22640,21-10-2020 16:21:51.106450,Saludable · Desayunos,Maracuyá,24200,6700,30900
22640,22641,21-10-2020 16:21:51.277690,Desayunos,Desayunos en Bogotá,24200,3400,27600
22641,22642,21-10-2020 16:21:51.697298,Desayunos · Típica,La Frijolada,35000,4500,39500
22642,22643,21-10-2020 16:21:52.118716,Desayunos · Café,Libertario Coffee Roasters,15000,4600,19600
22643,22644,21-10-2020 16:21:52.387803,Típica · Parrilla,El Portal de la Antigua,31800,5600,37400
22644,22645,21-10-2020 16:21:52.709639,Desayunos,El Fogón Castellano,18900,3200,22100
22645,22646,21-10-2020 16:21:53.079058,Desayunos · Café,El Gualilo,12500,6200,18700
22646,22647,21-10-2020 16:21:53.400145,Postres,La Tertulia,53400,3400,56800
22647,22648,21-10-2020 16:21:53.719066,Postres · Saludable,Ana Rebana,31800,6300,38100
22648,22649,21-10-2020 16:21:53.939922,Desayunos · Típica,Casa Vieja,53400,6000,59400
22649,22650,21-10-2020 16:21:54.158961,Parrilla,Carnes la Zarza,9000,4900,13900
22650,22651,21-10-2020 16:21:54.329757,Pollo,Chicken House,65000,4200,69200
22651,22652,21-10-2020 16:21:54.698715,Parrilla · Café,Figaro Café/ Restaurante Argentino,8900,5800,14700
22652,22653,21-10-2020 16:21:54.969809,Saludable,Amor Propio saludable,15600,4000,19600
22653,22654,21-10-2020 16:21:55.338752,Típica,Cazuelitas 93,39700,3900,43600
22654,22655,21-10-2020 16:21:55.759834,Parrilla,El Tambor,23000,6800,29800
22655,22656,21-10-2020 16:21:56.128880,Típica · Parrilla,El Santandereano,23000,5200,28200
22656,22657,21-10-2020 16:21:56.450599,Desayunos,El Fogón Castellano,17800,3200,21000
22657,22658,21-10-2020 16:21:56.669604,Típica · Parrilla,Toya,45800,4200,50000
22658,22659,21-10-2020 16:21:56.940150,Pollo,Señor Fantástico,10700,4700,15400
22659,22660,21-10-2020 16:21:57.308998,Postres,La Tertulia,18900,3400,22300
22660,22661,21-10-2020 16:21:57.629948,Saludable · Desayunos,Libre de Culpa,35000,4000,39000
22661,22662,21-10-2020 16:21:57.798728,Desayunos · Panadería,El Pan de Phillippe,8900,4600,13500
22662,22663,21-10-2020 16:21:58.220324,Desayunos · Jugos y Batidos,Dont Be Hungry,24200,5600,29800
22663,22664,21-10-2020 16:21:58.489834,Saludable · Desayunos,Agua Dulce,24300,3700,28000
22664,22665,21-10-2020 16:21:58.910621,Parrilla,Beraca Parrilla Bbq,11870,5600,17470
22665,22666,21-10-2020 16:21:59.078941,Italiana,F*cking Good Pizza,24300,4200,28500
22666,22667,21-10-2020 16:21:59.299992,Internacional,La Esquina con Sabor Parrilla,27800,3000,30800
22667,22668,21-10-2020 16:21:59.718863,Sushi,Kim Pop,35000,5400,40400
22668,22669,21-10-2020 16:22:00.039302,Desayunos · Típica,90 Calentados,15600,3700,19300
22669,22670,21-10-2020 16:22:00.208079,Desayunos,El Fogón Castellano,11870,3200,15070
22670,22671,21-10-2020 16:22:00.579895,Pollo,Chicken House,23000,4200,27200
22671,22672,21-10-2020 16:22:00.798594,Alta Cocina · Italiana,Trattoria de la Plaza,35000,6000,41000
22672,22673,21-10-2020 16:22:00.969271,Típica,Carbón & Mondongos,7500,6400,13900
22673,22674,21-10-2020 16:22:01.337823,Sánduches · Pescados y Mariscos,Pacific Comida de Mar,11870,4000,15870
22674,22675,21-10-2020 16:22:01.759495,Saludable · Desayunos,Fresh Co,35000,5600,40600
22675,22676,21-10-2020 16:22:01.978256,Postres · Saludable,Ana Rebana,8900,6300,15200
22676,22677,21-10-2020 16:22:02.199076,Postres · Desayunos,Maria Luisa - Postres,29500,4300,33800
22677,22678,21-10-2020 16:22:02.418721,Italiana,F*cking Good Pizza,27800,4200,32000
22678,22679,21-10-2020 16:22:02.589621,Parrilla,OAK Ahumado y Brebajes,18900,6000,24900
22679,22680,21-10-2020 16:22:02.957971,Saludable · Desayunos,Básico y elemental,11870,5000,16870
22680,22681,21-10-2020 16:22:03.129148,Típica,Cabrito Santandereano,13000,6600,19600
22681,22682,21-10-2020 16:22:03.448584,Típica · Pescados y Mariscos,La Vitualla,15000,6300,21300
22682,22683,21-10-2020 16:22:03.670000,Hamburguesas · Desayunos,El Inglés Gastro Pub,13600,6600,20200
22683,22684,21-10-2020 16:22:03.888337,Parrilla,Restaurante Bar Mi Ranchito,65000,5200,70200
22684,22685,21-10-2020 16:22:04.159499,Típica,Sabrosito,48750,4000,52750
22685,22686,21-10-2020 16:22:04.478460,Desayunos · Jugos y Batidos,Kuriwaji,70000,6300,76300
22686,22687,21-10-2020 16:22:04.699601,Desayunos,Don Leo,34500,6000,40500
22687,22688,21-10-2020 16:22:04.968233,Mexicana,Mexicanachos,35000,3900,38900
22688,22689,21-10-2020 16:22:05.139677,Sushi,Sushi Reel,35000,4700,39700
22689,22690,21-10-2020 16:22:05.408714,Sushi,Umi,35000,5600,40600
22690,22691,21-10-2020 16:22:05.580584,Típica,El Cucharón - Tipica,13000,4400,17400
22691,22692,21-10-2020 16:22:05.750735,Postres · Desayunos,Buñuelos nacho,9000,6600,15600
22692,22693,21-10-2020 16:22:05.923091,Italiana,F*cking Good Pizza,11870,4200,16070
22693,22694,21-10-2020 16:22:06.192795,Desayunos · Sánduches,Frutos del Bosque,13600,3500,17100
22694,22695,21-10-2020 16:22:06.514258,Típica,Bendita S,31800,4600,36400
22695,22696,21-10-2020 16:22:06.884336,Hamburguesas,Gofi Burger,7500,5100,12600
22696,22697,21-10-2020 16:22:07.105936,Típica · Pescados y Mariscos,Arroces Mrg,9000,4300,13300
22697,22698,21-10-2020 16:22:07.375411,Saludable · Desayunos,Maracuyá,13600,6700,20300
22698,22699,21-10-2020 16:22:07.647269,Típica,Sabores De Mi Tierra,53400,5400,58800
22699,22700,21-10-2020 16:22:07.965783,Típica · Parrilla,La Parilla de David,18900,3100,22000
22700,22701,21-10-2020 16:22:08.238403,Desayunos · Parrilla,Mi Patria,18900,4600,23500
22701,22702,21-10-2020 16:22:08.607983,Hamburguesas,Gofi Burger,39700,5100,44800
22702,22703,21-10-2020 16:22:08.930234,Desayunos · Jugos y Batidos,Frutiwow,35000,4100,39100
22703,22704,21-10-2020 16:22:09.198534,Internacional,Rio Sabores y Experiencias,9000,4100,13100
22704,22705,21-10-2020 16:22:09.370860,Saludable · Típica,Saludable Mrg,13000,5800,18800
22705,22706,21-10-2020 16:22:09.589967,Desayunos · Árabe,Boniato Sabores Vivos,37900,5300,43200
22706,22707,21-10-2020 16:22:09.810934,Típica · Parrilla,Parrilla Farandula Gourmet,7500,5100,12600
22707,22708,21-10-2020 16:22:10.179839,Sushi,Canoa To Go,35000,5900,40900
22708,22709,21-10-2020 16:22:10.600798,Crepes,San Crepes,7500,4900,12400
22709,22710,21-10-2020 16:22:10.869495,Desayunos · Típica,Fogón Sangileño,9000,5000,14000
22710,22711,21-10-2020 16:22:11.190696,Sushi,Umi,39700,5600,45300
22711,22712,21-10-2020 16:22:11.609308,Pollo · Desayunos,Caserito Gourmet,45800,6700,52500
22712,22713,21-10-2020 16:22:11.930946,Desayunos · Café,Matchacha,37900,5900,43800
22713,22714,21-10-2020 16:22:12.249764,Desayunos · Panadería,Pasteleite,53400,5900,59300
22714,22715,21-10-2020 16:22:12.471358,Mexicana,Hidalgo Taquería,24200,4900,29100
22715,22716,21-10-2020 16:22:12.740035,Desayunos · Típica,Papadió - Colombianas,65000,5700,70700
22716,22717,21-10-2020 16:22:12.911058,Saludable · Desayunos,Básico y Elemental,34500,5900,40400
22717,22718,21-10-2020 16:22:13.329946,Parrilla,Arepaisa de Medellín,53900,5600,59500
22718,22719,21-10-2020 16:22:13.500934,Saludable · Desayunos,Raices Bienestar Gourmet,31800,6600,38400
22719,22720,21-10-2020 16:22:13.719926,Postres,La Galeta,11870,3000,14870
22720,22721,21-10-2020 16:22:14.041430,Parrilla · Café,Gaira Café,24200,4400,28600
22721,22722,21-10-2020 16:22:14.409895,Sushi,Kim Pop,15000,5400,20400
22722,22723,21-10-2020 16:22:14.781350,Mexicana,Mexicanachos,23000,3900,26900
22723,22724,21-10-2020 16:22:15.100065,Desayunos · Jugos y Batidos,Frutiwow,10700,4100,14800
22724,22725,21-10-2020 16:22:15.421408,Desayunos · Típica,D´Porco,45800,3900,49700
22725,22726,21-10-2020 16:22:15.689845,Desayunos · Pescados y Mariscos,Gypsy Bistro,9000,4500,13500
22726,22727,21-10-2020 16:22:15.910727,Desayunos,Sr Buñuelo,11870,6400,18270
22727,22728,21-10-2020 16:22:16.079423,Desayunos · Panadería,Choclofee,70000,4700,74700
22728,22729,21-10-2020 16:22:16.350769,Pescados y Mariscos,Fish Place - Del Mar,24300,5400,29700
22729,22730,21-10-2020 16:22:16.519319,Saludable · Desayunos,Básico y elemental,11870,5000,16870
22730,22731,21-10-2020 16:22:16.890575,Postres · Desayunos,KOKOA & co.,15600,4700,20300
22731,22732,21-10-2020 16:22:17.211081,Postres · Desayunos,Vivalight Market.,8900,6500,15400
22732,22733,21-10-2020 16:22:17.381990,Típica,La Olla de Barro,39700,5300,45000
22733,22734,21-10-2020 16:22:17.751036,Desayunos · Panadería,El Pan de Phillippe,24200,4600,28800
22734,22735,21-10-2020 16:22:18.172568,Comida Rápida · Perros Calientes,Similoa - Comida Rapida,18900,3700,22600
22735,22736,21-10-2020 16:22:18.391377,Hamburguesas · Alitas,Beer,17800,6600,24400
22736,22737,21-10-2020 16:22:18.763367,Postres · Desayunos,Aury Postres - Comidas & Picadas,35000,4700,39700
22737,22738,21-10-2020 16:22:18.931980,Típica,Cazuelitas 93,37900,3900,41800
22738,22739,21-10-2020 16:22:19.354408,Pollo,Señor Fantástico,7500,4700,12200
22739,22740,21-10-2020 16:22:19.773403,Desayunos · Pescados y Mariscos,Luzí­a - Mediterranea,70000,5700,75700
22740,22741,21-10-2020 16:22:20.144973,Desayunos · Café,Norma's Ice Cream Café,23000,6300,29300
22741,22742,21-10-2020 16:22:20.563803,Parrilla,Rústico Picadería,45800,3800,49600
22742,22743,21-10-2020 16:22:20.784829,Pollo · Desayunos,Piaf,8900,6500,15400
22743,22744,21-10-2020 16:22:21.053368,Parrilla,Coquitas,11870,5600,17470
22744,22745,21-10-2020 16:22:21.274646,Saludable · Típica,Sopas Mrg,24200,3100,27300
22745,22746,21-10-2020 16:22:21.643793,Típica,Bandejas Mrg,35000,3800,38800
22746,22747,21-10-2020 16:22:21.914494,Saludable,The Good Rice Bowls,24300,3500,27800
22747,22748,21-10-2020 16:22:22.183882,Saludable · Desayunos,Básico y Elemental,35000,5900,40900
22748,22749,21-10-2020 16:22:22.405772,Desayunos,Cafetería el Kippe,37900,3200,41100
22749,22750,21-10-2020 16:22:22.774978,Postres · Desayunos,Maltihelado,27800,4500,32300
22750,22751,21-10-2020 16:22:22.995990,Sushi · Asiática,Tu Sushi,53900,6400,60300
22751,22752,21-10-2020 16:22:23.165760,Pizza · Italiana,Piatto - Pizza,10700,6600,17300
22752,22753,21-10-2020 16:22:23.438417,Desayunos · Panadería,Siena Café,9000,3700,12700
22753,22754,21-10-2020 16:22:23.757976,Postres · Desayunos,Amelie Helados,7500,6400,13900
22754,22755,21-10-2020 16:22:24.078973,Desayunos · Café,El Gualilo,39700,6200,45900
22755,22756,21-10-2020 16:22:24.397932,Típica · Parrilla,La Parilla de David,9000,3100,12100
22756,22757,21-10-2020 16:22:24.618929,Parrilla,OAK Ahumado y Brebajes,17800,6000,23800
22757,22758,21-10-2020 16:22:24.787587,Parrilla,Restaurante Bar Mi Ranchito,8900,5200,14100
22758,22759,21-10-2020 16:22:25.158924,Desayunos · Panadería,Santa Juana Food Bar,10700,5900,16600
22759,22760,21-10-2020 16:22:25.527959,Hamburguesas,Bendito Cordero,53900,5800,59700
22760,22761,21-10-2020 16:22:25.848995,Típica,Campo Victoria,31800,3000,34800
22761,22762,21-10-2020 16:22:26.018353,Saludable · Desayunos,Libre de Culpa,23000,4000,27000
22762,22763,21-10-2020 16:22:26.339248,Sushi,Canoa To Go,48750,5900,54650
22763,22764,21-10-2020 16:22:26.707829,Postres,Levelma,10700,6200,16900
22764,22765,21-10-2020 16:22:26.928547,Saludable · Desayunos,Guadalupe - Fruteria,48750,5900,54650
22765,22766,21-10-2020 16:22:27.096925,Sushi · Asiática,Arigato,39700,5300,45000
22766,22767,21-10-2020 16:22:27.317882,Desayunos · Jugos y Batidos,Kuriwaji,24300,6300,30600
22767,22768,21-10-2020 16:22:27.487194,Saludable · Desayunos,Fresh Co,48750,5600,54350
22768,22769,21-10-2020 16:22:27.908207,Sushi,Canoa To Go,39700,5900,45600
22769,22770,21-10-2020 16:22:28.126881,Postres · Café,Celestino Café,31800,5900,37700
22770,22771,21-10-2020 16:22:28.548248,Desayunos · Sánduches,Garnish,15600,5200,20800
22771,22772,21-10-2020 16:22:28.916985,Pescados y Mariscos,La Gran Cazuela,37900,3200,41100
22772,22773,21-10-2020 16:22:29.288107,Pollo · Típica,Auyama,35000,3900,38900
22773,22774,21-10-2020 16:22:29.506414,Hamburguesas · Desayunos,El Inglés Gastro Pub,45800,6600,52400
22774,22775,21-10-2020 16:22:29.677662,Pollo · Desayunos,Piaf,23000,6500,29500
22775,22776,21-10-2020 16:22:29.946047,Típica,Campo Victoria,34500,3000,37500
22776,22777,21-10-2020 16:22:30.116614,Parrilla,OAK Ahumado y Brebajes,15000,6000,21000
22777,22778,21-10-2020 16:22:30.435797,Desayunos · Típica,Calentao Express,27800,6000,33800
22778,22779,21-10-2020 16:22:30.707838,Hamburguesas · Desayunos,El Inglés Gastro Pub,34500,6600,41100
22779,22780,21-10-2020 16:22:31.027596,Desayunos · Típica,Parrilla Farandula Típico,9000,5900,14900
22780,22781,21-10-2020 16:22:31.348740,Pollo,Oliva Va,27800,5600,33400
22781,22782,21-10-2020 16:22:31.517572,Saludable · Desayunos,La Estampilla,17800,6000,23800
22782,22783,21-10-2020 16:22:31.739247,Postres,Toledo Pastelería,31800,6800,38600
22783,22784,21-10-2020 16:22:32.108261,Italiana,Bocatto Di Passo,35000,5000,40000
22784,22785,21-10-2020 16:22:32.329074,Desayunos,Desayunos en Bogotá,27800,3400,31200
22785,22786,21-10-2020 16:22:32.698989,Postres,Beiked,53400,4000,57400
22786,22787,21-10-2020 16:22:32.970076,Pescados y Mariscos,Fish Place - Del Mar,48750,5400,54150
22787,22788,21-10-2020 16:22:33.138699,Típica · Parrilla,Toya,8900,4200,13100
22788,22789,21-10-2020 16:22:33.510871,Desayunos,Jacinta Arepas de Huevo,29500,4000,33500
22789,22790,21-10-2020 16:22:33.779758,Postres,Toledo Pastelería,7500,6800,14300
22790,22791,21-10-2020 16:22:34.050656,Crepes,San Crepes,53900,4900,58800
22791,22792,21-10-2020 16:22:34.419922,Pizza · Parrilla,Urban Lunch,53900,4000,57900
22792,22793,21-10-2020 16:22:34.791359,Postres · Desayunos,Vivalight Market.,7500,6500,14000
22793,22794,21-10-2020 16:22:35.059794,Desayunos · Típica,La Parrilla Dorada Polo,24300,6600,30900
22794,22795,21-10-2020 16:22:35.380765,Típica · Parrilla,Toya,53400,4200,57600
22795,22796,21-10-2020 16:22:35.699439,Saludable · Desayunos,Copacabana Açai Bowls,27800,3000,30800
22796,22797,21-10-2020 16:22:36.123127,Desayunos · Típica,Cochon,15000,3300,18300
22797,22798,21-10-2020 16:22:36.342993,Desayunos · Panadería,Pasteleite,24300,5900,30200
22798,22799,21-10-2020 16:22:36.765282,Parrilla · Café,Figaro Café/ Restaurante Argentino,24300,5800,30100
22799,22800,21-10-2020 16:22:37.134366,Pescados y Mariscos,Pescadero Héroes del Mar,11870,6600,18470
22800,22801,21-10-2020 16:22:37.355644,Pollo · Sánduches,Pollos Century,65000,3000,68000
22801,22802,21-10-2020 16:22:37.524112,Postres · Desayunos,Gelateria Da Favola,29500,6500,36000
22802,22803,21-10-2020 16:22:37.695763,Sánduches · Pescados y Mariscos,Pacific Comida de Mar,35000,4000,39000
22803,22804,21-10-2020 16:22:37.863917,Parrilla · Café,Figaro Café/ Restaurante Argentino,10700,5800,16500
22804,22805,21-10-2020 16:22:38.286925,Parrilla,Parrilla Pimentón,13000,3400,16400
22805,22806,21-10-2020 16:22:38.505547,Postres,Levelma,17800,6200,24000
22806,22807,21-10-2020 16:22:38.826989,Postres · Desayunos,Maltihelado,24200,4500,28700
22807,22808,21-10-2020 16:22:39.196219,Pollo · Saludable,Tremenda Sal y Dulce,70000,6500,76500
22808,22809,21-10-2020 16:22:39.617951,Saludable · Desayunos,Raices Bienestar Gourmet,48750,6600,55350
22809,22810,21-10-2020 16:22:39.987219,Pollo · China,China Tao,23000,3500,26500
22810,22811,21-10-2020 16:22:40.408635,Parrilla,Arepaisa de Medellín,27800,5600,33400
22811,22812,21-10-2020 16:22:40.777322,Típica · Parrilla,La Parilla de David,18900,3100,22000
22812,22813,21-10-2020 16:22:40.998271,Saludable · Parrilla,Box,35000,3700,38700
22813,22814,21-10-2020 16:22:41.167363,Hamburguesas · Saludable,Restaurant Inn,70000,6100,76100
22814,22815,21-10-2020 16:22:41.488449,Desayunos · Sánduches,Frutos del Bosque,65000,3500,68500
22815,22816,21-10-2020 16:22:41.857238,Alta Cocina · Postres,La Pinta,24300,4500,28800
22816,22817,21-10-2020 16:22:42.128825,Típica · Pescados y Mariscos,Arroces Mrg,10700,4300,15000
22817,22818,21-10-2020 16:22:42.448904,Típica,Carbón & Mondongos,15600,6400,22000
22818,22819,21-10-2020 16:22:42.872144,Postres · Desayunos,Jacques Pastelería,70000,5900,75900
22819,22820,21-10-2020 16:22:43.091186,Alta Cocina · Postres,La Pinta,17800,4500,22300
22820,22821,21-10-2020 16:22:43.262630,Saludable · Parrilla,Box,17800,3700,21500
22821,22822,21-10-2020 16:22:43.632268,Desayunos · Panadería,El Pan de Phillippe,15000,4600,19600
22822,22823,21-10-2020 16:22:43.853272,Asiática,TeT,18900,5900,24800
22823,22824,21-10-2020 16:22:44.272848,Desayunos · Jugos y Batidos,Kuriwaji,48750,6300,55050
22824,22825,21-10-2020 16:22:44.644411,Desayunos,Jacinta Arepas de Huevo,15600,4000,19600
22825,22826,21-10-2020 16:22:44.913028,Hamburguesas,Monchis - Hamburguesa,65000,4300,69300
22826,22827,21-10-2020 16:22:45.234925,Desayunos · Internacional,Camilia,17800,3900,21700
22827,22828,21-10-2020 16:22:45.553615,Postres · Desayunos,Buñuelos nacho,13000,6600,19600
22828,22829,21-10-2020 16:22:45.875338,Desayunos · Café,El Gualilo,18900,6200,25100
22829,22830,21-10-2020 16:22:46.144997,Típica,El Mondongo y Mucho Mas,10700,5600,16300
22830,22831,21-10-2020 16:22:46.466770,Pollo,Oliva Va,9000,5600,14600
22831,22832,21-10-2020 16:22:46.786294,Desayunos · Típica,Peninsula Calentados y Parrilla,39700,3400,43100
22832,22833,21-10-2020 16:22:47.057910,Postres · Desayunos,Restaurante Cornelia,11870,5500,17370
22833,22834,21-10-2020 16:22:47.327326,Alta Cocina · Italiana,Trattoria de la Plaza,34500,6000,40500
22834,22835,21-10-2020 16:22:47.498292,Parrilla,Restaurante Bar Mi Ranchito,39700,5200,44900
22835,22836,21-10-2020 16:22:47.917842,Parrilla,Arroces Maria Paula,23000,6800,29800
22836,22837,21-10-2020 16:22:48.339002,Saludable · Desayunos,Malú,65000,3700,68700
22837,22838,21-10-2020 16:22:48.707646,Desayunos,Señor Desayuno,37900,6800,44700
22838,22839,21-10-2020 16:22:48.878474,Saludable · Jugos y Batidos,Berdes Drinks & Salads,65000,3500,68500
22839,22840,21-10-2020 16:22:49.147472,Peruana,Masivo,13600,5800,19400
22840,22841,21-10-2020 16:22:49.469641,Desayunos · Panadería,Pasteleite,31800,5900,37700
22841,22842,21-10-2020 16:22:49.639470,Típica,Campo Victoria,24200,3000,27200
22842,22843,21-10-2020 16:22:50.060935,Helados,Buon Gelato,11870,4400,16270
22843,22844,21-10-2020 16:22:50.379627,Desayunos · Típica,Desayunadero de la 42,35000,5900,40900
22844,22845,21-10-2020 16:22:50.652001,Desayunos · Típica,Peninsula Calentados y Parrilla,35000,3400,38400
22845,22846,21-10-2020 16:22:50.922264,Pollo,Heart & Cooking,53400,5000,58400
22846,22847,21-10-2020 16:22:51.144602,Desayunos · Pescados y Mariscos,Gypsy Bistro,12500,4500,17000
22847,22848,21-10-2020 16:22:51.314167,Pollo · Saludable,Tremenda Sal y Dulce,18900,6500,25400
22848,22849,21-10-2020 16:22:51.585487,Desayunos · Típica,Papadió - Colombianas,7500,5700,13200
22849,22850,21-10-2020 16:22:51.854432,Típica,Sabores De Mi Tierra,24200,5400,29600
22850,22851,21-10-2020 16:22:52.076770,Desayunos · Internacional,Camilia,10700,3900,14600
22851,22852,21-10-2020 16:22:52.396376,Típica · Parrilla,Mi Ranchito Parrilla,15600,4400,20000
22852,22853,21-10-2020 16:22:52.768735,Saludable,Amor Propio saludable,48750,4000,52750
22853,22854,21-10-2020 16:22:53.087547,Desayunos · Panadería,Artesanos,31800,4300,36100
22854,22855,21-10-2020 16:22:53.408975,Saludable · Típica,Saludable Mrg,37900,5800,43700
22855,22856,21-10-2020 16:22:53.827774,Desayunos · Típica,Desayunadero de la 42,35000,5900,40900
22856,22857,21-10-2020 16:22:54.048838,Peruana,Masivo,37900,5800,43700
22857,22858,21-10-2020 16:22:54.268082,Saludable,Amor Propio saludable,10700,4000,14700
22858,22859,21-10-2020 16:22:54.689881,Desayunos,Bagel Shop,70000,3200,73200
22859,22860,21-10-2020 16:22:54.959050,Desayunos · Sánduches,Danilo Colombia,31800,3300,35100
22860,22861,21-10-2020 16:22:55.281412,Hamburguesas,Monchis - Hamburguesa,13000,4300,17300
22861,22862,21-10-2020 16:22:55.451910,Peruana · Internacional,La Chifería,29500,6600,36100
22862,22863,21-10-2020 16:22:55.773920,Típica,Carbón & Mondongos,11870,6400,18270
22863,22864,21-10-2020 16:22:55.993346,Desayunos · Jugos y Batidos,Dont Be Hungry,23000,5600,28600
22864,22865,21-10-2020 16:22:56.414860,Saludable · Desayunos,La Estampilla,23000,6000,29000
22865,22866,21-10-2020 16:22:56.734356,Desayunos · Café,El Gualilo,23000,6200,29200
22866,22867,21-10-2020 16:22:57.055437,Mexicana,La leyenda mexican kitchen,48750,3200,51950
22867,22868,21-10-2020 16:22:57.224683,Sushi,Kim Pop,24200,5400,29600
22868,22869,21-10-2020 16:22:57.447391,Pescados y Mariscos,Fish Place - Del Mar,65000,5400,70400
22869,22870,21-10-2020 16:22:57.616716,Hamburguesas,Bendito Cordero,34500,5800,40300
22870,22871,21-10-2020 16:22:58.038013,Saludable,Amor Propio saludable,18900,4000,22900
22871,22872,21-10-2020 16:22:58.457625,Alta Cocina · Parrilla,Criterión,53900,6000,59900
22872,22873,21-10-2020 16:22:58.729228,Desayunos · Parrilla,Mi Patria,24300,4600,28900
22873,22874,21-10-2020 16:22:58.947650,Helados,Buon Gelato,9000,4400,13400
22874,22875,21-10-2020 16:22:59.169499,Alta Cocina · Postres,La Pinta,37900,4500,42400
22875,22876,21-10-2020 16:22:59.538995,Italiana,F*cking Good Pizza,45800,4200,50000
22876,22877,21-10-2020 16:22:59.760620,Asiática,TeT,37900,5900,43800
22877,22878,21-10-2020 16:23:00.029703,Desayunos · Típica,Parrilla Farandula Típico,13000,5900,18900
22878,22879,21-10-2020 16:23:00.350953,Sánduches · China,Peru Mix,53400,5900,59300
22879,22880,21-10-2020 16:23:00.619789,Postres · Desayunos,Jacques Pastelería,53900,5900,59800
22880,22881,21-10-2020 16:23:00.891530,Postres · Desayunos,Jacques Pastelería,24200,5900,30100
22881,22882,21-10-2020 16:23:01.261870,Desayunos,La Frijolada Desayunos,23000,4400,27400
22882,22883,21-10-2020 16:23:01.533586,Típica,La Cocina,24300,4600,28900
22883,22884,21-10-2020 16:23:01.852971,Desayunos · Internacional,Camilia,48750,3900,52650
22884,22885,21-10-2020 16:23:02.275586,Postres · Café,Celestino Café,8900,5900,14800
22885,22886,21-10-2020 16:23:02.495022,Postres · Saludable,Ana Rebana,15000,6300,21300
22886,22887,21-10-2020 16:23:02.866508,Típica,Carbón & Mondongos,53400,6400,59800
22887,22888,21-10-2020 16:23:03.186234,Peruana · Internacional,La Chifería,53900,6600,60500
22888,22889,21-10-2020 16:23:03.559933,Postres,La Tertulia,27800,3400,31200
22889,22890,21-10-2020 16:23:03.979485,Saludable · Desayunos,Raices Bienestar Gourmet,34500,6600,41100
22890,22891,21-10-2020 16:23:04.150909,Asiática,TeT,70000,5900,75900
22891,22892,21-10-2020 16:23:04.320210,Saludable · Desayunos,Agua Dulce,10700,3700,14400
22892,22893,21-10-2020 16:23:04.642795,Saludable · Desayunos,La Cesta,17800,4700,22500
22893,22894,21-10-2020 16:23:04.812031,Jugos y Batidos,Pomponio,7500,3600,11100
22894,22895,21-10-2020 16:23:05.133923,Pescados y Mariscos,Pescadero Héroes del Mar,23000,6600,29600
22895,22896,21-10-2020 16:23:05.453305,Postres,Levelma,53400,6200,59600
22896,22897,21-10-2020 16:23:05.624904,Saludable · Desayunos,Libre de Culpa,10700,4000,14700
22897,22898,21-10-2020 16:23:05.893814,Saludable · Desayunos,Guadalupe - Fruteria,35000,5900,40900
22898,22899,21-10-2020 16:23:06.215669,Típica,Baondish,13000,5800,18800
22899,22900,21-10-2020 16:23:06.485950,Saludable · Desayunos,Básico y elemental,17800,5000,22800
22900,22901,21-10-2020 16:23:06.908298,Postres · Desayunos,Amelie Helados,24300,6400,30700
22901,22902,21-10-2020 16:23:07.177947,Saludable · Parrilla,The Angels Grill and Drinks,15600,6200,21800
22902,22903,21-10-2020 16:23:07.450876,Típica,Salsig,65000,5600,70600
22903,22904,21-10-2020 16:23:07.721144,Desayunos · Comida Rápida,La Veneca,13600,6300,19900
22904,22905,21-10-2020 16:23:07.942964,Desayunos · Panadería,Le Pain Quotidien,45800,3900,49700
22905,22906,21-10-2020 16:23:08.162908,Pollo · Desayunos,Candelina,35000,5300,40300
22906,22907,21-10-2020 16:23:08.485734,Típica,Bendita S,9000,4600,13600
22907,22908,21-10-2020 16:23:08.905850,Típica · Parrilla,La Ternera Parrilla,24300,5200,29500
22908,22909,21-10-2020 16:23:09.227823,Sánduches · China,Peru Mix,70000,5900,75900
22909,22910,21-10-2020 16:23:09.397660,Pizza,Pizza Andante,23000,6300,29300
22910,22911,21-10-2020 16:23:09.820116,Desayunos · Panadería,Ficchi Panadería,8900,3100,12000
22911,22912,21-10-2020 16:23:10.189370,Hamburguesas,Gofi Burger,45800,5100,50900
22912,22913,21-10-2020 16:23:10.460914,Comida Rápida · Perros Calientes,Similoa - Comida Rapida,45800,3700,49500
22913,22914,21-10-2020 16:23:10.830468,Pizza,18 Scalini,70000,4300,74300
22914,22915,21-10-2020 16:23:11.252675,Peruana,Uma Cantina Peruana,45800,3200,49000
22915,22916,21-10-2020 16:23:11.571726,Saludable,Puro Verde,53900,5700,59600
22916,22917,21-10-2020 16:23:11.744168,Internacional,La Esquina con Sabor Parrilla,45800,3000,48800
22917,22918,21-10-2020 16:23:12.063227,Típica · Parrilla,Toya,15000,4200,19200
22918,22919,21-10-2020 16:23:12.335435,Peruana,Uma Cantina Peruana,10700,3200,13900
22919,22920,21-10-2020 16:23:12.656158,Desayunos · Panadería,Siena Café,18900,3700,22600
22920,22921,21-10-2020 16:23:12.929182,Desayunos · Típica,Calentao Express,15000,6000,21000
22921,22922,21-10-2020 16:23:13.249113,Desayunos · Café,Aromacafé el Placer de Compartir,29500,5000,34500
22922,22923,21-10-2020 16:23:13.571594,Típica,Bendita S,9000,4600,13600
22923,22924,21-10-2020 16:23:13.891709,Desayunos,Jacinta Arepas de Huevo,35000,4000,39000
22924,22925,21-10-2020 16:23:14.263953,Helados,Buon Gelato,12500,4400,16900
22925,22926,21-10-2020 16:23:14.433572,Pollo · Saludable,Yerbabuena,35000,3900,38900
22926,22927,21-10-2020 16:23:14.656162,Pizza,18 Scalini,39700,4300,44000
22927,22928,21-10-2020 16:23:14.925414,Desayunos · Parrilla,Mi Patria,29500,4600,34100
22928,22929,21-10-2020 16:23:15.097372,Italiana,F*cking Good Pizza,24300,4200,28500
22929,22930,21-10-2020 16:23:15.467639,Pizza,Pizza Andante,13000,6300,19300
22930,22931,21-10-2020 16:23:15.689442,Sánduches,Submarin,13600,3800,17400
22931,22932,21-10-2020 16:23:15.908868,Mexicana,La leyenda mexican kitchen,15600,3200,18800
22932,22933,21-10-2020 16:23:16.131099,Desayunos · Sánduches,Frutos del Bosque,34500,3500,38000
22933,22934,21-10-2020 16:23:16.500799,Desayunos · Café,vereda central calle 99,18900,5700,24600
22934,22935,21-10-2020 16:23:16.722431,Internacional,Rio Sabores y Experiencias,18900,4100,23000
22935,22936,21-10-2020 16:23:17.091503,Postres · Café,Loló Coffee & Snacks,35000,4600,39600
22936,22937,21-10-2020 16:23:17.264745,Pizza,pizza andante,29500,4200,33700
22937,22938,21-10-2020 16:23:17.584559,Desayunos · Típica,D'Porco - Lechona,39700,6300,46000
22938,22939,21-10-2020 16:23:17.906261,Desayunos · Internacional,Camilia,15600,3900,19500
22939,22940,21-10-2020 16:23:18.325941,Desayunos,Jacinta Arepas de Huevo,37900,4000,41900
22940,22941,21-10-2020 16:23:18.747621,Sushi,Canoa To Go,65000,5900,70900
22941,22942,21-10-2020 16:23:19.117302,Crepes,La Chabatta,15600,5900,21500
22942,22943,21-10-2020 16:23:19.290682,Saludable,A2manos,8900,4200,13100
22943,22944,21-10-2020 16:23:19.561423,Hamburguesas,Gofi Burger,70000,5100,75100
22944,22945,21-10-2020 16:23:19.932826,Helados,Buon Gelato,15600,4400,20000
22945,22946,21-10-2020 16:23:20.152462,Pollo · Desayunos,Piaf,15600,6500,22100
22946,22947,21-10-2020 16:23:20.324431,Postres · Desayunos,Amelie Helados,13600,6400,20000
22947,22948,21-10-2020 16:23:20.543503,Saludable · Típica,Saludable Mrg,23000,5800,28800
22948,22949,21-10-2020 16:23:20.765019,Desayunos · Café,Libertario Coffee Roasters,11870,4600,16470
22949,22950,21-10-2020 16:23:21.084155,Pizza,18 Scalini,11870,4300,16170
22950,22951,21-10-2020 16:23:21.255953,Postres · Desayunos,Maltihelados,7500,6200,13700
22951,22952,21-10-2020 16:23:21.425606,Postres · Panadería,RIGHT AWAY FOODS,12500,6600,19100
22952,22953,21-10-2020 16:23:21.647801,Típica,Baondish,9000,5800,14800
22953,22954,21-10-2020 16:23:21.916160,Postres · Desayunos,Buñuelos nacho,8900,6600,15500
22954,22955,21-10-2020 16:23:22.338506,Típica · Parrilla,Toya,15000,4200,19200
22955,22956,21-10-2020 16:23:22.557647,Saludable · Desayunos,Malú,39700,3700,43400
22956,22957,21-10-2020 16:23:22.878850,Desayunos · Típica,Calentao Express,34500,6000,40500
22957,22958,21-10-2020 16:23:23.098311,Helados,Buon Gelato,70000,4400,74400
22958,22959,21-10-2020 16:23:23.471044,Desayunos · Panadería,Choclofee,11870,4700,16570
22959,22960,21-10-2020 16:23:23.741451,Italiana,Bocatto Di Passo,65000,5000,70000
22960,22961,21-10-2020 16:23:24.063501,Pollo,Oliva Va,34500,5600,40100
22961,22962,21-10-2020 16:23:24.283809,Pollo · Típica,Auyama,34500,3900,38400
22962,22963,21-10-2020 16:23:24.656832,Parrilla,Parrilla Pimentón,53400,3400,56800
22963,22964,21-10-2020 16:23:24.876394,Desayunos · Café,vereda central calle 99,53900,5700,59600
22964,22965,21-10-2020 16:23:25.048096,Helados,Buon Gelato,12500,4400,16900
22965,22966,21-10-2020 16:23:25.268372,Desayunos,Sunny Breakfast Brunch,31800,4300,36100
22966,22967,21-10-2020 16:23:25.690767,Desayunos · Comida Rápida,Chocolatto,8900,3400,12300
22967,22968,21-10-2020 16:23:26.110226,Parrilla,Beraca Parrilla Bbq,15000,5600,20600
22968,22969,21-10-2020 16:23:26.482927,Típica · Parrilla,Parrilla Farandula Gourmet,12500,5100,17600
22969,22970,21-10-2020 16:23:26.802371,Desayunos,Desayunos en Bogotá,27800,3400,31200
22970,22971,21-10-2020 16:23:27.224186,Desayunos · Típica,La Parrilla Dorada Polo,48750,6600,55350
22971,22972,21-10-2020 16:23:27.493892,Saludable,Amor Propio saludable,65000,4000,69000
22972,22973,21-10-2020 16:23:27.715171,Postres · Desayunos,Maria Luisa - Postres,45800,4300,50100
22973,22974,21-10-2020 16:23:28.084571,Parrilla,Arepaisa de Medellín,13600,5600,19200
22974,22975,21-10-2020 16:23:28.407391,Asiática,Thai Station,13000,6000,19000
22975,22976,21-10-2020 16:23:28.777000,Comida Rápida,Fiesta Digital Andrés,70000,3100,73100
22976,22977,21-10-2020 16:23:28.948298,Postres · Desayunos,Protein Bakes,9000,5900,14900
22977,22978,21-10-2020 16:23:29.217471,Pollo · Saludable,Tremenda Sal y Dulce,48750,6500,55250
22978,22979,21-10-2020 16:23:29.489631,Pollo · Típica,Auyama,53900,3900,57800
22979,22980,21-10-2020 16:23:29.810175,Desayunos,Bagel Shop,12500,3200,15700
22980,22981,21-10-2020 16:23:29.982133,Desayunos · Panadería,Juliana Restaurante,35000,6100,41100
22981,22982,21-10-2020 16:23:30.201805,Crepes,San Crepes,17800,4900,22700
22982,22983,21-10-2020 16:23:30.523843,Típica,Cazuelitas 93,18900,3900,22800
22983,22984,21-10-2020 16:23:30.942739,Desayunos · Árabe,Boniato Sabores Vivos,23000,5300,28300
22984,22985,21-10-2020 16:23:31.114357,Desayunos · Típica,Papadió - Colombianas,10700,5700,16400
22985,22986,21-10-2020 16:23:31.485305,Pollo · Sánduches,Pollos Century,34500,3000,37500
22986,22987,21-10-2020 16:23:31.906972,Típica · Parrilla,La Ternera Parrilla,45800,5200,51000
22987,22988,21-10-2020 16:23:32.126659,Desayunos,Desayunos en Bogotá,27800,3400,31200
22988,22989,21-10-2020 16:23:32.298005,Crepes,La Chabatta,39700,5900,45600
22989,22990,21-10-2020 16:23:32.717895,Postres · Desayunos,Sharmus,31800,6100,37900
22990,22991,21-10-2020 16:23:32.889376,Peruana,Masivo,37900,5800,43700
22991,22992,21-10-2020 16:23:33.058010,Desayunos,Bagel Shop,53400,3200,56600
22992,22993,21-10-2020 16:23:33.230070,Saludable · Desayunos,Copacabana Açai Bowls,53900,3000,56900
22993,22994,21-10-2020 16:23:33.649817,Pescados y Mariscos,La Gran Cazuela,23000,3200,26200
22994,22995,21-10-2020 16:23:33.871648,Saludable · Desayunos,Re.al Alimentos Reales,18900,4000,22900
22995,22996,21-10-2020 16:23:34.040970,Desayunos,Fratelli - Desayunos,35000,4600,39600
22996,22997,21-10-2020 16:23:34.362743,Desayunos · Pescados y Mariscos,Luzí­a - Mediterranea,37900,5700,43600
22997,22998,21-10-2020 16:23:34.532081,Pollo · Desayunos,Candelina,29500,5300,34800
22998,22999,21-10-2020 16:23:34.753967,Postres · Desayunos,Maltihelado,70000,4500,74500
22999,23000,21-10-2020 16:23:35.073954,Postres · Desayunos,La Folie - Postres,15000,3300,18300
23000,23001,21-10-2020 16:23:35.246528,Postres · Desayunos,Gelateria Da Favola,24300,6500,30800
23001,23002,21-10-2020 16:23:35.616464,Desayunos,Desayunos en Bogotá,13600,3400,17000
23002,23003,21-10-2020 16:23:35.788714,Alta Cocina · Parrilla,Criterión,23000,6000,29000
23003,23004,21-10-2020 16:23:36.158306,Sushi · Asiática,Tu Sushi,9000,6400,15400
23004,23005,21-10-2020 16:23:36.580278,Saludable · Desayunos,Bawana - Sandwich,53400,3400,56800
23005,23006,21-10-2020 16:23:36.749755,Desayunos · Panadería,El Pan de Phillippe,70000,4600,74600
23006,23007,21-10-2020 16:23:37.071240,Postres · Desayunos,Vivalight Market.,18900,6500,25400
23007,23008,21-10-2020 16:23:37.241694,Saludable,Amor Propio saludable,23000,4000,27000
23008,23009,21-10-2020 16:23:37.664346,Saludable,Amor Propio saludable,70000,4000,74000
23009,23010,21-10-2020 16:23:37.935005,Postres,Levelma,70000,6200,76200
23010,23011,21-10-2020 16:23:38.158500,Postres · Desayunos,KOKOA & co.,48750,4700,53450
23011,23012,21-10-2020 16:23:38.429494,Pollo · Saludable,Yerbabuena,53400,3900,57300
23012,23013,21-10-2020 16:23:38.651852,Pollo · China,China Tao,53900,3500,57400
23013,23014,21-10-2020 16:23:39.021162,Pollo · Saludable,Yerbabuena,18900,3900,22800
23014,23015,21-10-2020 16:23:39.444038,Comida Rápida,Fiesta Digital Andrés,31800,3100,34900
23015,23016,21-10-2020 16:23:39.864585,Sushi · Asiática,Arigato,27800,5300,33100
23016,23017,21-10-2020 16:23:40.238111,Parrilla,OAK Ahumado y Brebajes,17800,6000,23800
23017,23018,21-10-2020 16:23:40.558345,Desayunos · Pescados y Mariscos,Gypsy Bistro,31800,4500,36300
23018,23019,21-10-2020 16:23:40.730730,Sushi,Umi,8900,5600,14500
23019,23020,21-10-2020 16:23:41.150810,Parrilla · Café,Figaro Café/ Restaurante Argentino,11870,5800,17670
23020,23021,21-10-2020 16:23:41.572765,Helados,Buon Gelato,17800,4400,22200
23021,23022,21-10-2020 16:23:41.891863,Pollo · Desayunos,Caserito Gourmet,8900,6700,15600
23022,23023,21-10-2020 16:23:42.063861,Desayunos · Café,Aromacafé el Placer de Compartir,34500,5000,39500
23023,23024,21-10-2020 16:23:42.333527,Desayunos,Señor Desayuno,53900,6800,60700
23024,23025,21-10-2020 16:23:42.706013,Desayunos · Café,vereda central calle 99,8900,5700,14600
23025,23026,21-10-2020 16:23:43.075416,Parrilla,Parrilla Pimentón,17800,3400,21200
23026,23027,21-10-2020 16:23:43.247802,Pizza,Pizza Andante,53400,6300,59700
23027,23028,21-10-2020 16:23:43.517990,Postres · Desayunos,BagBog Bagels,9000,6400,15400
23028,23029,21-10-2020 16:23:43.839940,Pollo,Chicken House,53400,4200,57600
23029,23030,21-10-2020 16:23:44.058990,Desayunos · Típica,Alce,13600,4900,18500
23030,23031,21-10-2020 16:23:44.333166,Típica,Campo Victoria,39700,3000,42700
23031,23032,21-10-2020 16:23:44.602967,Postres · Panadería,RIGHT AWAY FOODS,53900,6600,60500
23032,23033,21-10-2020 16:23:44.875093,China,China Food Col,24300,3600,27900
23033,23034,21-10-2020 16:23:45.044194,Típica,Juan Chorizo,37900,3900,41800
23034,23035,21-10-2020 16:23:45.317213,Hamburguesas · Alitas,Beer,15600,6600,22200
23035,23036,21-10-2020 16:23:45.736736,Saludable,Ventura Soup y Salad,15600,3800,19400
23036,23037,21-10-2020 16:23:46.059651,Saludable · Desayunos,Guadalupe - Fruteria,24200,5900,30100
23037,23038,21-10-2020 16:23:46.229388,Desayunos · Típica,Cochon,18900,3300,22200
23038,23039,21-10-2020 16:23:46.551629,Típica · Parrilla,Parrilla Farandula Gourmet,48750,5100,53850
23039,23040,21-10-2020 16:23:46.870959,Desayunos · Parrilla,Mi Patria,11870,4600,16470
23040,23041,21-10-2020 16:23:47.293971,Desayunos · Italiana,Rceta By Rausch,70000,3600,73600
23041,23042,21-10-2020 16:23:47.663580,Saludable · Desayunos,Libre de Culpa,35000,4000,39000
23042,23043,21-10-2020 16:23:48.035954,Saludable · Desayunos,Básico y Elemental,29500,5900,35400
23043,23044,21-10-2020 16:23:48.205510,Desayunos · Típica,Criollomania,11870,5200,17070
23044,23045,21-10-2020 16:23:48.428063,Saludable · Parrilla,Box,34500,3700,38200
23045,23046,21-10-2020 16:23:48.697539,Pollo · Desayunos,Candelina,27800,5300,33100
23046,23047,21-10-2020 16:23:48.868962,Desayunos · Pescados y Mariscos,Gypsy Bistro,37900,4500,42400
23047,23048,21-10-2020 16:23:49.288803,Desayunos · Jugos y Batidos,Kuriwaji,11870,6300,18170
23048,23049,21-10-2020 16:23:49.710878,Típica,Sopitas y Más,23000,4200,27200
23049,23050,21-10-2020 16:23:50.130961,Sushi · Desayunos,Maki Roll,7500,4300,11800
23050,23051,21-10-2020 16:23:50.405736,Jugos y Batidos,Pomponio,15600,3600,19200
23051,23052,21-10-2020 16:23:50.726566,Desayunos · Panadería,Decofruta,65000,4700,69700
23052,23053,21-10-2020 16:23:51.060773,Desayunos,Sr Buñuelo,24300,6400,30700
23053,23054,21-10-2020 16:23:51.281680,Pollo · Saludable,Yerbabuena,35000,3900,38900
23054,23055,21-10-2020 16:23:51.604767,Desayunos · Comida Rápida,La Veneca,23000,6300,29300
23055,23056,21-10-2020 16:23:51.875503,Saludable,Ventura Soup y Salad,15000,3800,18800
23056,23057,21-10-2020 16:23:52.249334,Desayunos · Sánduches,Frutos del Bosque,70000,3500,73500
23057,23058,21-10-2020 16:23:52.470772,Pizza,Pastas Laurentina,53900,4800,58700
23058,23059,21-10-2020 16:23:52.694279,Típica,Sopitas y Más,18900,4200,23100
23059,23060,21-10-2020 16:23:52.915112,Desayunos · Sánduches,Garnish,29500,5200,34700
23060,23061,21-10-2020 16:23:53.188880,Pollo · Pescados y Mariscos,Bang Bang Rice,34500,3400,37900
23061,23062,21-10-2020 16:23:53.609556,Desayunos,Bagel Shop,53400,3200,56600
23062,23063,21-10-2020 16:23:53.881753,Alta Cocina · Parrilla,Criterión,65000,6000,71000
23063,23064,21-10-2020 16:23:54.151889,Parrilla,Rústico Picadería,70000,3800,73800
23064,23065,21-10-2020 16:23:54.424423,Desayunos,Sr Buñuelo,31800,6400,38200
23065,23066,21-10-2020 16:23:54.644929,Desayunos,Fratelli - Desayunos,13600,4600,18200
23066,23067,21-10-2020 16:23:54.816972,Desayunos · Típica,Cochon,13600,3300,16900
23067,23068,21-10-2020 16:23:55.036876,Postres,Beiked,29500,4000,33500
23068,23069,21-10-2020 16:23:55.411318,Desayunos,Archies Desayunos,39700,3100,42800
23069,23070,21-10-2020 16:23:55.681764,Desayunos · Empanadas,Empanadas Doraditas.com,31800,3000,34800
23070,23071,21-10-2020 16:23:55.854087,Desayunos,Fratelli - Desayunos,48750,4600,53350
23071,23072,21-10-2020 16:23:56.074053,Desayunos · Comida Rápida,Chocolatto,9000,3400,12400
23072,23073,21-10-2020 16:23:56.246970,Pollo · Desayunos,Piaf,70000,6500,76500
23073,23074,21-10-2020 16:23:56.568206,Sushi,Umi,9000,5600,14600
23074,23075,21-10-2020 16:23:56.741806,Mexicana,Cantina La 15,35000,4300,39300
23075,23076,21-10-2020 16:23:56.962290,Postres · Desayunos,Buñuelos nacho,37900,6600,44500
23076,23077,21-10-2020 16:23:57.236014,Postres · Desayunos,BagBog Bagels,13000,6400,19400
23077,23078,21-10-2020 16:23:57.606929,Desayunos · Típica,Papadió - Colombianas,53900,5700,59600
23078,23079,21-10-2020 16:23:57.879445,Desayunos · Café,Norma's Ice Cream Café,53900,6300,60200
23079,23080,21-10-2020 16:23:58.150513,Saludable · Parrilla,The Angels Grill and Drinks,8900,6200,15100
23080,23081,21-10-2020 16:23:58.372906,Hamburguesas · Desayunos,El Inglés Gastro Pub,70000,6600,76600
23081,23082,21-10-2020 16:23:58.594417,Sánduches · China,Peru Mix,23000,5900,28900
23082,23083,21-10-2020 16:23:59.016698,Desayunos · Panadería,Santa Juana Food Bar,53900,5900,59800
23083,23084,21-10-2020 16:23:59.286865,Pizza,Pastas Laurentina,13600,4800,18400
23084,23085,21-10-2020 16:23:59.508787,Parrilla,Carnes la Zarza,10700,4900,15600
23085,23086,21-10-2020 16:23:59.829025,Desayunos · Café,Aromacafé el Placer de Compartir,10700,5000,15700
23086,23087,21-10-2020 16:24:00.252846,Pescados y Mariscos,Fish Place - Del Mar,45800,5400,51200
23087,23088,21-10-2020 16:24:00.623842,Jugos y Batidos,Pomponio,17800,3600,21400
23088,23089,21-10-2020 16:24:00.945943,Postres · Desayunos,Protein Bakes,8900,5900,14800
23089,23090,21-10-2020 16:24:01.216720,Asiática,TeT,65000,5900,70900
23090,23091,21-10-2020 16:24:01.539145,Parrilla · Café,Figaro Café/ Restaurante Argentino,11870,5800,17670
23091,23092,21-10-2020 16:24:01.709396,Parrilla · Café,Gaira Café,35000,4400,39400
23092,23093,21-10-2020 16:24:01.931221,Desayunos,El Corral - Desayunos,23000,5000,28000
23093,23094,21-10-2020 16:24:02.251084,Sushi,Canoa To Go,24300,5900,30200
23094,23095,21-10-2020 16:24:02.573222,Desayunos · Sánduches,Frutos del Bosque,9000,3500,12500
23095,23096,21-10-2020 16:24:02.892728,Parrilla,Antojo a Domicilio,39700,5000,44700
23096,23097,21-10-2020 16:24:03.265046,Desayunos · Panadería,Decofruta,34500,4700,39200
23097,23098,21-10-2020 16:24:03.634940,Saludable · Desayunos,Copacabana Açai Bowls,34500,3000,37500
23098,23099,21-10-2020 16:24:03.958123,Desayunos · Panadería,Siena Café,10700,3700,14400
23099,23100,21-10-2020 16:24:04.128382,Postres · Desayunos,Vivalight Market.,9000,6500,15500
23100,23101,21-10-2020 16:24:04.500967,Desayunos · Panadería,Choclofee,24300,4700,29000
23101,23102,21-10-2020 16:24:04.821522,Saludable · Desayunos,La Cesta,48750,4700,53450
23102,23103,21-10-2020 16:24:05.144176,Típica · Parrilla,El Portal de la Antigua,53400,5600,59000
23103,23104,21-10-2020 16:24:05.514611,Postres,Toledo Pastelería,18900,6800,25700
23104,23105,21-10-2020 16:24:05.738274,Desayunos · Panadería,Pasteleite,13000,5900,18900
23105,23106,21-10-2020 16:24:06.057929,Hamburguesas · Pescados y Mariscos,El Velero,9000,6500,15500
23106,23107,21-10-2020 16:24:06.380239,Parrilla,Rústico Picadería,23000,3800,26800
23107,23108,21-10-2020 16:24:06.549925,Pizza,Pastas Laurentina,35000,4800,39800
23108,23109,21-10-2020 16:24:06.721637,Saludable · Desayunos,Fresh Co,8900,5600,14500
23109,23110,21-10-2020 16:24:07.141844,Alta Cocina · Postres,La Pinta,70000,4500,74500
23110,23111,21-10-2020 16:24:07.514250,Sushi · Asiática,Arigato,23000,5300,28300
23111,23112,21-10-2020 16:24:07.833830,Desayunos · Café,El Gualilo,35000,6200,41200
23112,23113,21-10-2020 16:24:08.256090,Pollo · Pescados y Mariscos,Bang Bang Rice,35000,3400,38400
23113,23114,21-10-2020 16:24:08.676424,Postres,Beiked,8900,4000,12900
23114,23115,21-10-2020 16:24:08.898755,Desayunos · Jugos y Batidos,Kuriwaji,35000,6300,41300
23115,23116,21-10-2020 16:24:09.168656,Desayunos · Típica,Casa Vieja,35000,6000,41000
23116,23117,21-10-2020 16:24:09.541817,Saludable · Desayunos,Maracuyá,24300,6700,31000
23117,23118,21-10-2020 16:24:09.712354,Sushi · Asiática,Tu Sushi,7500,6400,13900
23118,23119,21-10-2020 16:24:09.884941,Pizza,Pastas Laurentina,12500,4800,17300
23119,23120,21-10-2020 16:24:10.305289,Desayunos · Panadería,Premium Break Bakery,10700,3700,14400
23120,23121,21-10-2020 16:24:10.728426,Saludable · Desayunos,Bawana - Sandwich,34500,3400,37900
23121,23122,21-10-2020 16:24:11.049024,Sushi · Desayunos,Maki Roll,27800,4300,32100
23122,23123,21-10-2020 16:24:11.221576,Desayunos,La Frijolada Desayunos,31800,4400,36200
23123,23124,21-10-2020 16:24:11.492283,Internacional,La Esquina con Sabor Parrilla,45800,3000,48800
23124,23125,21-10-2020 16:24:11.914807,Postres · Saludable,Ana Rebana,29500,6300,35800
23125,23126,21-10-2020 16:24:12.285370,Parrilla · Internacional,Taperia de la Plaza,27800,5700,33500
23126,23127,21-10-2020 16:24:12.458777,Hamburguesas,Burger Society,39700,4100,43800
23127,23128,21-10-2020 16:24:12.728793,Postres · Desayunos,KOKOA & co.,24200,4700,28900
23128,23129,21-10-2020 16:24:13.000666,Sushi · Asiática,Arigato,8900,5300,14200
23129,23130,21-10-2020 16:24:13.320915,Alta Cocina · Postres,La Pinta,15600,4500,20100
23130,23131,21-10-2020 16:24:13.543812,Desayunos · Típica,La Frijolada,24200,4500,28700
23131,23132,21-10-2020 16:24:13.963654,Mexicana,Hidalgo Taquería,12500,4900,17400
23132,23133,21-10-2020 16:24:14.185991,Desayunos,Bagel Shop,37900,3200,41100
23133,23134,21-10-2020 16:24:14.356076,Pizza,pizza andante,17800,4200,22000
23134,23135,21-10-2020 16:24:14.578264,Desayunos · Típica,Cochon,45800,3300,49100
23135,23136,21-10-2020 16:24:14.747992,Típica · Pescados y Mariscos,Arroces Mrg,48750,4300,53050
23136,23137,21-10-2020 16:24:15.070231,Desayunos · Típica,Fogón Sangileño,15000,5000,20000
23137,23138,21-10-2020 16:24:15.240674,Sushi · Asiática,Arigato,48750,5300,54050
23138,23139,21-10-2020 16:24:15.463912,Pollo,Oliva Va,8900,5600,14500
23139,23140,21-10-2020 16:24:15.883628,Desayunos · Comida Rápida,La Veneca,39700,6300,46000
23140,23141,21-10-2020 16:24:16.257351,Sánduches · Pescados y Mariscos,Pacific Comida de Mar,11870,4000,15870
23141,23142,21-10-2020 16:24:16.477886,Desayunos · Sánduches,Frutos del Bosque,24200,3500,27700
23142,23143,21-10-2020 16:24:16.850542,Postres · Desayunos,La Folie - Postres,23000,3300,26300
23143,23144,21-10-2020 16:24:17.120664,Postres · Desayunos,Protein Bakes,70000,5900,75900
23144,23145,21-10-2020 16:24:17.343113,Postres · Panadería,RIGHT AWAY FOODS,10700,6600,17300
23145,23146,21-10-2020 16:24:17.563390,Saludable · Desayunos,Básico y elemental,39700,5000,44700
23146,23147,21-10-2020 16:24:17.785820,Sushi,Umi,18900,5600,24500
23147,23148,21-10-2020 16:24:18.106124,Pizza · Parrilla,Urban Lunch,39700,4000,43700
23148,23149,21-10-2020 16:24:18.378884,Saludable · Desayunos,La Estampilla,70000,6000,76000
23149,23150,21-10-2020 16:24:18.649709,Italiana,Bocatto Di Passo,8900,5000,13900
23150,23151,21-10-2020 16:24:18.921976,Desayunos · Café,Norma's Ice Cream Café,18900,6300,25200
23151,23152,21-10-2020 16:24:19.242932,Asiática,Thai Station,45800,6000,51800
23152,23153,21-10-2020 16:24:19.566000,Típica,La Cocina,13600,4600,18200
23153,23154,21-10-2020 16:24:19.836280,Pizza,pizza andante,13600,4200,17800
23154,23155,21-10-2020 16:24:20.158929,Saludable · Desayunos,Fresh Co,53400,5600,59000
23155,23156,21-10-2020 16:24:20.529982,Desayunos · Café,Norma's Ice Cream Café,35000,6300,41300
23156,23157,21-10-2020 16:24:20.903416,Peruana · Internacional,La Chifería,24200,6600,30800
23157,23158,21-10-2020 16:24:21.324598,Desayunos · Típica,Casa Vieja,7500,6000,13500
23158,23159,21-10-2020 16:24:21.648151,Desayunos,Don Leo,15600,6000,21600
23159,23160,21-10-2020 16:24:21.918495,Postres · Desayunos,Sharmus,53400,6100,59500
23160,23161,21-10-2020 16:24:22.291468,Pizza,Pastas Laurentina,37900,4800,42700
23161,23162,21-10-2020 16:24:22.611528,Desayunos · Jugos y Batidos,Frutiwow,53400,4100,57500
23162,23163,21-10-2020 16:24:22.984569,Postres · Desayunos,Aury Postres - Comidas & Picadas,65000,4700,69700
23163,23164,21-10-2020 16:24:23.306038,Desayunos · Helados,San Giorgio Gelateria,13000,3100,16100
23164,23165,21-10-2020 16:24:23.479251,Hamburguesas · Alitas,Beer,39700,6600,46300
23165,23166,21-10-2020 16:24:23.749840,Postres,Toledo Pastelería,53900,6800,60700
23166,23167,21-10-2020 16:24:24.022164,Saludable · Típica,Saludable Mrg,34500,5800,40300
23167,23168,21-10-2020 16:24:24.192366,Típica,Sabrosito,15600,4000,19600
23168,23169,21-10-2020 16:24:24.464923,Desayunos · Internacional,Camilia,8900,3900,12800
23169,23170,21-10-2020 16:24:24.784547,Pollo,Oliva Va,9000,5600,14600
23170,23171,21-10-2020 16:24:24.956425,Desayunos · Panadería,Santa Juana Food Bar,17800,5900,23700
23171,23172,21-10-2020 16:24:25.126686,Hamburguesas,Burger Society,45800,4100,49900
23172,23173,21-10-2020 16:24:25.449881,Postres · Desayunos,Maria Luisa - Postres,70000,4300,74300
23173,23174,21-10-2020 16:24:25.820291,Desayunos,Jacinta Arepas de Huevo,34500,4000,38500
23174,23175,21-10-2020 16:24:26.042715,Sánduches,Submarin,48750,3800,52550
23175,23176,21-10-2020 16:24:26.463391,Pescados y Mariscos,Pescadero Héroes del Mar,8900,6600,15500
23176,23177,21-10-2020 16:24:26.635685,Postres · Helados,Mahé,15600,6000,21600
23177,23178,21-10-2020 16:24:27.055270,Saludable,Ventura Soup y Salad,70000,3800,73800
23178,23179,21-10-2020 16:24:27.327574,Saludable,Hanai - Bowls Saludables,13600,5900,19500
23179,23180,21-10-2020 16:24:27.497339,Alta Cocina · Parrilla,Criterión,13000,6000,19000
23180,23181,21-10-2020 16:24:27.819530,China,China Food Col,9000,3600,12600
23181,23182,21-10-2020 16:24:28.189621,Desayunos · Panadería,Siena Café,45800,3700,49500
23182,23183,21-10-2020 16:24:28.612411,Típica · Parrilla,El Portal de la Antigua,45800,5600,51400
23183,23184,21-10-2020 16:24:29.032237,Desayunos · Café,Matchacha,18900,5900,24800
23184,23185,21-10-2020 16:24:29.404042,Pollo · Desayunos,Piaf,39700,6500,46200
23185,23186,21-10-2020 16:24:29.573900,Alta Cocina · Italiana,Trattoria de la Plaza,35000,6000,41000
23186,23187,21-10-2020 16:24:29.745733,Postres,Beiked,35000,4000,39000
23187,23188,21-10-2020 16:24:30.116250,Jugos y Batidos,Pomponio,29500,3600,33100
23188,23189,21-10-2020 16:24:30.488854,Desayunos · Jugos y Batidos,Kuriwaji,8900,6300,15200
23189,23190,21-10-2020 16:24:30.859447,Postres · Helados,Mahé,12500,6000,18500
23190,23191,21-10-2020 16:24:31.181799,Típica,Juan Chorizo,9000,3900,12900
23191,23192,21-10-2020 16:24:31.503892,Pollo · Pescados y Mariscos,Bang Bang Rice,17800,3400,21200
23192,23193,21-10-2020 16:24:31.776816,Desayunos · Pescados y Mariscos,Luzí­a - Mediterranea,53900,5700,59600
23193,23194,21-10-2020 16:24:32.047167,Desayunos · Panadería,Decofruta,13000,4700,17700
23194,23195,21-10-2020 16:24:32.321660,Desayunos · Típica,Desayunadero de la 42,39700,5900,45600
23195,23196,21-10-2020 16:24:32.642897,Pollo · Saludable,Yerbabuena,13000,3900,16900
23196,23197,21-10-2020 16:24:32.865205,Postres,La Tertulia,23000,3400,26400
23197,23198,21-10-2020 16:24:33.034658,Pollo · Desayunos,Abasto,13600,3600,17200
23198,23199,21-10-2020 16:24:33.356980,Postres · Desayunos,La Folie - Postres,13600,3300,16900
23199,23200,21-10-2020 16:24:33.727067,Desayunos · Panadería,Le Pain Quotidien,24300,3900,28200
23200,23201,21-10-2020 16:24:33.949754,Pollo · Desayunos,Abasto,13600,3600,17200
23201,23202,21-10-2020 16:24:34.120199,Pizza · Italiana,Pisapore - Pizza,12500,6600,19100
23202,23203,21-10-2020 16:24:34.493302,Desayunos · Café,Libertario Coffee Roasters,65000,4600,69600
23203,23204,21-10-2020 16:24:34.662772,Mexicana,La leyenda mexican kitchen,23000,3200,26200
23204,23205,21-10-2020 16:24:34.934760,Helados,Buon Gelato,13000,4400,17400
23205,23206,21-10-2020 16:24:35.104418,Sushi · Asiática,Tu Sushi,23000,6400,29400
23206,23207,21-10-2020 16:24:35.426911,Desayunos · Pescados y Mariscos,Gypsy Bistro,29500,4500,34000
23207,23208,21-10-2020 16:24:35.796825,Sushi · Asiática,Arigato,13600,5300,18900
23208,23209,21-10-2020 16:24:36.219159,Desayunos · Típica,Cochon,17800,3300,21100
23209,23210,21-10-2020 16:24:36.489467,Alta Cocina · Parrilla,Criterión,10700,6000,16700
23210,23211,21-10-2020 16:24:36.713044,Parrilla,Antojo a Domicilio,13000,5000,18000
23211,23212,21-10-2020 16:24:36.934138,Postres,Levelma,53400,6200,59600
23212,23213,21-10-2020 16:24:37.107481,Postres,Toledo Pastelería,9000,6800,15800
23213,23214,21-10-2020 16:24:37.377907,Pescados y Mariscos,Fish Place - Del Mar,53400,5400,58800
23214,23215,21-10-2020 16:24:37.650547,Desayunos · Típica,Rojo Gourmet,23000,4700,27700
23215,23216,21-10-2020 16:24:37.920666,Saludable,Puro Verde,45800,5700,51500
23216,23217,21-10-2020 16:24:38.093104,Saludable · Desayunos,La Cesta,31800,4700,36500
23217,23218,21-10-2020 16:24:38.312267,Desayunos · Café,Matchacha,17800,5900,23700
23218,23219,21-10-2020 16:24:38.734885,Desayunos,Jacinta Arepas de Huevo,8900,4000,12900
23219,23220,21-10-2020 16:24:39.054735,Saludable,A2manos,8900,4200,13100
23220,23221,21-10-2020 16:24:39.376845,Desayunos,Butter,15600,6700,22300
23221,23222,21-10-2020 16:24:39.697603,Desayunos · Café,Aromacafé el Placer de Compartir,10700,5000,15700
23222,23223,21-10-2020 16:24:39.970017,Desayunos · Panadería,Choclofee,13600,4700,18300
23223,23224,21-10-2020 16:24:40.189701,Hamburguesas · Saludable,Restaurant Inn,39700,6100,45800
23224,23225,21-10-2020 16:24:40.561664,Postres,Beiked,8900,4000,12900
23225,23226,21-10-2020 16:24:40.930923,Desayunos · Típica,La Frijolada,8900,4500,13400
23226,23227,21-10-2020 16:24:41.353098,Típica,Sopitas y Más,31800,4200,36000
23227,23228,21-10-2020 16:24:41.673074,Desayunos · Típica,Calentao Express,23000,6000,29000
23228,23229,21-10-2020 16:24:42.096380,Desayunos · Árabe,Boniato Sabores Vivos,37900,5300,43200
23229,23230,21-10-2020 16:24:42.366544,Típica,Bandejas Mrg,17800,3800,21600
